,datetime,symbol,Open,High,Low,Close,Volume,Dividends,Stock Splits,change_in_price,down_days,up_days,RSI,low_14,high_14,k_percent,r_percent,MACD,MACD_EMA,Price_Rate_Of_Change,On Balance Volume,Prediction
13,2013-01-22,GOOG,17.550716400146484,17.567651748657227,17.323068618774414,17.506132125854492,152264594.0,0.0,0.0,-0.0408477783203125,0.0408477783203125,0.0,20.14396685273948,17.323068618774414,18.555450439453125,14.85444721825411,-85.14555278174589,-0.09171100153648482,-0.036825313998919515,-0.04149737385096208,-235487370.0,-1.0
14,2013-01-23,GOOG,18.33104133605957,18.655075073242188,18.326059341430664,18.46827507019043,237249950.0,0.0,0.0,0.9621429443359375,0.0,0.9621429443359375,65.71773910510161,17.323068618774414,18.655075073242188,85.97604370270135,-14.023956297298652,-0.04820091845582297,-0.0391834027627866,0.004579107727617826,1762580.0,1.0
15,2013-01-24,GOOG,18.461801528930664,18.850095748901367,18.443618774414062,18.784839630126957,135815168.0,0.0,0.0,0.316564559936527,0.0,0.316564559936527,71.82263454469606,17.323068618774414,18.850095748901367,95.72659074046803,-4.273409259531969,0.004619633033264847,-0.030169064539428126,0.01716841033979688,137577748.0,1.0
16,2013-01-25,GOOG,18.699161529541016,18.891191482543945,18.686208724975582,18.771390914916992,89369729.0,0.0,0.0,-0.01344871520996449,0.01344871520996449,0.0,71.20110480001931,17.323068618774414,18.891191482543945,92.36025630421774,-7.639743695782268,0.0440130697927863,-0.014990854773761199,0.018486743941670936,48208019.0,-1.0
17,2013-01-28,GOOG,18.723819732666016,18.819459915161133,18.627429962158203,18.698165893554688,65327951.0,0.0,0.0,-0.07322502136230469,0.07322502136230469,0.0,67.52978216746666,17.323068618774414,18.891191482543945,87.69065910274063,-12.309340897259375,0.0690249323426464,0.002120554393314829,0.03799528651001194,-17119932.0,-1.0
18,2013-01-29,GOOG,18.599035263061523,18.853084564208984,18.59380531311035,18.771638870239254,70145942.0,0.0,0.0,0.07347297668456676,0.0,0.07347297668456676,69.35895771939201,17.323068618774414,18.891191482543945,92.37606854240333,-7.62393145759667,0.09212042525009068,0.020383728643868056,0.03965902272477573,53026010.0,1.0
19,2013-01-30,GOOG,18.773134231567383,18.95271110534668,18.752460479736328,18.775375366210938,69579828.0,0.0,0.0,0.00373649597168324,0.0,0.00373649597168324,69.45991212085065,17.323068618774414,18.95271110534668,89.11812004185383,-10.881879958146165,0.10905313286091456,0.038324451944289926,0.054027606202845524,122605838.0,1.0
20,2013-01-31,GOOG,18.692684173583984,18.869770050048828,18.686208724975582,18.821701049804688,65613015.0,0.0,0.0,0.04632568359375,0.0,0.04632568359375,70.83457213802018,17.323068618774414,18.95271110534668,91.96081001683048,-8.039189983169514,0.12389362939827464,0.055597604144074705,0.06237690553515174,188218853.0,1.0
21,2013-02-01,GOOG,18.88421630859375,19.342500686645508,18.88172721862793,19.31759262084961,150405652.0,0.0,0.0,0.4958915710449219,0.0,0.4958915710449219,81.25558151934084,17.323068618774414,19.342500686645508,98.76658065442346,-1.23341934557654,0.16716962419135228,0.07807788333631614,0.10090697808649907,338624505.0,1.0
22,2013-02-04,GOOG,19.120580673217773,19.189821243286133,18.885961532592773,18.904640197753903,122075862.0,0.0,0.0,-0.4129524230957067,0.4129524230957067,0.0,60.488500666550195,17.323068618774414,19.342500686645508,78.31764208076571,-21.682357919234303,0.17069523364850525,0.09671134594787474,0.0798867540725332,216548643.0,-1.0
23,2013-02-05,GOOG,18.95719337463379,19.20576286315918,18.915849685668945,19.07201385498047,75108474.0,0.0,0.0,0.16737365722656605,0.0,0.16737365722656605,64.7068944627477,17.323068618774414,19.342500686645508,86.60579694813953,-13.39420305186047,0.18292516422908278,0.11403592260424832,0.03269058872555619,291657117.0,1.0
24,2013-02-06,GOOG,18.905885696411133,19.25183868408203,18.89168930053711,19.182350158691406,83435569.0,0.0,0.0,0.1103363037109375,0.0,0.1103363037109375,67.35773231430699,17.323068618774414,19.342500686645508,92.06952635337053,-7.930473646629466,0.19795370753975305,0.13088312652826192,0.021161241532609454,375092686.0,1.0
25,2013-02-07,GOOG,19.17064476013184,19.39754295349121,19.066036224365234,19.27649688720703,114033831.0,0.0,0.0,0.094146728515625,0.0,0.094146728515625,69.60536302940848,17.323068618774414,19.39754295349121,94.16497643482754,-5.83502356517246,0.21394346178861312,0.14754555267329253,0.0269082869020989,489126517.0,1.0
26,2013-02-08,GOOG,19.430419921875,19.59330940246582,19.416223526000977,19.560930252075195,121256803.0,0.0,0.0,0.28443336486816406,0.0,0.28443336486816406,75.4888143903832,17.323068618774414,19.59330940246582,98.57375699427016,-1.4262430057298405,0.2440629966861998,0.1668958275697519,0.046141657071183895,610383320.0,1.0
27,2013-02-11,GOOG,19.38733291625977,19.501901626586918,19.27151679992676,19.487455368041992,87037018.0,0.0,0.0,-0.07347488403320312,0.07347488403320312,0.0,71.3710313872605,18.326059341430664,19.59330940246582,91.64694974744282,-8.353050252557178,0.2594496510020363,0.18544246667361636,0.03813287176207081,523346302.0,-1.0
28,2013-02-12,GOOG,19.47076988220215,19.62394523620605,19.41149139404297,19.444616317749023,74638720.0,0.0,0.0,-0.04283905029296875,0.04283905029296875,0.0,68.8446445727146,18.443618774414062,19.62394523620605,84.80683740795169,-15.193162592048301,0.26534947677320986,0.20144863704250418,0.03564461101227745,448707582.0,-1.0
29,2013-02-13,GOOG,19.430419921875,19.56043243408203,19.42643547058105,19.498414993286133,48107646.0,0.0,0.0,0.053798675537109375,0.0,0.053798675537109375,70.36472474769681,18.59380531311035,19.62394523620605,87.81425318002586,-12.185746819974145,0.27078290379362,0.21533267800293934,0.0359539205139201,496815228.0,1.0
30,2013-02-14,GOOG,19.42045783996582,19.64486694335937,19.371639251708984,19.62195205688477,69672173.0,0.0,0.0,0.12353706359863637,0.0,0.12353706359863637,73.75720597792885,18.59380531311035,19.64486694335937,97.81983417383687,-2.1801658261631363,0.28092441479205377,0.2284640300219096,0.015755557227491224,566487401.0,1.0
31,2013-02-15,GOOG,19.61149024963379,19.757444381713867,19.603271484375,19.74822807312012,109601278.0,0.0,0.0,0.12627601623535156,0.0,0.12627601623535156,76.87888829883359,18.59380531311035,19.757444381713867,99.20797532135055,-0.79202467864945,0.2948938693043637,0.24176053245295515,0.04462332350903164,676088679.0,1.0
32,2013-02-19,GOOG,19.825439453125,20.09966278076172,19.807756423950195,20.09592628479004,117711564.0,0.0,0.0,0.3476982116699183,0.0,0.3476982116699183,83.22036746883423,18.686208724975582,20.09966278076172,99.73564786514397,-0.26435213485602255,0.3281534091938383,0.25905006634513983,0.053686644608963885,793800243.0,1.0
33,2013-02-20,GOOG,20.05731964111328,20.148727416992188,19.7208309173584,19.737518310546875,110982436.0,0.0,0.0,-0.35840797424316406,0.35840797424316406,0.0,62.750246536470556,18.686208724975582,20.148727416992188,71.88349737408733,-28.116502625912677,0.3236832833242751,0.27198326765312725,0.028941612850494458,682817807.0,-1.0
34,2013-02-21,GOOG,19.87550163269043,20.06105613708496,19.70663452148437,19.81398200988769,140781714.0,0.0,0.0,0.07646369934081676,0.0,0.07646369934081676,64.87695744009815,18.88172721862793,20.148727416992188,73.57968786929442,-26.420312130705575,0.3221797501935235,0.2820266382363259,0.027882925296315975,823599521.0,1.0
35,2013-02-22,GOOG,19.906883239746094,19.95644760131836,19.770893096923828,19.918092727661133,82463941.0,0.0,0.0,0.10411071777344105,0.0,0.10411071777344105,67.76803583611674,18.885961532592773,20.148727416992188,81.73575227360952,-18.264247726390483,0.3251232351658828,0.29064875565931286,0.01825897188851977,906063462.0,1.0
36,2013-02-25,GOOG,19.98259925842285,20.134780883789062,19.688453674316406,19.69542694091797,92501423.0,0.0,0.0,-0.22266578674316406,0.22266578674316406,0.0,56.32645320831451,18.89168930053711,20.148727416992188,63.9390031105379,-36.0609968894621,0.30686773394670297,0.2938933936729792,0.010672074365185358,813562039.0,-1.0
37,2013-02-26,GOOG,19.80078125,19.824443817138672,19.536771774291992,19.67948532104492,88430220.0,0.0,0.0,-0.015941619873050428,0.015941619873050428,0.0,55.55166122585188,18.89168930053711,20.148727416992188,62.67081405052699,-37.32918594947301,0.2878464841384236,0.29268376053509443,0.012078870544825593,725131819.0,-1.0
38,2013-02-27,GOOG,19.795799255371094,20.043621063232425,19.703895568847656,19.919836044311523,81347773.0,0.0,0.0,0.24035072326660512,0.0,0.24035072326660512,64.13417371914298,19.066036224365234,20.148727416992188,78.85903439139457,-21.140965608605423,0.28795065165503075,0.2917369814484232,0.021613092713971715,806479592.0,1.0
39,2013-02-28,GOOG,19.95271110534668,20.09941291809082,19.95096969604492,19.955202102661133,90971711.0,0.0,0.0,0.035366058349609375,0.0,0.035366058349609375,65.27263908532885,19.27151679992676,20.148727416992188,77.93855767746359,-22.061442322536408,0.2874284773279143,0.2908751660694085,0.01698353175108469,897451303.0,1.0
40,2013-03-01,GOOG,19.870519638061523,20.103147506713867,19.829423904418945,20.079486846923828,87342157.0,0.0,0.0,0.12428474426269531,0.0,0.12428474426269531,69.23274502279375,19.27151679992676,20.148727416992188,92.10673369412774,-7.893266305872255,0.29324720971470697,0.29134962525162245,0.01677410107768562,984793460.0,1.0
41,2013-03-04,GOOG,20.05731964111328,20.49418258666992,20.049848556518555,20.46080780029297,111440145.0,0.0,0.0,0.3813209533691406,0.0,0.3813209533691406,78.08127410866791,19.371639251708984,20.49418258666992,97.02685986923515,-2.9731401307648455,0.3237511006800098,0.29783047166673937,0.018156989149542113,1096233605.0,1.0
42,2013-03-05,GOOG,20.645864486694336,20.925317764282227,20.645116806030277,20.88671112060547,162370331.0,0.0,0.0,0.4259033203125,0.0,0.4259033203125,84.00838368030718,19.371639251708984,20.925317764282227,97.51514593499677,-2.4848540650032227,0.37675177419768957,0.3136158064671471,0.058223774234297476,1258603936.0,1.0
43,2013-03-06,GOOG,20.947235107421875,21.02120780944824,20.64287567138672,20.706886291503903,115350748.0,0.0,0.0,-0.17982482910156605,0.17982482910156605,0.0,74.22947130009247,19.371639251708984,21.02120780944824,80.94522858903689,-19.054771410963113,0.40003871388370627,0.33090132906382574,0.045064353100281895,1143253188.0,-1.0
44,2013-03-07,GOOG,20.77363586425781,20.8373966217041,20.66205406188965,20.73727226257324,82415761.0,0.0,0.0,0.030385971069335938,0.0,0.030385971069335938,74.80136628754072,19.536771774291992,21.02120780944824,80.872497019037,-19.127502980962998,0.41604636554844276,0.3479310781109333,0.04112740843778062,1225668949.0,1.0
45,2013-03-08,GOOG,20.78459358215332,20.795055389404297,20.549226760864254,20.710372924804688,116912581.0,0.0,0.0,-0.026899337768551135,0.026899337768551135,0.0,73.14336720422583,19.536771774291992,21.02120780944824,79.06040561654557,-20.939594383454438,0.42173132283695836,0.3626916413867018,0.05153206309928371,1108756368.0,-1.0
46,2013-03-11,GOOG,20.71460723876953,20.914108276367188,20.70987319946289,20.792564392089844,64027093.0,0.0,0.0,0.08219146728515625,0.0,0.08219146728515625,75.0899896033585,19.536771774291992,21.02120780944824,84.59728732371222,-15.40271267628778,0.42775119348494073,0.3757039145355845,0.05656037507518641,1172783461.0,1.0
47,2013-03-12,GOOG,20.69019889831543,20.719587326049805,20.514854431152344,20.612987518310547,80633104.0,0.0,0.0,-0.17957687377929688,0.17957687377929688,0.0,63.48888291360012,19.536771774291992,21.02120780944824,72.49997430204368,-27.500025697956325,0.41357765004388014,0.38327883056351586,0.0347970471472312,1092150357.0,-1.0
48,2013-03-13,GOOG,20.620210647583008,20.689699172973636,20.480981826782227,20.555702209472656,65898080.0,0.0,0.0,-0.057285308837890625,0.057285308837890625,0.0,60.07274338205623,19.536771774291992,21.02120780944824,68.64091217466404,-31.359087825335962,0.39327537948966196,0.3852781760182599,0.0300924091734176,1026252277.0,-1.0
49,2013-03-14,GOOG,20.597545623779297,20.597545623779297,20.358442306518555,20.461803436279297,66295564.0,0.0,0.0,-0.09389877319335938,0.09389877319335938,0.0,54.524051597871846,19.536771774291992,21.02120780944824,62.315360182558436,-37.684639817441564,0.365535790143646,0.3813296424879834,0.019040157364083266,959956713.0,-1.0
50,2013-03-15,GOOG,20.38608741760254,20.4309196472168,20.257570266723636,20.28148078918457,124452737.0,0.0,0.0,-0.18032264709472656,0.18032264709472656,0.0,45.26062002797625,19.536771774291992,21.02120780944824,50.16780765593531,-49.83219234406468,0.3255097831171412,0.3701655431423347,-0.008764415015219074,835503976.0,-1.0
51,2013-03-18,GOOG,20.049848556518555,20.24312400817871,19.96192741394043,20.11933708190918,73807616.0,0.0,0.0,-0.16214370727539062,0.16214370727539062,0.0,38.47804632213401,19.703895568847656,21.02120780944824,31.537057066448988,-68.46294293355102,0.2777241328671245,0.35167709220665944,-0.036739821519303106,761696360.0,-1.0
52,2013-03-19,GOOG,20.20526695251465,20.404767990112305,20.085962295532227,20.207258224487305,84242583.0,0.0,0.0,0.087921142578125,0.0,0.087921142578125,43.7518437678628,19.829423904418945,21.02120780944824,31.703257484340035,-68.29674251565997,0.24402500435497387,0.33014651730146993,-0.024128594709171503,845938943.0,1.0
53,2013-03-20,GOOG,20.3444938659668,20.36142921447754,20.21024703979492,20.29169273376465,58771467.0,0.0,0.0,0.08443450927734375,0.0,0.08443450927734375,48.631249132878345,19.829423904418945,21.02120780944824,38.78797384282017,-61.21202615717982,0.22147859279310822,0.3084128053443752,-0.021486891967598565,904710410.0,1.0
54,2013-03-21,GOOG,20.20651054382324,20.34673500061035,20.17064476013184,20.20576477050781,59325536.0,0.0,0.0,-0.08592796325683949,0.08592796325683949,0.0,44.13543394517386,19.96192741394043,21.02120780944824,23.019151265466963,-76.98084873453304,0.19452593399040907,0.28563532454774043,-0.02436499603985942,845384874.0,-1.0
55,2013-03-22,GOOG,20.29243850708008,20.30489158630371,20.165414810180664,20.18210220336914,59751126.0,0.0,0.0,-0.023662567138668322,0.023662567138668322,0.0,42.875979882216114,19.96192741394043,21.02120780944824,20.785317123060814,-79.21468287693918,0.16932782268678537,0.26237373714361834,-0.029359639206068433,785633748.0,-1.0
56,2013-03-25,GOOG,20.234405517578125,20.40427017211914,20.095178604125977,20.165414810180664,68736680.0,0.0,0.0,-0.016687393188476562,0.016687393188476562,0.0,41.90297649848577,19.96192741394043,21.02120780944824,19.209965284280038,-80.79003471571995,0.1463400536543844,0.2391669309841955,-0.02171314118015666,716897068.0,-1.0
57,2013-03-26,GOOG,20.261554718017575,20.27400779724121,20.11933708190918,20.234655380249023,47854701.0,0.0,0.0,0.06924057006835938,0.0,0.06924057006835938,47.59649422168717,19.96192741394043,20.914108276367188,28.642454083094126,-71.35754591690588,0.1321263182085879,0.21775875716668194,-0.015618382965077449,764751769.0,1.0
58,2013-03-27,GOOG,20.09169006347656,20.09966278076172,19.95844078063965,19.991567611694336,86852328.0,0.0,0.0,-0.2430877685546875,0.2430877685546875,0.0,34.07080135329099,19.95844078063965,20.914108276367188,3.4663553173866624,-96.53364468261334,0.1002842430973594,0.194263809345439,-0.022981152470227584,677899441.0,-1.0
59,2013-03-28,GOOG,20.02469253540039,20.059064865112305,19.758441925048828,19.780607223510746,91855009.0,0.0,0.0,-0.2109603881835902,0.2109603881835902,0.0,26.523372652961143,19.758441925048828,20.914108276367188,1.9179669319463977,-98.0820330680536,0.05752119273197209,0.16691524411119132,-0.02469610433676639,586044432.0,-1.0
60,2013-04-01,GOOG,19.8010311126709,19.981355667114254,19.75719451904297,19.954954147338867,72562968.0,0.0,0.0,0.17434692382812145,0.0,0.17434692382812145,39.33772457894679,19.75719451904297,20.719587326049805,20.548743387947386,-79.45125661205262,0.03715486549197067,0.14096313657015597,-0.008170395172618417,658607400.0,1.0
61,2013-04-02,GOOG,20.03839111328125,20.294681549072266,20.02494239807129,20.250097274780277,81966082.0,0.0,0.0,0.2951431274414098,0.0,0.2951431274414098,54.75173523990179,19.75719451904297,20.689699172973636,52.85794056465437,-47.14205943534563,0.044135096497171844,0.12159750956180744,0.0021199833157503623,740573482.0,1.0
62,2013-04-03,GOOG,20.260557174682617,20.27898979187012,19.94200134277344,20.079736709594727,69800653.0,0.0,0.0,-0.17036056518555043,0.17036056518555043,0.0,46.8271117986142,19.75719451904297,20.597545623779297,38.381836917196644,-61.618163082803356,0.03560882059546344,0.10439975827453433,-0.010445457998545127,670772829.0,-1.0
63,2013-04-04,GOOG,20.03116798400879,20.068527221679688,19.708627700805664,19.80252456665039,98270968.0,0.0,0.0,-0.27721214294433594,0.27721214294433594,0.0,36.82096268397487,19.708627700805664,20.4309196472168,12.99984948070838,-87.00015051929162,0.006558468822483121,0.08483148810092184,-0.019956690995729387,572501861.0,-1.0
64,2013-04-05,GOOG,19.57811546325684,19.601280212402344,19.3375186920166,19.50314712524414,137870844.0,0.0,0.0,-0.29937744140625,0.29937744140625,0.0,29.07825774754498,19.3375186920166,20.404767990112305,15.519188770896406,-84.4808112291036,-0.040007412800509456,0.05986369538260559,-0.033641444844712765,434631017.0,-1.0
65,2013-04-08,GOOG,19.39604949951172,19.41597366333008,19.13826560974121,19.298912048339844,113708616.0,0.0,0.0,-0.20423507690429688,0.20423507690429688,0.0,24.948690903497493,19.13826560974121,20.404767990112305,12.684258718215935,-87.31574128178407,-0.0922294296455668,0.02944505815675477,-0.04296974646925489,320922401.0,-1.0
66,2013-04-09,GOOG,19.31510162353516,19.52058219909668,19.25557518005371,19.36865234375,86615444.0,0.0,0.0,0.06974029541015625,0.0,0.06974029541015625,28.92564347038389,19.13826560974121,20.40427017211914,18.19793868483814,-81.80206131516185,-0.12655562974444834,-0.0017550894508266835,-0.042798012628587956,407537845.0,1.0
67,2013-04-10,GOOG,19.499910354614254,19.73477935791016,19.327556610107425,19.68073272705078,79440651.0,0.0,0.0,0.31208038330078125,0.0,0.31208038330078125,44.1943129319758,19.13826560974121,20.40427017211914,42.84874900376798,-57.151250996232015,-0.12723232511864424,-0.026850543036684448,-0.015548299697204726,486978496.0,1.0
68,2013-04-11,GOOG,19.74798011779785,19.75345993041992,19.528303146362305,19.685962677001957,81452163.0,0.0,0.0,0.005229949951175428,0.0,0.005229949951175428,44.425171160988306,19.13826560974121,20.40427017211914,43.26185572601802,-56.73814427398198,-0.12589616550790694,-0.046659671605430365,-0.0047847139088984525,568430659.0,1.0
69,2013-04-12,GOOG,19.725812911987305,19.728553771972656,19.500158309936523,19.677494049072266,65713390.0,0.0,0.0,-0.008468627929691053,0.008468627929691053,0.0,44.08443703995415,19.13826560974121,20.40427017211914,42.59293018014286,-57.40706981985715,-0.124086368787097,-0.06214501358988378,-0.013904321514244256,502717269.0,-1.0
70,2013-04-15,GOOG,19.57537651062012,19.850595474243164,19.35296058654785,19.475252151489254,98491793.0,0.0,0.0,-0.20224189758301137,0.20224189758301137,0.0,36.39295803997655,19.13826560974121,20.294681549072266,29.140599872998813,-70.8594001270012,-0.1373232793880348,-0.0771806687288131,-0.03826377289831706,404225476.0,-1.0
71,2013-04-16,GOOG,19.59131622314453,19.825687408447266,19.524816513061523,19.760183334350582,69941178.0,0.0,0.0,0.2849311828613281,0.0,0.2849311828613281,50.44725266633709,19.13826560974121,20.294681549072266,53.77976067755764,-46.22023932244235,-0.12348099962967041,-0.08644073588418344,-0.015914221379777937,474166654.0,1.0
72,2013-04-17,GOOG,19.59530258178711,19.69717025756836,19.379859924316406,19.490943908691406,81785407.0,0.0,0.0,-0.26923942565917613,0.26923942565917613,0.0,40.65351372118697,19.13826560974121,20.294681549072266,30.497530080241464,-69.50246991975854,-0.1326337538941864,-0.09567934026453491,-0.015734390678838972,392381247.0,-1.0
73,2013-04-18,GOOG,19.56043243408203,19.57164192199707,18.960432052612305,19.076248168945312,133398142.0,0.0,0.0,-0.41469573974609375,0.41469573974609375,0.0,30.225112086965353,18.960432052612305,20.294681549072266,8.68024433513311,-91.31975566486689,-0.17126993960131998,-0.11079746115085125,-0.021888721525679666,258983105.0,-1.0
74,2013-04-19,GOOG,19.15719413757324,20.01099395751953,19.084964752197266,19.92207717895508,232998073.0,0.0,0.0,0.8458290100097692,0.0,0.8458290100097692,56.491286066248804,18.960432052612305,20.294681549072266,72.073860915385,-27.926139084615,-0.1323082428040081,-0.11509961771345444,0.03229016895119985,491981178.0,1.0
75,2013-04-22,GOOG,19.94025993347168,20.023944854736328,19.302648544311523,19.928054809570312,115768308.0,0.0,0.0,0.005977630615230822,0.0,0.005977630615230822,56.62443485506889,18.960432052612305,20.27898979187012,73.38493629430737,-26.615063705692627,-0.09979977360837111,-0.11203964876044321,0.028881847631532453,607749486.0,1.0
76,2013-04-23,GOOG,19.95022201538086,20.311368942260746,19.93428039550781,20.12207794189453,92035684.0,0.0,0.0,0.19402313232421875,0.0,0.19402313232421875,61.08463572374714,18.960432052612305,20.311368942260746,85.98816852092371,-14.011831479076298,-0.05775399505650114,-0.10118251764498899,0.02242524305190785,699785170.0,1.0
77,2013-04-24,GOOG,20.127307891845703,20.373634338378903,20.124568939208984,20.26030921936035,73438237.0,0.0,0.0,0.1382312774658203,0.0,0.1382312774658203,64.1177556855366,18.960432052612305,20.373634338378903,91.98096973377895,-8.019030266221046,-0.013153062621679368,-0.08357662615428149,0.02917543590740279,773223407.0,1.0
78,2013-04-25,GOOG,20.330047607421875,20.335527420043945,20.115352630615234,20.15196418762207,79986690.0,0.0,0.0,-0.10834503173828125,0.10834503173828125,0.0,59.895783900123234,18.960432052612305,20.373634338378903,84.31433680871905,-15.685663191280957,0.013315118232899437,-0.06419827684886308,0.02411232534826624,693236717.0,-1.0
79,2013-04-26,GOOG,20.114606857299805,20.118091583251957,19.840133666992188,19.960681915283203,99880980.0,0.0,0.0,-0.1912822723388672,0.1912822723388672,0.0,52.81174179850325,18.960432052612305,20.373634338378903,70.77895873401509,-29.22104126598491,0.018671025701930688,-0.047624416045869554,0.024925467460857886,593355737.0,-1.0
80,2013-04-29,GOOG,20.006261825561523,20.49069595336914,20.00003433227539,20.400035858154297,92376959.0,0.0,0.0,0.43935394287109375,0.0,0.43935394287109375,64.07313090477666,18.960432052612305,20.49069595336914,94.07552545871303,-5.924474541286977,0.05763860343795102,-0.026571811851531586,0.032380900165607907,685732696.0,1.0
81,2013-04-30,GOOG,20.39854049682617,20.61373519897461,20.365663528442383,20.53727149963379,92613843.0,0.0,0.0,0.1372356414794922,0.0,0.1372356414794922,66.91852953620659,18.960432052612305,20.61373519897461,95.37509503268893,-4.624904967311062,0.09844014522952804,-0.0015694201525970936,0.05368275625049668,778346539.0,1.0
82,2013-05-01,GOOG,20.5046443939209,20.54100608825684,20.332788467407227,20.434158325195312,58418148.0,0.0,0.0,-0.10311317443847656,0.10311317443847656,0.0,62.618962155419666,18.960432052612305,20.61373519897461,89.13829722187292,-10.86170277812708,0.12107170077661777,0.022958804255134493,0.07118329265922285,719928391.0,-1.0
83,2013-05-02,GOOG,20.425939559936523,20.785839080810547,20.39978790283203,20.66280174255371,81034603.0,0.0,0.0,0.22864341735839844,0.0,0.22864341735839844,67.89641493167463,18.960432052612305,20.785839080810547,93.25973131711456,-6.740268682885442,0.15563555240757765,0.04949415407765959,0.037181090954767626,800962994.0,1.0
84,2013-05-03,GOOG,20.84586524963379,21.09094619750977,20.82195472717285,21.06404685974121,100880714.0,0.0,0.0,0.4012451171875,0.0,0.4012451171875,75.03361190639392,18.960432052612305,21.09094619750977,98.73742505615456,-1.2625749438454363,0.2129062845216403,0.08217658035567404,0.05700466307556251,901843708.0,1.0
85,2013-05-06,GOOG,21.127309799194336,21.465791702270508,21.127309799194336,21.45831871032715,85973045.0,0.0,0.0,0.3942718505859375,0.0,0.3942718505859375,80.05978927461295,18.960432052612305,21.465791702270508,99.70171979322893,-0.29828020677106726,0.28676188825542326,0.12309364212513876,0.06640669876596283,987816753.0,1.0
86,2013-05-07,GOOG,21.49468231201172,21.516101837158203,21.187334060668945,21.35072135925293,78653713.0,0.0,0.0,-0.10759735107421875,0.10759735107421875,0.0,75.28717010434035,18.960432052612305,21.516101837158203,93.52887924311165,-6.471120756888352,0.3327831370918801,0.1650315412738815,0.05382011340925641,909163040.0,-1.0
87,2013-05-08,GOOG,21.344993591308597,21.765417098999023,21.243125915527344,21.759191513061523,99102072.0,0.0,0.0,0.40847015380859375,0.0,0.40847015380859375,80.40414430534497,19.084964752197266,21.765417098999023,99.76774121931591,-0.23225878068409606,0.39759597738525443,0.21154442863403322,0.07975536828448004,1008265112.0,1.0
88,2013-05-09,GOOG,21.689701080322266,21.90937805175781,21.62469482421875,21.705642700195312,88353936.0,0.0,0.0,-0.05354881286621094,0.05354881286621094,0.0,77.96232809724386,19.302648544311523,21.90937805175781,92.18425421661458,-7.815745783385415,0.4395753871145125,0.2571506204382806,0.0874198983941552,919911176.0,-1.0
89,2013-05-10,GOOG,21.801034927368164,21.93129539489746,21.72257804870605,21.92357444763184,76192522.0,0.0,0.0,0.217931747436527,0.0,0.217931747436527,80.71288352788306,19.840133666992188,21.93129539489746,99.6307819159757,-0.3692180840243072,0.48482371788401935,0.30268524001381375,0.07468313291559991,996103698.0,1.0
90,2013-05-13,GOOG,21.890199661254883,21.979366302490234,21.752965927124023,21.85632705688477,58157173.0,0.0,0.0,-0.06724739074707031,0.06724739074707031,0.0,77.27874664490744,19.840133666992188,21.979366302490234,94.2484401385911,-5.751559861408889,0.5093885479708256,0.3440259016679592,0.06422740027926799,937946525.0,-1.0
91,2013-05-14,GOOG,21.855579376220703,22.13428497314453,21.846614837646484,22.09468460083008,63408784.0,0.0,0.0,0.2383575439453125,0.0,0.2383575439453125,80.64646927744059,19.840133666992188,22.13428497314453,98.2738552505996,-1.7261447494004083,0.5418279822336522,0.38358631782913083,0.08126227903340366,1001355309.0,1.0
92,2013-05-15,GOOG,22.30389976501465,22.823949813842773,22.267038345336918,22.81174659729004,160033605.0,0.0,0.0,0.7170619964599574,0.0,0.7170619964599574,87.22111848192806,19.840133666992188,22.823949813842773,99.5910198232014,-0.40898017679858906,0.618227981306049,0.4305146505700976,0.10400065206601261,1161388914.0,1.0
93,2013-05-16,GOOG,22.889205932617188,22.91361427307129,22.466041564941406,22.51236724853516,128865215.0,0.0,0.0,-0.29937934875487926,0.29937934875487926,0.0,74.95454191854303,20.00003433227539,22.91361427307129,86.22838457535093,-13.771615424649072,0.6471727950112474,0.47384627949199903,0.06875793613819092,1032523699.0,-1.0
94,2013-05-17,GOOG,22.66554450988769,22.75197029113769,22.428930282592773,22.64462280273437,112098604.0,0.0,0.0,0.13225555419921164,0.0,0.13225555419921164,76.62988068920811,20.332788467407227,22.91361427307129,89.57731010955602,-10.422689890443978,0.6730179947895927,0.5136806225762809,0.055284111883206144,1144622303.0,1.0
95,2013-05-20,GOOG,22.540512084960938,22.92905616760254,22.540512084960938,22.628433227539062,91248746.0,0.0,0.0,-0.016189575195308947,0.016189575195308947,0.0,75.9126526369192,20.332788467407227,22.92905616760254,88.42095751370857,-11.579042486291428,0.6843057598966951,0.5478056500573348,0.05984396717970375,1053373557.0,-1.0
96,2013-05-21,GOOG,22.61573028564453,22.70639038085937,22.35645294189453,22.58957862854004,79617311.0,0.0,0.0,-0.03885459899902344,0.03885459899902344,0.0,73.99480013206653,20.39978790283203,22.92905616760254,86.57803350514493,-13.421966494855079,0.6822524949020696,0.57469501903698,0.03816259050709925,973756246.0,-1.0
97,2013-05-22,GOOG,22.479740142822266,22.647859573364254,22.089204788208008,22.152467727661133,102807910.0,0.0,0.0,-0.43711090087890625,0.43711090087890625,0.0,55.72137449151005,20.82195472717285,22.92905616760254,63.14423097812312,-36.855769021876874,0.6380161686557777,0.5873592489647704,0.020585662154191775,870948336.0,-1.0
98,2013-05-23,GOOG,21.84312629699707,22.165916442871094,21.768407821655277,21.987335205078125,91345105.0,0.0,0.0,-0.1651325225830078,0.1651325225830078,0.0,50.30601187477743,21.127309799194336,22.92905616760254,47.73287855402198,-52.26712144597801,0.5829199478850384,0.5864713887485979,0.0029083194256751543,779603231.0,-1.0
99,2013-05-24,GOOG,21.799789428710938,21.88845634460449,21.69393539428711,21.7514705657959,92216359.0,0.0,0.0,-0.23586463928222656,0.23586463928222656,0.0,43.36086013917254,21.187334060668945,22.92905616760254,32.38958171807036,-67.61041828192964,0.514302743692781,0.5720376597344943,-0.004797534865577546,687386872.0,-1.0
100,2013-05-28,GOOG,22.00502014160156,22.220212936401367,21.92780876159668,21.949478149414062,90638467.0,0.0,0.0,0.19800758361816406,0.0,0.19800758361816406,50.04177236718665,21.243125915527344,22.92905616760254,41.8968835168167,-58.10311648318331,0.47047102936595664,0.5517243336574764,-0.006572008337723201,778025339.0,1.0
101,2013-05-29,GOOG,21.810997009277344,21.86778450012207,21.52656364440918,21.62668800354004,80837869.0,0.0,0.0,-0.32279014587402344,0.32279014587402344,0.0,40.9549529212408,21.52656364440918,22.92905616760254,7.139029796956385,-92.8609702030436,0.40502797516150935,0.522385061954458,-0.05194948964980972,697187470.0,-1.0
102,2013-05-30,GOOG,21.66678810119629,21.89044952392578,21.579364776611328,21.68770980834961,85145956.0,0.0,0.0,0.06102180480957031,0.0,0.06102180480957031,43.20455352886312,21.52656364440918,22.92905616760254,11.489983816349566,-88.51001618365044,0.35400540091431054,0.48870912974291625,-0.03663130718690677,782333426.0,1.0
103,2013-05-31,GOOG,21.62195587158203,21.84312629699707,21.607011795043945,21.69916534423828,79071272.0,0.0,0.0,0.011455535888671875,0.0,0.011455535888671875,43.66943721519208,21.52656364440918,22.92905616760254,12.306782173505052,-87.69321782649496,0.3109097064627413,0.4531492450839143,-0.04175196322466124,861404698.0,1.0
104,2013-06-03,GOOG,21.74349975585937,21.767658233642575,21.295679092407227,21.609750747680664,99399181.0,0.0,0.0,-0.08941459655761719,0.08941459655761719,0.0,40.671246923098714,21.295679092407227,22.92905616760254,19.228361903872205,-80.7716380961278,0.26647136496213975,0.4158136690570673,-0.0450178087724894,762005517.0,-1.0
105,2013-06-04,GOOG,21.61523056030273,21.68347549438477,21.272016525268555,21.39729881286621,75024159.0,0.0,0.0,-0.21245193481445312,0.21245193481445312,0.0,34.22851785603142,21.272016525268555,22.92905616760254,7.560608955691175,-92.43939104430882,0.21167505535545672,0.37498594631456494,-0.052780082146706486,686981358.0,-1.0
106,2013-06-05,GOOG,21.48222923278809,21.65508079528809,21.34823226928711,21.412242889404297,84587872.0,0.0,0.0,0.014944076538085938,0.0,0.014944076538085938,35.063405795544824,21.272016525268555,22.92905616760254,8.462462849605073,-91.53753715039493,0.16752309004857224,0.33349337505959387,-0.033415005829465216,771569230.0,1.0
107,2013-06-06,GOOG,21.526811599731445,21.577373504638672,21.10140609741211,21.535280227661133,103550684.0,0.0,0.0,0.12303733825683594,0.0,0.12303733825683594,42.051352925014,21.10140609741211,22.92905616760254,23.73945304550649,-76.26054695449352,0.14083473711941963,0.29496164747024217,-0.020559789224143366,875119914.0,1.0
108,2013-06-07,GOOG,21.67924118041992,21.9178466796875,21.552217483520508,21.911121368408203,107385002.0,0.0,0.0,0.3758411407470703,0.0,0.3758411407470703,57.98671779430021,21.10140609741211,22.92905616760254,44.303627056558284,-55.69637294344171,0.1482954046499252,0.2656283989053768,0.00733977052858914,982504916.0,1.0
109,2013-06-10,GOOG,21.970149993896484,22.19182014465332,21.92008781433105,22.17239189147949,93862506.0,0.0,0.0,0.2612705230712855,0.0,0.2612705230712855,65.57905522354892,21.10140609741211,22.70639038085937,66.72874028193377,-33.27125971806623,0.17328862955726976,0.24716044503535148,0.01015576500489046,1076367422.0,1.0
110,2013-06-11,GOOG,22.016725540161133,22.092193603515625,21.90589141845703,21.91311454772949,70567517.0,0.0,0.0,-0.25927734375,0.25927734375,0.0,54.33569388118693,21.10140609741211,22.647859573364254,52.48838474223182,-47.51161525776818,0.1702159642675518,0.23177154888152227,0.01324412430338695,1005799905.0,-1.0
111,2013-06-12,GOOG,22.05383682250977,22.067285537719727,21.660062789916992,21.718095779418945,88522565.0,0.0,0.0,-0.19501876831054332,0.19501876831054332,0.0,47.29795536178439,21.10140609741211,22.220212936401367,55.12029963670584,-44.87970036329416,0.15031432999819216,0.21548010510462817,0.0014010686853453969,917277340.0,-1.0
112,2013-06-13,GOOG,21.64337539672852,21.90937805175781,21.556699752807617,21.84312629699707,83106340.0,0.0,0.0,0.125030517578125,0.0,0.125030517578125,51.906093512592165,21.10140609741211,22.220212936401367,66.29564405014176,-33.70435594985825,0.14298128212641004,0.2009803405088222,0.0066344004700169545,1000383680.0,1.0
113,2013-06-14,GOOG,21.920337677001957,22.03490829467773,21.77164459228516,21.794309616088867,90136592.0,0.0,0.0,-0.048816680908203125,0.048816680908203125,0.0,49.93894340341043,21.10140609741211,22.220212936401367,61.93236352601619,-38.067636473983804,0.13171292454391903,0.18712685731571746,0.008540536656953979,910247088.0,-1.0
114,2013-06-17,GOOG,21.89866828918457,22.1527156829834,21.87500762939453,22.07351303100586,86173794.0,0.0,0.0,0.2792034149169922,0.0,0.2792034149169922,59.95446628037782,21.10140609741211,22.19182014465332,89.15025774413101,-10.849742255868993,0.143653093066348,0.17843210446578125,0.031602784260461814,996420882.0,1.0
115,2013-06-18,GOOG,22.133289337158203,22.44088554382324,22.125816345214844,22.431421279907227,87000883.0,0.0,0.0,0.3579082489013672,0.0,0.3579082489013672,69.09873147226153,21.10140609741211,22.44088554382324,99.29343716759747,-0.7065628324025202,0.17991837300138513,0.17872935817290375,0.04759792777277272,1083421765.0,1.0
116,2013-06-19,GOOG,22.450101852416992,22.68596649169922,22.35371208190918,22.43291664123535,117073180.0,0.0,0.0,0.001495361328125,0.0,0.001495361328125,69.13271086086168,21.10140609741211,22.68596649169922,84.03028048812783,-15.969719511872176,0.20640018385157077,0.18426352330866255,0.04168213295043377,1200494945.0,1.0
117,2013-06-20,GOOG,22.26629066467285,22.44088554382324,22.000288009643555,22.035903930664062,135385563.0,0.0,0.0,-0.39701271057128906,0.39701271057128906,0.0,51.71287350711821,21.10140609741211,22.68596649169922,58.9752108295236,-41.0247891704764,0.19312864957051445,0.18603654856103946,0.005694941858875868,1065109382.0,-1.0
118,2013-06-21,GOOG,22.125568389892575,22.163923263549805,21.74524307250977,21.94100952148437,159889066.0,0.0,0.0,-0.09489440917969105,0.09489440917969105,0.0,48.35267354245688,21.10140609741211,22.68596649169922,52.98652087350688,-47.013479126493124,0.17296062183322647,0.18342136321546917,-0.010435607088653098,905220316.0,-1.0
119,2013-06-24,GOOG,21.71560478210449,21.826190948486328,21.500659942626957,21.663549423217773,121128323.0,0.0,0.0,-0.277460098266598,0.277460098266598,0.0,39.65879148114892,21.10140609741211,22.68596649169922,35.476295370778296,-64.5237046292217,0.1330568244235799,0.17334845545706765,-0.011388847713460826,784091993.0,-1.0
120,2013-06-25,GOOG,21.84960174560547,21.909875869750977,21.53204345703125,21.57413482666016,102510801.0,0.0,0.0,-0.08941459655761363,0.08941459655761363,0.0,37.17347228749971,21.10140609741211,22.68596649169922,29.833430833712725,-70.16656916628727,0.09314467171068941,0.15730769870776184,-0.006628617638532064,681581192.0,-1.0
121,2013-06-26,GOOG,21.76218032836914,21.868032455444336,21.6829776763916,21.759689331054688,73530581.0,0.0,0.0,0.1855545043945277,0.0,0.1855545043945277,45.370902213924865,21.500659942626957,22.68596649169922,21.853366846785146,-78.14663315321485,0.07561392644722886,0.1409689442556307,-0.0038198271075259305,755111773.0,1.0
122,2013-06-27,GOOG,21.887958526611328,22.03465843200684,21.83440971374512,21.84486961364746,77348840.0,0.0,0.0,0.08518028259277344,0.0,0.08518028259277344,48.902336877856335,21.500659942626957,22.68596649169922,29.03971730266037,-70.96028269733962,0.06781183743770924,0.12633752289202882,0.0023198714916516927,832460613.0,1.0
123,2013-06-28,GOOG,21.79082298278809,21.96367454528809,21.77313995361328,21.927061080932617,94324230.0,0.0,0.0,0.08219146728515625,0.0,0.08219146728515625,52.33301810559333,21.500659942626957,22.68596649169922,35.9739122878722,-64.02608771212779,0.06748244989238827,0.11456650829208939,-0.006634736839012723,926784843.0,1.0
124,2013-07-01,GOOG,22.078493118286133,22.218719482421875,22.04237937927246,22.114110946655277,69250599.0,0.0,0.0,0.1870498657226598,0.0,0.1870498657226598,59.47726774282802,21.500659942626957,22.68596649169922,51.75462875055129,-48.24537124944871,0.0813757814964653,0.10792836293295947,-0.014145797062630971,996035442.0,1.0
125,2013-07-02,GOOG,22.171894073486328,22.19182014465332,21.849851608276367,21.97538185119629,75943592.0,0.0,0.0,-0.13872909545898793,0.13872909545898793,0.0,52.71584348894057,21.500659942626957,22.68596649169922,40.05055982698287,-59.94944017301713,0.08026741744701837,0.10239617383576784,-0.020395688949248814,920091850.0,-1.0
126,2013-07-03,GOOG,21.915355682373047,22.146240234375,21.8804874420166,22.07799530029297,42036977.0,0.0,0.0,0.10261344909667969,0.0,0.10261344909667969,56.89772750297203,21.500659942626957,22.68596649169922,48.707683098342095,-51.292316901657905,0.08666956103473566,0.09925085127555985,0.0019101267532000143,962128827.0,1.0
127,2013-07-05,GOOG,22.16716194152832,22.301658630371094,22.10066032409668,22.25383758544922,68331166.0,0.0,0.0,0.17584228515625,0.0,0.17584228515625,63.313256102185676,21.500659942626957,22.68596649169922,63.5428567750489,-36.45714322495111,0.10472440553452245,0.1003455621273528,0.0142576878086913,1030459993.0,1.0
128,2013-07-08,GOOG,22.396303176879883,22.5721435546875,22.34325218200684,22.54275321960449,79075287.0,0.0,0.0,0.2889156341552699,0.0,0.2889156341552699,71.38723683223724,21.500659942626957,22.68596649169922,87.91761741240501,-12.082382587594994,0.14072283809093733,0.10842101732007223,0.040584475757441396,1109535280.0,1.0
129,2013-07-09,GOOG,22.6899528503418,22.7385196685791,22.36566734313965,22.54648971557617,79472771.0,0.0,0.0,0.0037364959716796875,0.0,0.0037364959716796875,71.48089718324336,21.500659942626957,22.7385196685791,84.48693749566604,-15.513062504333956,0.16762108832474354,0.12026103152100949,0.04507040012165042,1189008051.0,1.0
130,2013-07-10,GOOG,22.50190734863281,22.693439483642575,22.425443649291992,22.565170288085938,68592140.0,0.0,0.0,0.018680572509769178,0.0,0.018680572509769178,72.0094411512597,21.500659942626957,22.7385196685791,85.996040031125,-14.003959968874993,0.18827511163051724,0.1338638475429138,0.03701711659466089,1257600191.0,1.0
131,2013-07-11,GOOG,22.739765167236328,22.93428611755371,22.628183364868164,22.920089721679688,103755449.0,0.0,0.0,0.35491943359375,0.0,0.35491943359375,80.09612417060448,21.500659942626957,22.93428611755371,99.00975609107104,-0.9902439089289611,0.23062307631232315,0.1532156932967988,0.04922071530060723,1361355640.0,1.0
132,2013-07-12,GOOG,22.914112091064453,22.988832473754883,22.795557022094727,22.988832473754883,103113050.0,0.0,0.0,0.06874275207519531,0.0,0.06874275207519531,81.3032956153474,21.500659942626957,22.988832473754883,100.0,-0.0,0.26665703891636383,0.17590396242071474,0.048422877507536155,1464468690.0,1.0
133,2013-07-15,GOOG,23.021211624145508,23.113365173339844,22.82345199584961,23.03092384338379,78713937.0,0.0,0.0,0.04209136962890625,0.0,0.04209136962890625,82.07152124248458,21.53204345703125,23.113365173339844,94.78655550570038,-5.213444494299623,0.29520753527384613,0.19976467699134345,0.04145827516828926,1543182627.0,1.0
134,2013-07-16,GOOG,23.091697692871094,23.11261749267578,22.762182235717773,22.90439987182617,79617311.0,0.0,0.0,-0.12652397155762074,0.12652397155762074,0.0,71.83427588021954,21.6829776763916,23.113365173339844,85.39100055338105,-14.608999446618956,0.3041191531617571,0.22063557222542787,0.042275398303456724,1463565316.0,-1.0
135,2013-07-17,GOOG,22.93901824951172,23.0849723815918,22.82195854187012,22.87799835205078,60469809.0,0.0,0.0,-0.026401519775387072,0.026401519775387072,0.0,69.73980008739909,21.77313995361328,23.113365173339844,82.43826352282171,-17.56173647717828,0.3055293788228113,0.23761433354490566,0.036235312168365175,1403095507.0,-1.0
136,2013-07-18,GOOG,22.88895606994629,22.914112091064453,22.49543190002441,22.681982040405277,145924920.0,0.0,0.0,-0.19601631164550426,0.19601631164550426,0.0,55.80173413679195,21.77313995361328,23.113365173339844,67.8126387576426,-32.18736124235739,0.28751617984373823,0.2475947028046727,0.019239129130519173,1257170587.0,-1.0
137,2013-07-19,GOOG,22.08247947692871,22.48945426940918,21.80850601196289,22.331296920776367,295475379.0,0.0,0.0,-0.3506851196289098,0.3506851196289098,0.0,39.503769066241134,21.80850601196289,23.113365173339844,40.06492993939678,-59.93507006060322,0.24215248175912762,0.2465062585955636,-0.009380233938959481,961695208.0,-1.0
138,2013-07-22,GOOG,22.46579360961914,22.73154640197754,22.341259002685547,22.68247985839844,116563276.0,0.0,0.0,0.35118293762207387,0.0,0.35118293762207387,54.76853941575554,21.80850601196289,23.113365173339844,66.97840443663584,-33.02159556336416,0.23186555612030801,0.2435781181005124,0.006031543913832538,1078258484.0,1.0
139,2013-07-23,GOOG,22.68247985839844,22.739765167236328,22.40526962280273,22.5106258392334,82134711.0,0.0,0.0,-0.17185401916504262,0.17185401916504262,0.0,47.93853605491493,21.80850601196289,23.113365173339844,53.80809270861045,-46.19190729138955,0.20745476400426455,0.23635344728126262,-0.002417196420686385,996123773.0,-1.0
140,2013-07-24,GOOG,22.5968017578125,22.672517776489254,22.43341445922852,22.488208770751957,83451629.0,0.0,0.0,-0.02241706848144176,0.02241706848144176,0.0,47.05532286211146,21.80850601196289,23.113365173339844,52.090124276079685,-47.909875723920315,0.18417711622305433,0.22591818106962072,-0.01884289966453412,912672144.0,-1.0
141,2013-07-25,GOOG,22.263301849365234,22.337522506713867,22.069278717041016,22.109628677368164,120493954.0,0.0,0.0,-0.3785800933837926,0.3785800933837926,0.0,34.624683757142535,21.80850601196289,23.113365173339844,23.077024273448306,-76.9229757265517,0.13364113832943048,0.20746277252158238,-0.03824482158415221,792178190.0,-1.0
142,2013-07-26,GOOG,22.091943740844727,22.16666412353516,21.967660903930664,22.051097869873047,71374530.0,0.0,0.0,-0.05853080749511719,0.05853080749511719,0.0,33.066400959510986,21.80850601196289,23.113365173339844,18.591420828448726,-81.40857917155128,0.08785539943309928,0.1835412979038854,-0.04254392833625831,720803660.0,-1.0
143,2013-07-29,GOOG,22.039888381958008,22.286962509155277,21.940013885498047,21.974384307861328,75959652.0,0.0,0.0,-0.07671356201171875,0.07671356201171875,0.0,30.95929187646672,21.80850601196289,23.113365173339844,12.712352475143323,-87.28764752485668,0.04486267201185257,0.15580557272547851,-0.040604231901697485,644844008.0,-1.0
144,2013-07-30,GOOG,22.05383682250977,22.306638717651367,21.93951416015625,22.18982696533203,70487217.0,0.0,0.0,0.21544265747070312,0.0,0.21544265747070312,42.775757583201404,21.80850601196289,23.113365173339844,29.223150256825537,-70.77684974317447,0.02785374197871704,0.130215206576126,-0.03008005228993571,715331225.0,1.0
145,2013-07-31,GOOG,22.241384506225582,22.32905578613281,22.07176971435547,22.11087226867676,87265872.0,0.0,0.0,-0.07895469665526988,0.07895469665526988,0.0,39.88887990957233,21.80850601196289,23.113365173339844,23.1723289120949,-76.8276710879051,0.007911933891133316,0.1057545520391273,-0.025179006433880047,628065353.0,-1.0
146,2013-08-01,GOOG,22.291446685791016,22.52930450439453,22.291446685791016,22.521085739135746,85856610.0,0.0,0.0,0.4102134704589844,0.0,0.4102134704589844,57.2036649934521,21.80850601196289,23.113365173339844,54.6097041171022,-45.39029588289781,0.02492105850835813,0.08958785333297338,0.008498781733666583,713921963.0,1.0
147,2013-08-02,GOOG,22.501657485961918,22.5903263092041,22.436403274536133,22.57961654663086,68812965.0,0.0,0.0,0.058530807495113635,0.0,0.058530807495113635,59.14128876427519,21.80850601196289,23.11261749267578,59.12918842233045,-40.87081157766955,0.04263236799469183,0.08019675626531704,-0.004534923536127167,782734928.0,1.0
148,2013-08-05,GOOG,22.55022621154785,22.553464889526367,22.396053314208984,22.540512084960938,52584363.0,0.0,0.0,-0.039104461669921875,0.039104461669921875,0.0,57.14674275244182,21.80850601196289,23.0849723815918,57.346287408328145,-42.653712591671855,0.05290349467581379,0.07473810394741638,0.0013276505922572568,730150565.0,-1.0
149,2013-08-06,GOOG,22.532791137695312,22.65782356262207,22.309627532958984,22.330549240112305,60469809.0,0.0,0.0,-0.2099628448486328,0.2099628448486328,0.0,47.27020355892684,21.80850601196289,22.914112091064453,47.217832645569096,-52.78216735443091,0.043598760980056994,0.06851023535394449,-0.007010764274151704,669680756.0,-1.0
150,2013-08-07,GOOG,22.292442321777344,22.37737464904785,22.14424705505371,22.18310165405273,55374783.0,0.0,0.0,-0.14744758605957387,0.14744758605957387,0.0,41.46358516030015,21.80850601196289,22.739765167236328,40.224639937080774,-59.775360062919226,0.02404977302188982,0.05961814288753354,0.0033231212408273425,614305973.0,-1.0
151,2013-08-08,GOOG,22.30364990234375,22.312368392944336,22.04960250854492,22.2331657409668,59743096.0,0.0,0.0,0.050064086914069605,0.0,0.050064086914069605,44.151313180175606,21.93951416015625,22.739765167236328,36.69493424094695,-63.30506575905305,0.012453229593166526,0.05018516022866013,0.008256635210099894,674049069.0,1.0
152,2013-08-09,GOOG,22.18086051940918,22.30439758300781,22.166912078857425,22.177125930786133,53146462.0,0.0,0.0,-0.056039810180667615,0.056039810180667615,0.0,41.67958425471924,21.93951416015625,22.739765167236328,29.69215515227785,-70.30784484772215,-0.0012446780885824182,0.03989919256521161,0.009226270920012825,620902607.0,-1.0
153,2013-08-12,GOOG,22.08970260620117,22.092193603515625,21.95894241333008,22.055082321166992,55286453.0,0.0,0.0,-0.12204360961914062,0.12204360961914062,0.0,36.53933530800347,21.93951416015625,22.672517776489254,15.766383471461545,-84.23361652853846,-0.02169807989071515,0.02757973807402624,-0.0060723611939631494,565616154.0,-1.0
154,2013-08-13,GOOG,22.08795928955078,22.129552841186523,21.82320022583008,21.9489803314209,57004870.0,0.0,0.0,-0.10610198974609375,0.10610198974609375,0.0,32.516593102757426,21.82320022583008,22.65782356262207,15.070283809014157,-84.92971619098584,-0.04593947634380413,0.012875895190460153,-0.0073218249958055814,508611284.0,-1.0
155,2013-08-14,GOOG,21.87724876403809,21.92357444763184,21.598045349121094,21.664047241210938,83600184.0,0.0,0.0,-0.28493309020996094,0.28493309020996094,0.0,24.2455417341082,21.598045349121094,22.65782356262207,6.227896672059954,-93.77210332794004,-0.08713807102343907,-0.007126898052319702,-0.03805493695339479,425011100.0,-1.0
156,2013-08-15,GOOG,21.530298233032227,21.54225349426269,21.36989974975586,21.411245346069336,75048249.0,0.0,0.0,-0.25280189514160156,0.25280189514160156,0.0,19.236386233234825,21.36989974975586,22.65782356262207,3.2102517167893634,-96.78974828321064,-0.13858956979619208,-0.033419432401094185,-0.05174451028203386,349962851.0,-1.0
157,2013-08-16,GOOG,21.45159339904785,21.48048591613769,21.33353614807129,21.34275245666504,67255147.0,0.0,0.0,-0.06849288940429688,0.06849288940429688,0.0,18.069340204228894,21.33353614807129,22.65782356262207,0.6959447392223624,-99.30405526077763,-0.18278499465122877,-0.06329254485112111,-0.0531380841651351,282707704.0,-1.0
158,2013-08-19,GOOG,21.3626766204834,21.71859359741211,21.356201171875,21.560436248779297,72707508.0,0.0,0.0,0.2176837921142578,0.0,0.2176837921142578,32.9800160808127,21.33353614807129,22.65782356262207,17.13375043928631,-82.86624956071368,-0.19796300567450942,-0.09022663701579878,-0.034486970430161024,355415212.0,1.0
159,2013-08-20,GOOG,21.627683639526367,21.721332550048828,21.50788307189941,21.55470848083496,49504863.0,0.0,0.0,-0.0057277679443359375,0.0057277679443359375,0.0,32.79879198030696,21.33353614807129,22.65782356262207,16.701233458349897,-83.29876654165011,-0.20805553296008839,-0.11379241620465672,-0.028327561358082898,305910349.0,-1.0
160,2013-08-21,GOOG,21.684968948364254,21.84088516235352,21.58160781860352,21.6520938873291,70555472.0,0.0,0.0,0.09738540649414062,0.0,0.09738540649414062,39.33817717318516,21.33353614807129,22.65782356262207,24.055030332359703,-75.9449696676403,-0.2058231721389241,-0.1321985673915102,-0.02613536283620721,376465821.0,1.0
161,2013-08-22,GOOG,21.73602867126465,21.787086486816406,21.67500686645508,21.76118469238281,34926424.0,0.0,0.0,0.10909080505370738,0.0,0.10909080505370738,46.115606680526795,21.33353614807129,22.65782356262207,32.292728875369164,-67.70727112463084,-0.1930262376949905,-0.14436410145220627,-0.01875541671637071,411392245.0,1.0
162,2013-08-23,GOOG,21.86379814147949,21.868032455444336,21.662553787231445,21.67400932312012,43245489.0,0.0,0.0,-0.08717536926268821,0.08717536926268821,0.0,41.808661244619195,21.33353614807129,22.65782356262207,25.7099154841946,-74.2900845158054,-0.18775455699382704,-0.15304219256053042,-0.017278239659125783,368146756.0,-1.0
163,2013-08-26,GOOG,21.668779373168945,21.79082298278809,21.57039833068848,21.578866958618164,42257801.0,0.0,0.0,-0.09514236450195668,0.09514236450195668,0.0,37.40894239543829,21.33353614807129,22.37737464904785,23.502755485389347,-76.49724451461066,-0.1890743498852494,-0.16024862402547424,-0.016862440405621126,325888955.0,-1.0
164,2013-08-27,GOOG,21.410249710083008,21.512615203857425,21.118343353271484,21.17438316345215,69623993.0,0.0,0.0,-0.4044837951660156,0.4044837951660156,0.0,24.672523610945092,21.118343353271484,22.312368392944336,4.693353013435823,-95.30664698656417,-0.22022010320021934,-0.17224291986042328,-0.022602613090102253,256264962.0,-1.0
165,2013-08-28,GOOG,21.1768741607666,21.305391311645508,21.11510467529297,21.1345329284668,53395392.0,0.0,0.0,-0.03985023498534801,0.03985023498534801,0.0,23.753193319861154,21.11510467529297,22.30439758300781,1.6335969926165608,-98.36640300738344,-0.24529134173632983,-0.18685260423560462,-0.012923695615553399,202869570.0,-1.0
166,2013-08-29,GOOG,21.147483825683597,21.42917823791504,21.135528564453125,21.305889129638672,59361671.0,0.0,0.0,0.17135620117187145,0.0,0.17135620117187145,35.64983791680615,21.11510467529297,22.129552841186523,18.806722783874793,-81.19327721612521,-0.24846929803446827,-0.1991759429953774,-0.0017272058560027226,262231241.0,1.0
167,2013-08-30,GOOG,21.314109802246094,21.37089729309082,21.060062408447266,21.09343719482422,74743109.0,0.0,0.0,-0.21245193481445312,0.21245193481445312,0.0,29.144520229770123,21.060062408447266,22.129552841186523,3.1206250523879078,-96.87937494761209,-0.2650752842903543,-0.2123558112543728,-0.021660000222932352,187488132.0,-1.0
168,2013-09-03,GOOG,21.279239654541016,21.57388687133789,21.269027709960938,21.42917823791504,82210996.0,0.0,0.0,0.3357410430908203,0.0,0.3357410430908203,46.83465796299408,21.060062408447266,21.92357444763184,42.74588109001173,-57.25411890998827,-0.24828216462281816,-0.2195410819280619,-0.005823796829891537,269699128.0,1.0
169,2013-09-04,GOOG,21.428430557250977,21.755952835083008,21.299415588378903,21.70937728881836,81954037.0,0.0,0.0,0.2801990509033203,0.0,0.2801990509033203,57.139190056625,21.060062408447266,21.868032455444336,80.363731648761,-19.636268351238996,-0.2099437172179499,-0.21762160898603952,0.0026456287224387864,351653165.0,1.0
170,2013-09-05,GOOG,21.755952835083008,21.914857864379883,21.708879470825195,21.90688705444336,51845604.0,0.0,0.0,0.197509765625,0.0,0.197509765625,62.97573611559252,21.060062408447266,21.914857864379883,99.06751844769379,-0.9324815523062127,-0.1617582145005052,-0.20644893008893267,0.006695516081509645,403498769.0,1.0
171,2013-09-06,GOOG,21.97861862182617,22.011993408203125,21.76193046569824,21.90738677978516,62698130.0,0.0,0.0,0.0004997253418004277,0.0,0.0004997253418004277,62.99044907597701,21.060062408447266,22.011993408203125,89.0111123133091,-10.988887686690898,-0.12212277780479042,-0.18958369963210425,0.01076761817279892,466196899.0,1.0
172,2013-09-09,GOOG,22.0107479095459,22.16068649291992,21.978120803833008,22.11834526062012,49569103.0,0.0,0.0,0.21095848083496094,0.0,0.21095848083496094,68.99243321144661,21.060062408447266,22.16068649291992,96.1529796687954,-3.8470203312046127,-0.07284908972609117,-0.16623677765090164,0.025000307154055657,515766002.0,1.0
173,2013-09-10,GOOG,22.16741180419922,22.216726303100582,22.017473220825195,22.133787155151367,51697050.0,0.0,0.0,0.015441894531246447,0.0,0.015441894531246447,69.41141192420761,21.060062408447266,22.216726303100582,92.82945129241072,-7.170548707589276,-0.03218232952585254,-0.13942588802589181,0.045309654798123766,567463052.0,1.0
174,2013-09-11,GOOG,22.13054847717285,22.340511322021484,22.069278717041016,22.32108497619629,64665477.0,0.0,0.0,0.18729782104492188,0.0,0.18729782104492188,74.27596938725314,21.060062408447266,22.340511322021484,98.48284881815636,-1.5171511818436405,0.014986959095832475,-0.10854331860154695,0.056142809105153235,632128529.0,1.0
175,2013-09-12,GOOG,22.351221084594727,22.36367416381836,22.16716194152832,22.243127822875977,43984248.0,0.0,0.0,-0.0779571533203125,0.0779571533203125,0.0,69.0056186910908,21.060062408447266,22.36367416381836,90.7528955269303,-9.247104473069697,0.045553365591331385,-0.07772398176297128,0.04398965410617439,588144281.0,-1.0
176,2013-09-13,GOOG,22.278993606567383,22.30838394165039,22.03839492797852,22.143749237060547,53214717.0,0.0,0.0,-0.09937858581542969,0.09937858581542969,0.0,62.484144753641544,21.060062408447266,22.36367416381836,83.12956861184429,-16.870431388155698,0.06105465020445067,-0.04996825536948689,0.049793309290249166,534929564.0,-1.0
177,2013-09-16,GOOG,22.321334838867188,22.341259002685547,22.039142608642575,22.111122131347656,53660381.0,0.0,0.0,-0.032627105712890625,0.032627105712890625,0.0,60.324469438417786,21.060062408447266,22.36367416381836,80.62674477810226,-19.373255221897733,0.06990102217405081,-0.02599439986077935,0.03182314719964574,481269183.0,-1.0
178,2013-09-17,GOOG,22.102405548095703,22.126813888549805,21.94275283813477,22.07002639770508,50564822.0,0.0,0.0,-0.04109573364257457,0.04109573364257457,0.0,57.4391573887033,21.060062408447266,22.36367416381836,77.47429287106374,-22.52570712893627,0.07275705835003876,-0.0062441082186157236,0.01661259575015439,430704361.0,-1.0
179,2013-09-18,GOOG,22.076004028320312,22.51485824584961,21.99431037902832,22.498668670654297,77678069.0,0.0,0.0,0.4286422729492152,0.0,0.4286422729492152,72.98809361947681,21.060062408447266,22.51485824584961,98.8871582679106,-1.112841732089384,0.10835920812551691,0.016676555050210814,0.027013496474429743,508382430.0,1.0
180,2013-09-19,GOOG,22.565170288085938,22.565170288085938,22.301408767700195,22.375879287719727,64155573.0,0.0,0.0,-0.12278938293457031,0.12278938293457031,0.0,65.12405522272148,21.060062408447266,22.565170288085938,87.42342639175781,-12.576573608242198,0.12522261073685215,0.03838576618753908,0.021385138841245377,444226857.0,-1.0
181,2013-09-20,GOOG,22.375879287719727,22.518844604492188,22.306888580322266,22.493438720703125,174463490.0,0.0,0.0,0.11755943298339844,0.0,0.11755943298339844,68.8336320585309,21.269027709960938,22.565170288085938,94.46576568091919,-5.534234319080806,0.1463855929749407,0.05998573154501941,0.016958477483884238,618690347.0,1.0
182,2013-09-23,GOOG,22.32008934020996,22.455581665039062,22.047361373901367,22.079740524291992,71362485.0,0.0,0.0,-0.4136981964111328,0.4136981964111328,0.0,48.07189509704382,21.299415588378903,22.565170288085938,61.648985865405,-38.35101413459499,0.12829652273809344,0.07364788978363422,-0.0024418157850947253,547327862.0,-1.0
183,2013-09-24,GOOG,22.079740524291992,22.169403076171875,21.952716827392575,22.088207244873047,59694916.0,0.0,0.0,0.008466720581054688,0.0,0.008466720581054688,48.439145777311936,21.708879470825195,22.565170288085938,44.29894218196965,-55.70105781803035,0.11333751305711459,0.0815858144383303,-0.010433082960420115,607022778.0,1.0
184,2013-09-25,GOOG,22.080984115600582,22.080984115600582,21.808256149291992,21.848854064941406,66207234.0,0.0,0.0,-0.23935317993164062,0.23935317993164062,0.0,39.359284533806544,21.76193046569824,22.565170288085938,10.821624727815388,-89.17837527218462,0.08123220626135108,0.08151509280293445,-0.01772564367179863,540815544.0,-1.0
185,2013-09-26,GOOG,21.87550544738769,21.9863395690918,21.793312072753903,21.87226676940918,50584897.0,0.0,0.0,0.023412704467773438,0.0,0.023412704467773438,40.615647283323916,21.793312072753903,22.565170288085938,10.229170991114293,-89.77082900888571,0.05702043189319994,0.07661616062098756,-0.012260004606492014,591400441.0,1.0
186,2013-09-27,GOOG,21.7888298034668,21.856077194213867,21.70140838623047,21.82793426513672,50540732.0,0.0,0.0,-0.04433250427246094,0.04433250427246094,0.0,38.85676814143352,21.70140838623047,22.565170288085938,14.648235657819194,-85.3517643421808,0.033864793361278345,0.06806588716904571,-0.012807485053391021,540859709.0,-1.0
187,2013-09-30,GOOG,21.64586639404297,21.93876838684082,21.62668800354004,21.815977096557617,69154239.0,0.0,0.0,-0.011957168579101562,0.011957168579101562,0.0,38.340055189243515,21.62668800354004,22.565170288085938,20.169703374759926,-79.83029662524007,0.014383140088671809,0.05732933775297093,-0.011511055608609544,471705470.0,-1.0
188,2013-10-01,GOOG,21.924072265625,22.10887908935547,21.919092178344727,22.092193603515625,67644602.0,0.0,0.0,0.2762165069580078,0.0,0.2762165069580078,54.47594157863859,21.62668800354004,22.565170288085938,49.60195921021879,-50.39804078978122,0.020990181544863873,0.050061506511349524,-0.018066627545337832,539350072.0,1.0
189,2013-10-02,GOOG,21.985841751098636,22.150972366333008,21.863550186157227,22.116851806640625,60036190.0,0.0,0.0,0.024658203125,0.0,0.024658203125,55.670861202718896,21.62668800354004,22.565170288085938,52.229414574166476,-47.77058542583353,0.02789446946578522,0.04562809910223667,-0.011576192280464248,599386262.0,1.0
190,2013-10-03,GOOG,22.11709976196289,22.26902961730957,21.72108459472656,21.82046127319336,84997401.0,0.0,0.0,-0.2963905334472656,0.2963905334472656,0.0,40.813231919072166,21.62668800354004,22.565170288085938,20.647514912557032,-79.35248508744297,0.009342245906964308,0.0383709284631822,-0.029918833481443308,514388861.0,-1.0
191,2013-10-04,GOOG,21.793312072753903,21.8558292388916,21.668779373168945,21.727310180664062,54523605.0,0.0,0.0,-0.09315109252929688,0.09315109252929688,0.0,37.21181074929982,21.62668800354004,22.565170288085938,10.72179824605973,-89.27820175394027,-0.012730290005414702,0.02815068476946282,-0.01596170676191544,459865256.0,-1.0
192,2013-10-07,GOOG,21.605268478393555,21.76815795898437,21.52207946777344,21.56267738342285,51937949.0,0.0,0.0,-0.16463279724121094,0.16463279724121094,0.0,31.536798089069478,21.52207946777344,22.565170288085938,3.8920787009944067,-96.1079212990056,-0.043011609076188506,0.01391822600033255,-0.023792327535869906,407927307.0,-1.0
193,2013-10-08,GOOG,21.552217483520508,21.56865501403809,21.211244583129883,21.26205444335937,78039419.0,0.0,0.0,-0.3006229400634801,0.3006229400634801,0.0,23.867620127825518,21.211244583129883,22.565170288085938,3.752780528761569,-96.24721947123844,-0.09022743820747792,-0.006910906841229549,-0.026857226463131156,329887888.0,-1.0
194,2013-10-09,GOOG,21.32706069946289,21.485715866088867,20.99580383300781,21.316600799560547,106449509.0,0.0,0.0,0.05454635620117543,0.0,0.05454635620117543,27.555915386085005,20.99580383300781,22.518844604492188,21.062927044302587,-78.93707295569742,-0.12184038877988712,-0.029896803228961072,-0.025405047209180576,436337397.0,1.0
195,2013-10-10,GOOG,21.51535415649414,21.63963890075684,21.424943923950195,21.62494468688965,90550137.0,0.0,0.0,0.30834388732910156,0.0,0.30834388732910156,44.95089860963444,20.99580383300781,22.455581665039062,43.09839758330909,-56.90160241669092,-0.12062264863947192,-0.04804197231106325,-0.009299532231562657,526887534.0,1.0
196,2013-10-11,GOOG,21.569900512695312,21.755455017089844,21.551719665527344,21.71834373474121,56567236.0,0.0,0.0,0.0933990478515625,0.0,0.0933990478515625,49.21304418613862,20.99580383300781,22.26902961730957,56.74876448796109,-43.25123551203891,-0.11084332710441203,-0.060602243269733014,-0.0044753146459716175,583454770.0,1.0
197,2013-10-14,GOOG,21.58559226989746,21.824447631835938,21.5539608001709,21.820959091186523,49930453.0,0.0,0.0,0.1026153564453125,0.0,0.1026153564453125,53.75231277148422,20.99580383300781,22.26902961730957,64.80824283897381,-35.19175716102618,-0.09373245509229022,-0.06722828563424446,-0.012277391607048882,633385223.0,1.0
198,2013-10-15,GOOG,21.81224250793457,22.05807113647461,21.768407821655277,21.96790885925293,63914673.0,0.0,0.0,0.14694976806640625,0.0,0.14694976806640625,59.7035222692579,20.99580383300781,22.26902961730957,76.34977536825681,-23.650224631743193,-0.06753583891914872,-0.06728979629122532,-0.0067343647590465405,697299896.0,1.0
199,2013-10-16,GOOG,22.064048767089844,22.374385833740234,22.01772117614746,22.366912841796875,80604999.0,0.0,0.0,0.3990039825439453,0.0,0.3990039825439453,71.28150939343206,20.99580383300781,22.374385833740234,99.45792184002191,-0.5420781599780831,-0.014412413958847736,-0.0567143198247498,0.025043080517955785,777904895.0,1.0
200,2013-10-17,GOOG,22.241384506225582,22.338769912719727,22.060562133789062,22.136775970458984,170902191.0,0.0,0.0,-0.23013687133789062,0.23013687133789062,0.0,59.83931172374806,20.99580383300781,22.374385833740234,82.76418354838447,-17.235816451615538,0.009014253377927162,-0.04356860518421441,0.01884567332035969,607002704.0,-1.0
201,2013-10-18,GOOG,24.32332992553711,25.29170036315918,24.259071350097656,25.190828323364254,464390148.0,0.0,0.0,3.05405235290527,0.0,3.05405235290527,88.3859396935184,20.99580383300781,25.29170036315918,97.65189782652025,-2.3481021734797483,0.27089382119001115,0.01932388009063072,0.1682606883842117,1071392852.0,1.0
202,2013-10-21,GOOG,25.192073822021484,25.37986946105957,24.895435333251957,24.98883628845215,145675990.0,0.0,0.0,-0.20199203491210582,0.20199203491210582,0.0,83.83814349395058,20.99580383300781,25.37986946105957,91.08058122795043,-8.919418772049575,0.4568696889322972,0.10683304185896404,0.17527853928794435,925716862.0,-1.0
203,2013-10-22,GOOG,25.031177520751957,25.230430603027344,24.80178642272949,25.080989837646484,88675135.0,0.0,0.0,0.09215354919433594,0.0,0.09215354919433594,84.26435778903362,20.99580383300781,25.37986946105957,93.18259239778067,-6.817407602219343,0.6047220642905486,0.20641084634528103,0.17659424565306603,1014391997.0,1.0
204,2013-10-23,GOOG,24.931549072265625,25.77215003967285,24.922334671020508,25.68896102905273,106927293.0,0.0,0.0,0.6079711914062464,0.0,0.6079711914062464,86.89515561702844,20.99580383300781,25.77215003967285,98.25831279767709,-1.7416872023229084,0.7621685200788555,0.31756238109199597,0.1879318722432124,1121319290.0,1.0
205,2013-10-24,GOOG,25.70041847229004,25.91710662841797,25.524328231811523,25.54300880432129,83997668.0,0.0,0.0,-0.14595222473144176,0.14595222473144176,0.0,83.04911694656681,20.99580383300781,25.91710662841797,92.39839856134068,-7.601601438659313,0.86519541277044,0.42708898742768486,0.17610298079323816,1037321622.0,-1.0
206,2013-10-25,GOOG,25.624452590942383,25.624452590942383,25.17414093017578,25.28522491455078,81524432.0,0.0,0.0,-0.2577838897705078,0.2577838897705078,0.0,76.17780745626698,20.99580383300781,25.91710662841797,87.16027563968406,-12.839724360315937,0.915490756443198,0.5247693412307874,0.1587586415834248,955797190.0,-1.0
207,2013-10-28,GOOG,25.28522491455078,25.490205764770508,25.230180740356445,25.280242919921875,46521724.0,0.0,0.0,-0.00498199462890625,0.00498199462890625,0.0,76.03751710348547,20.99580383300781,25.91710662841797,87.05904239239123,-12.940957607608764,0.9440655728775837,0.6086285875601467,0.1507805809779561,909275466.0,-1.0
208,2013-10-29,GOOG,25.382360458374023,25.82669448852539,25.242883682250977,25.809261322021484,64440637.0,0.0,0.0,0.5290184020996094,0.0,0.5290184020996094,80.44899291998618,21.424943923950195,25.91710662841797,97.59925644970016,-2.4007435502998273,0.9978955614697327,0.6864819823420639,0.15390360326311647,973716103.0,1.0
209,2013-10-30,GOOG,25.83889961242676,25.840892791748047,25.55421638488769,25.664304733276367,53162522.0,0.0,0.0,-0.1449565887451172,0.1449565887451172,0.0,76.02394886698731,21.551719665527344,25.91710662841797,94.20894648537174,-5.791053514628263,1.0171345370191283,0.7526124932774769,0.15935151385751878,920553581.0,-1.0
210,2013-10-31,GOOG,25.62719345092773,25.940767288208008,25.5036563873291,25.668289184570312,65845885.0,0.0,0.0,0.0039844512939453125,0.0,0.0039844512939453125,76.06570267955425,21.5539608001709,25.940767288208008,93.78869105850127,-6.211308941498729,1.0209343794543706,0.8062768705128558,0.018953757894623058,986399466.0,1.0
211,2013-11-01,GOOG,25.69842529296875,25.80328369140625,25.531801223754883,25.58011817932129,51524405.0,0.0,0.0,-0.08817100524902344,0.08817100524902344,0.0,72.8273926883004,21.768407821655277,25.940767288208008,91.35623112586958,-8.643768874130414,1.0052433000847003,0.8460701564272248,0.0236618417938248,934875061.0,-1.0
212,2013-11-04,GOOG,25.69120216369629,25.712871551513672,25.455337524414062,25.55695533752441,45722740.0,0.0,0.0,-0.023162841796878553,0.023162841796878553,0.0,71.89955987910373,22.01772117614746,25.940767288208008,90.21648128214319,-9.783518717856806,0.97964620722475,0.87278536658673,0.018977141769879635,889152321.0,-1.0
213,2013-11-05,GOOG,25.413494110107425,25.69493865966797,25.340518951416016,25.44263458251953,47433127.0,0.0,0.0,-0.11432075500487926,0.11432075500487926,0.0,67.03589622825379,22.060562133789062,25.940767288208008,87.16220700028757,-12.837792999712438,0.9393078416061087,0.8860898615906059,-0.009588805333723638,841719194.0,-1.0
214,2013-11-06,GOOG,25.54425430297852,25.57912254333496,25.289459228515625,25.47327041625977,36652871.0,0.0,0.0,0.030635833740237928,0.0,0.030635833740237928,67.71126482238861,24.259071350097656,25.940767288208008,72.20086810261644,-27.79913189738357,0.8994432300761162,0.888760535287708,-0.0027302338810500926,878372065.0,1.0
215,2013-11-07,GOOG,25.469783782958984,25.502660751342773,25.09693145751953,25.10465240478516,67435822.0,0.0,0.0,-0.3686180114746094,0.3686180114746094,0.0,52.716466312665176,24.80178642272949,25.940767288208008,26.590963135138214,-73.40903686486179,0.8285547831841704,0.8767193848670005,-0.007141423909648892,810936243.0,-1.0
216,2013-11-08,GOOG,25.12457656860352,25.367416381835938,25.118349075317383,25.305896759033203,51825529.0,0.0,0.0,0.20124435424804332,0.0,0.20124435424804332,58.5050230670992,24.80178642272949,25.940767288208008,44.259772186069426,-55.740227813930574,0.7796268617706126,0.8573008802477229,0.0010147781883500517,862761772.0,1.0
217,2013-11-11,GOOG,25.143505096435547,25.303407669067383,25.105897903442383,25.1704044342041,44670812.0,0.0,0.0,-0.13549232482910156,0.13549232482910156,0.0,53.42416557767465,24.922334671020508,25.940767288208008,24.357994726117703,-75.64200527388229,0.7215998795346223,0.8301606801051029,-0.02475300938862146,818090960.0,-1.0
218,2013-11-12,GOOG,25.098424911499023,25.344003677368164,25.031177520751957,25.200044631958008,48906630.0,0.0,0.0,0.02964019775390625,0.0,0.02964019775390625,54.423248499490725,25.031177520751957,25.940767288208008,18.56519468972702,-81.43480531027298,0.6702782437952948,0.7981841928431413,-0.01808972057272995,866997590.0,1.0
219,2013-11-13,GOOG,25.074764251708984,25.72482681274414,25.06853675842285,25.715362548828125,63412799.0,0.0,0.0,0.5153179168701172,0.0,0.5153179168701172,68.13508680454456,25.031177520751957,25.940767288208008,75.2190770559901,-24.780922944009895,0.6635384667707918,0.7712550476286715,0.0018339112482068654,930410389.0,1.0
220,2013-11-14,GOOG,25.7514762878418,25.89668273925781,25.662559509277344,25.78410530090332,46842923.0,0.0,0.0,0.06874275207519531,0.0,0.06874275207519531,69.54536655944275,25.031177520751957,25.940767288208008,82.77663261946743,-17.22336738053256,0.6561800748059206,0.7482400530641213,0.007974440155125384,977253312.0,1.0
221,2013-11-15,GOOG,25.77513885498047,25.85309600830078,25.661563873291016,25.742511749267575,51243355.0,0.0,0.0,-0.04159355163574574,0.04159355163574574,0.0,67.460915232852,25.031177520751957,25.940767288208008,78.20385122681007,-21.796148773189934,0.6396191132434303,0.7265158650999832,0.007260505380729754,926009957.0,-1.0
222,2013-11-18,GOOG,25.79705619812012,26.120594024658203,25.63491439819336,25.69244766235352,70651832.0,0.0,0.0,-0.050064086914055395,0.050064086914055395,0.0,64.76496486417834,25.031177520751957,26.120594024658203,60.69947896240706,-39.300521037592944,0.6153611779667045,0.7042849276733275,0.009818679705663191,855358125.0,-1.0
223,2013-11-19,GOOG,25.696683883666992,25.77215003967285,25.48074150085449,25.534290313720703,45433661.0,0.0,0.0,-0.15815734863281605,0.15815734863281605,0.0,56.530200566189826,25.031177520751957,26.120594024658203,46.181858927670845,-53.81814107232916,0.5767264698465127,0.6787732361079646,0.002395448109481224,809924464.0,-1.0
224,2013-11-20,GOOG,25.652597427368164,25.737529754638672,25.413742065429688,25.462310791015625,38692487.0,0.0,0.0,-0.07197952270507812,0.07197952270507812,0.0,52.99195115828778,25.031177520751957,26.120594024658203,39.5746960614038,-60.4253039385962,0.5341427741246711,0.6498471437113059,0.014246697403477837,771231977.0,-1.0
225,2013-11-21,GOOG,25.57912254333496,25.860816955566406,25.55421638488769,25.75521278381348,43835693.0,0.0,0.0,0.2929019927978551,0.0,0.2929019927978551,63.66891087710169,25.031177520751957,26.120594024658203,66.4608311389996,-33.5391688610004,0.5180577831288886,0.6234892715948225,0.01775538836101065,815067670.0,1.0
226,2013-11-22,GOOG,25.739023208618164,25.80751609802246,25.634416580200195,25.700916290283203,50356042.0,0.0,0.0,-0.05429649353027699,0.05429649353027699,0.0,60.71907476423899,25.031177520751957,26.120594024658203,61.476833436046704,-38.52316656395329,0.4952204456775675,0.5978355064113715,0.021076810961296655,764711628.0,-1.0
227,2013-11-25,GOOG,25.83217430114746,26.231428146362305,25.77887344360352,26.05060577392578,64761837.0,0.0,0.0,0.3496894836425781,0.0,0.3496894836425781,70.7795080486857,25.031177520751957,26.231428146362305,84.93461543962353,-15.065384560376478,0.4995798637317428,0.5781843778754457,0.03375236648942748,829473465.0,1.0
228,2013-11-26,GOOG,26.117107391357425,26.43840217590332,25.97613525390625,26.361440658569336,91794785.0,0.0,0.0,0.3108348846435547,0.0,0.3108348846435547,76.85838917298382,25.031177520751957,26.43840217590332,94.53097150819133,-5.46902849180867,0.5220980890699352,0.5669671201143437,0.025124207699364298,921268250.0,1.0
229,2013-11-27,GOOG,26.451602935791016,26.60029602050781,26.401042938232425,26.47850227355957,45112461.0,0.0,0.0,0.11706161499023438,0.0,0.11706161499023438,78.77695411835461,25.031177520751957,26.60029602050781,92.23807845187032,-7.761921548129679,0.5431289858246551,0.562199493256406,0.026931202946643307,966380711.0,1.0
230,2013-11-29,GOOG,26.45484161376953,26.5659236907959,26.38734436035156,26.390830993652344,47890836.0,0.0,0.0,-0.08767127990722656,0.08767127990722656,0.0,73.51044643865878,25.031177520751957,26.60029602050781,86.65078342470267,-13.34921657529734,0.5464229597921921,0.5590441865635633,0.025184770262490552,918489875.0,-1.0
231,2013-12-02,GOOG,26.48846435546875,26.559200286865234,26.1709041595459,26.26355743408203,55133884.0,0.0,0.0,-0.1272735595703125,0.1272735595703125,0.0,66.10752431533093,25.031177520751957,26.60029602050781,78.53963314573292,-21.460366854267075,0.5326237899522432,0.5537601072412993,0.02222870234996499,863355991.0,-1.0
232,2013-12-03,GOOG,26.175636291503903,26.48672103881836,26.12756729125977,26.23317146301269,67295297.0,0.0,0.0,-0.03038597106933949,0.03038597106933949,0.0,64.32307684861978,25.06853675842285,26.60029602050781,76.03248979246224,-23.967510207537757,0.5133187356862443,0.5456718329302883,0.027370298555603467,796060694.0,-1.0
233,2013-12-04,GOOG,26.186098098754883,26.500171661376957,26.151975631713867,26.355712890625,47842656.0,0.0,0.0,0.12254142761230824,0.0,0.12254142761230824,68.3042545777525,25.413742065429688,26.60029602050781,79.3871042411463,-20.612895758853703,0.5021192913997261,0.5369613246241759,0.03508723567715677,843903350.0,1.0
234,2013-12-05,GOOG,26.3313045501709,26.39257431030273,26.17912483215332,26.33479118347168,45517975.0,0.0,0.0,-0.020921707153320312,0.020921707153320312,0.0,66.83502263258382,25.413742065429688,26.60029602050781,77.62387155680176,-22.376128443198244,0.4859536727649356,0.5267597942523279,0.02250334347936156,798385375.0,-1.0
235,2013-12-06,GOOG,26.64487838745117,26.650108337402344,26.40303421020508,26.64687156677246,57366220.0,0.0,0.0,0.31208038330078125,0.0,0.31208038330078125,75.79587394420062,25.413742065429688,26.650108337402344,99.73820293360815,-0.26179706639185946,0.4926456693708374,0.5199369692760298,0.03680628604073921,855751595.0,1.0
236,2013-12-09,GOOG,26.674766540527344,26.956710815429688,26.600793838500977,26.85284805297852,59526286.0,0.0,0.0,0.20597648620605824,0.0,0.20597648620605824,79.92630965999163,25.413742065429688,26.956710815429688,93.26864121835466,-6.73135878164534,0.5087056634873406,0.517690708118292,0.03079553258817902,915277881.0,1.0
237,2013-12-10,GOOG,26.803285598754883,27.20577621459961,26.790830612182617,27.01523971557617,74433955.0,0.0,0.0,0.16239166259764914,0.0,0.16239166259764914,82.6237750512414,25.413742065429688,27.20577621459961,89.36758548313945,-10.63241451686054,0.5284453849402304,0.5198416434826797,0.02480134016477975,989711836.0,1.0
238,2013-12-11,GOOG,27.083484649658203,27.18111801147461,26.77887535095215,26.83167839050293,68728650.0,0.0,0.0,-0.18356132507323863,0.18356132507323863,0.0,70.30227935664479,25.55421638488769,27.20577621459961,77.3488179255405,-22.6511820744595,0.5232457405037607,0.5205224628868959,0.013338221070609002,920983186.0,-1.0
239,2013-12-12,GOOG,26.888465881347656,26.972400665283203,26.62520217895508,26.649112701416016,64099363.0,0.0,0.0,-0.18256568908691406,0.18256568908691406,0.0,60.029074936293185,25.634416580200195,27.20577621459961,64.57440416583216,-35.42559583416784,0.4986453859904465,0.516147047507606,0.009786797082130372,856883823.0,-1.0
240,2013-12-13,GOOG,26.78460502624512,26.806772232055664,26.34848976135254,26.42071914672852,86820208.0,0.0,0.0,-0.22839355468749645,0.22839355468749645,0.0,49.57249043363794,25.77887344360352,27.20577621459961,44.98174060429789,-55.01825939570212,0.45546960674255743,0.5040115593545963,0.005984022272722989,770063615.0,-1.0
241,2013-12-16,GOOG,26.50066947937012,26.76692008972168,26.45110511779785,26.72433090209961,64320188.0,0.0,0.0,0.3036117553710902,0.0,0.3036117553710902,60.20506903493364,25.97613525390625,27.20577621459961,60.84667574602209,-39.15332425397791,0.4406716334228875,0.4913435741682545,0.01872283874557157,834383803.0,1.0
242,2013-12-17,GOOG,26.720346450805664,26.91810417175293,26.609760284423828,26.64662170410156,61658247.0,0.0,0.0,-0.07770919799805043,0.07770919799805043,0.0,56.67590919825772,26.12756729125977,27.20577621459961,48.14043007861374,-51.85956992138626,0.41785685642307513,0.4766462306192187,0.01103778959361934,772725556.0,-1.0
243,2013-12-18,GOOG,26.696186065673828,27.022462844848636,26.377132415771484,27.01748275756836,88743390.0,0.0,0.0,0.3708610534668004,0.0,0.3708610534668004,67.24803529180181,26.12756729125977,27.20577621459961,82.53645903356136,-17.463540966438643,0.4248044869865346,0.4662778818926819,0.02592356132009699,861468946.0,1.0
244,2013-12-19,GOOG,26.918352127075195,27.19780540466309,26.87626075744629,27.054094314575195,66877738.0,0.0,0.0,0.03661155700683594,0.0,0.03661155700683594,68.13379932503891,26.12756729125977,27.20577621459961,85.93204927718767,-14.067950722812327,0.42832729053415974,0.45868776362097746,0.01528219726590807,928346684.0,1.0
245,2013-12-20,GOOG,27.105899810791016,27.426448822021484,27.09842872619629,27.412750244140625,130953011.0,0.0,0.0,0.3586559295654297,0.0,0.3586559295654297,75.59445396038821,26.12756729125977,27.426448822021484,98.9453558653016,-1.0546441346984117,0.4548168283796521,0.4579135765727124,0.020850756316702856,1059299695.0,1.0
246,2013-12-23,GOOG,27.592575073242188,27.79083251953125,27.524829864501957,27.77339744567871,69122119.0,0.0,0.0,0.36064720153808594,0.0,0.36064720153808594,80.80786906143886,26.151975631713867,27.79083251953125,98.93614421233822,-1.0638557876617867,0.49915721921438916,0.4661623051010478,0.02806407561378821,1128421814.0,1.0
247,2013-12-24,GOOG,27.770160675048828,27.77688407897949,27.59905242919922,27.69220352172852,29478078.0,0.0,0.0,-0.08119392395019176,0.08119392395019176,0.0,76.55950464832458,26.17912483215332,27.79083251953125,93.88046613072937,-6.119533869270631,0.5217314321506414,0.47727613051096657,0.03207123753876573,1098943736.0,-1.0
248,2013-12-26,GOOG,27.74625015258789,27.870534896850582,27.613746643066406,27.832178115844727,53712576.0,0.0,0.0,0.13997459411620738,0.0,0.13997459411620738,78.77878397367846,26.34848976135254,27.870534896850582,97.4799182947157,-2.5200817052842996,0.5446381884040399,0.4907485420895813,0.04439417655980149,1152656312.0,1.0
249,2013-12-27,GOOG,27.89544105529785,27.90241432189941,27.719600677490234,27.8555908203125,63023345.0,0.0,0.0,0.023412704467773438,0.0,0.023412704467773438,79.1595881929653,26.34848976135254,27.90241432189941,96.98675838095822,-3.013241619041786,0.558246054320545,0.5042480445357741,0.0543085775074994,1215679657.0,1.0
250,2013-12-30,GOOG,27.90390968322754,27.907894134521484,27.621965408325195,27.632925033569336,49629328.0,0.0,0.0,-0.22266578674316406,0.22266578674316406,0.0,66.13628637482509,26.34848976135254,27.907894134521484,82.36704310419691,-17.632956895803087,0.5447831964943433,0.5123550749274879,0.0339987607097898,1166050329.0,-1.0
251,2013-12-31,GOOG,27.70216560363769,27.92034721374512,27.553224563598636,27.913124084472656,54519590.0,0.0,0.0,0.2801990509033203,0.0,0.2801990509033203,72.66585084594874,26.34848976135254,27.92034721374512,99.54047173543186,-0.4595282645681325,0.5503790788547782,0.519959875712946,0.04752956657827112,1220569919.0,1.0
252,2014-01-02,GOOG,27.782365798950195,27.839401245117188,27.603036880493164,27.724082946777344,73129082.0,0.0,0.0,-0.1890411376953125,0.1890411376953125,0.0,63.18207870633762,26.34848976135254,27.92034721374512,87.51386350784952,-12.486136492150479,0.533410986245638,0.5226500978194843,0.026153442774421443,1147440837.0,-1.0
253,2014-01-03,GOOG,27.77090835571289,27.81897735595703,27.520097732543945,27.521841049194336,66917888.0,0.0,0.0,-0.2022418975830078,0.2022418975830078,0.0,54.41539653142741,26.34848976135254,27.92034721374512,74.64743613078883,-25.35256386921117,0.4979048821754013,0.5177010546906677,0.01728931411195478,1080522949.0,-1.0
254,2014-01-06,GOOG,27.721343994140625,27.86704635620117,27.557706832885746,27.828691482543945,71037271.0,0.0,0.0,0.3068504333496094,0.0,0.3068504333496094,63.32428393230601,26.377132415771484,27.92034721374512,94.06072755901987,-5.939272440980133,0.48889067693693633,0.5119389791399215,0.015173276475322961,1151560220.0,1.0
255,2014-01-07,GOOG,28.01997375488281,28.385852813720703,27.92433357238769,28.36517906188965,102486711.0,0.0,0.0,0.5364875793457031,0.0,0.5364875793457031,73.69526869365544,26.377132415771484,28.385852813720703,98.97079992555652,-1.029200074443478,0.5190535915633845,0.513361901624614,0.02130749820465394,1254046931.0,1.0
256,2014-01-08,GOOG,28.543014526367188,28.575891494750977,28.226449966430664,28.42420959472656,90036218.0,0.0,0.0,0.05903053283691051,0.0,0.05903053283691051,74.60690572393585,26.377132415771484,28.575891494750977,93.10147703427255,-6.89852296572745,0.5414793524478334,0.518985391789258,0.02643365207191528,1344083149.0,1.0
257,2014-01-09,GOOG,28.4792537689209,28.498680114746094,28.03392219543457,28.150484085083008,83692529.0,0.0,0.0,-0.27372550964355113,0.27372550964355113,0.0,62.93669955219254,26.87626075744629,28.575891494750977,74.97059800515319,-25.029401994846793,0.5310430350102138,0.5213969204334491,0.011436617282104544,1260390620.0,-1.0
258,2014-01-10,GOOG,28.37066078186035,28.37066078186035,27.95148086547852,28.14899063110352,86061375.0,0.0,0.0,-0.0014934539794886348,0.0014934539794886348,0.0,62.874783895455494,27.09842872619629,28.575891494750977,71.10581242835184,-28.89418757164816,0.5166955246188785,0.5204566412705349,0.010532887730999807,1174329245.0,-1.0
259,2014-01-13,GOOG,28.05658721923828,28.5656795501709,27.824954986572266,27.96966361999512,97118665.0,0.0,0.0,-0.17932701110839844,0.17932701110839844,0.0,55.33287124353179,27.520097732543945,28.575891494750977,42.58084329949089,-57.41915670050911,0.4852610409774165,0.5134175212119112,0.012186136140734494,1077210580.0,-1.0
260,2014-01-14,GOOG,28.34251594543457,28.66754722595215,28.0969352722168,28.627695083618164,99676216.0,0.0,0.0,0.6580314636230433,0.0,0.6580314636230433,70.37736404271057,27.520097732543945,28.66754722595215,96.52689355279475,-3.473106447205258,0.5075953822407904,0.512253093417687,0.02559982168183761,1176886796.0,1.0
261,2014-01-15,GOOG,28.71711158752441,28.767173767089844,28.48797035217285,28.60826873779297,78300393.0,0.0,0.0,-0.019426345825195312,0.019426345825195312,0.0,69.57907434656565,27.520097732543945,28.767173767089844,87.25779143412554,-12.74220856587446,0.51775955499172,0.5133543857324936,0.031892336807425536,1098586403.0,-1.0
262,2014-01-16,GOOG,28.62022399902344,28.840150833129883,28.59282684326172,28.79755973815918,67608467.0,0.0,0.0,0.18929100036621094,0.0,0.18929100036621094,73.01986607667283,27.520097732543945,28.840150833129883,96.77353168961173,-3.2264683103882743,0.534922681169089,0.5176680448198127,0.04635295606440493,1166194870.0,1.0
263,2014-01-17,GOOG,28.813251495361328,28.907398223876957,28.49818229675293,28.655841827392575,108457005.0,0.0,0.0,-0.14171791076660512,0.14171791076660512,0.0,66.52032074348814,27.520097732543945,28.907398223876957,81.86720194680606,-18.13279805319393,0.5309684574585134,0.5203281273475528,0.02972293344685184,1057737865.0,-1.0
264,2014-01-21,GOOG,28.91486930847168,28.9913330078125,28.675018310546875,28.983861923217773,79492846.0,0.0,0.0,0.32802009582519887,0.0,0.32802009582519887,72.95052061645465,27.520097732543945,28.9913330078125,99.49218967759165,-0.5078103224083459,0.5479863415627584,0.5258597701905939,0.021811350458187828,1137230711.0,1.0
265,2014-01-22,GOOG,29.056339263916016,29.08822059631348,28.86331367492676,29.01673889160156,63091600.0,0.0,0.0,0.03287696838378551,0.0,0.03287696838378551,73.53828119396431,27.520097732543945,29.08822059631348,95.44157499622895,-4.558425003771053,0.5576972471911432,0.5322272655907038,0.020845937506207113,1200322311.0,1.0
266,2014-01-23,GOOG,28.891706466674805,28.953723907470703,28.75148200988769,28.894197463989254,78256228.0,0.0,0.0,-0.12254142761230469,0.12254142761230469,0.0,67.25342919938001,27.520097732543945,29.08822059631348,87.62704525219262,-12.37295474780739,0.5491745978727671,0.5356167320471165,0.02641920389924457,1122066083.0,-1.0
267,2014-01-24,GOOG,28.66779518127441,28.73105812072754,27.97016143798828,27.990833282470703,156283602.0,0.0,0.0,-0.9033641815185511,0.9033641815185511,0.0,38.94328804982076,27.557706832885746,29.08822059631348,28.299415525341544,-71.70058447465846,0.46417566906649554,0.5213285194509922,-0.005618579746090702,965782481.0,-1.0
268,2014-01-27,GOOG,28.047372817993164,28.057334899902344,26.955713272094727,27.427942276000977,174796734.0,0.0,0.0,-0.5628910064697266,0.5628910064697266,0.0,29.895494340244625,26.955713272094727,29.08822059631348,22.144308652222406,-77.8556913477776,0.34738832928245245,0.4865404814172843,-0.019368175154129363,790985747.0,-1.0
269,2014-01-28,GOOG,27.65434455871582,28.038654327392575,27.644880294799805,27.970409393310547,88739375.0,0.0,0.0,0.5424671173095703,0.0,0.5424671173095703,44.288511675978434,26.955713272094727,29.08822059631348,47.58230415867647,-52.41769584132353,0.2952031655039953,0.4482730182346265,-0.02295978381730568,879725122.0,1.0
270,2014-01-29,GOOG,27.873523712158203,27.939027786254883,27.382862091064453,27.56966209411621,95552818.0,0.0,0.0,-0.40074729919433594,0.40074729919433594,0.0,37.692182815593306,26.955713272094727,29.08822059631348,28.789998282721267,-71.21000171727874,0.2189847692948348,0.4024153684466682,-0.036304421396346376,784172304.0,-1.0
271,2014-01-30,GOOG,28.51810646057129,28.70465850830078,28.07601356506348,28.27875328063965,204419353.0,0.0,0.0,0.7090911865234375,0.0,0.7090911865234375,52.220933305465024,26.955713272094727,29.08822059631348,62.04152236755478,-37.95847763244522,0.21333962733789136,0.3646002202249129,-0.01801563959713115,988591657.0,1.0
272,2014-01-31,GOOG,29.174396514892575,29.5527286529541,28.670785903930664,29.41399955749512,223486554.0,0.0,0.0,1.1352462768554723,0.0,1.1352462768554723,66.60549525905768,26.955713272094727,29.5527286529541,94.6581334680785,-5.341866531921507,0.29704653099090805,0.35108948237811194,0.02645735325694787,1212078211.0,1.0
273,2014-02-03,GOOG,29.36991310119629,29.43267822265625,28.19457054138184,28.229936599731445,183449044.0,0.0,0.0,-1.1840629577636754,1.1840629577636754,0.0,48.8912475455322,26.955713272094727,29.5527286529541,49.064912631170756,-50.935087368829244,0.2647885525986169,0.333829296422213,-0.02601190019065025,1028629167.0,-1.0
274,2014-02-04,GOOG,28.3435115814209,28.767173767089844,28.3191032409668,28.347745895385746,112897588.0,0.0,0.0,0.11780929565430043,0.0,0.11780929565430043,50.40550187039116,26.955713272094727,29.5527286529541,53.60124678315857,-46.39875321684143,0.24589556686654035,0.31624255051107847,-0.023055416348300994,1141526755.0,1.0
275,2014-02-05,GOOG,28.477758407592773,28.66181755065918,28.095191955566406,28.47327423095703,96139007.0,0.0,0.0,0.1255283355712855,0.0,0.1255283355712855,52.148547612447054,26.955713272094727,29.5527286529541,58.434808282118475,-41.565191717881525,0.2383047977788273,0.30065499996462824,-0.014567742660332339,1237665762.0,1.0
276,2014-02-06,GOOG,28.670785903930664,28.895692825317383,28.581619262695312,28.89071083068848,78155853.0,0.0,0.0,0.41743659973144887,0.0,0.41743659973144887,57.83479974021481,26.955713272094727,29.5527286529541,74.50851361355612,-25.491486386443885,0.26294167554575765,0.29311233508085416,0.032149008896470654,1315821615.0,1.0
277,2014-02-07,GOOG,29.081743240356445,29.337535858154297,28.90565490722656,29.326078414916992,105843245.0,0.0,0.0,0.4353675842285121,0.0,0.4353675842285121,63.110150532420555,26.955713272094727,29.5527286529541,91.27266477866955,-8.72733522133045,0.3139777639680261,0.2972854208582886,0.06920446746662634,1421664860.0,1.0
278,2014-02-10,GOOG,29.185604095458984,29.449615478515625,29.116365432739254,29.2137508392334,78099643.0,0.0,0.0,-0.11232757568359375,0.11232757568359375,0.0,60.84397795714657,26.955713272094727,29.5527286529541,86.94740831267113,-13.052591687328876,0.34142460482934567,0.3061132576525,0.04445202887234867,1343565217.0,-1.0
279,2014-02-11,GOOG,29.394073486328125,29.685482025146484,29.19581794738769,29.643388748168945,82339476.0,0.0,0.0,0.4296379089355469,0.0,0.4296379089355469,66.20034304886292,26.955713272094727,29.685482025146484,98.4579911052729,-1.542008894727097,0.3933107708199941,0.3235527602859989,0.07521770295818375,1425904693.0,1.0
280,2014-02-12,GOOG,29.613998413085938,29.63890647888184,29.424211502075195,29.55646514892578,69238554.0,0.0,0.0,-0.08692359924316406,0.08692359924316406,0.0,64.15171602123952,26.955713272094727,29.685482025146484,95.27370675349448,-4.726293246505518,0.4225460750538659,0.3433514232395723,0.045182751007657895,1356666139.0,-1.0
281,2014-02-13,GOOG,29.408519744873047,29.885482788085938,29.381370544433597,29.885482788085938,73731331.0,0.0,0.0,0.32901763916015625,0.0,0.32901763916015625,68.41992091225822,26.955713272094727,29.885482788085938,100.0,-0.0,0.4668823094049763,0.3680576004726531,0.016029211861148474,1430397470.0,1.0
282,2014-02-14,GOOG,29.77863121032715,29.997312545776367,29.70864486694336,29.95771026611328,87795852.0,0.0,0.0,0.07222747802734375,0.0,0.07222747802734375,69.34444296656679,27.382862091064453,29.997312545776367,98.4852541538237,-1.5147458461762935,0.5020598153676552,0.3948580434516536,0.06120359712030932,1518193322.0,1.0
283,2014-02-18,GOOG,29.92309188842773,30.208520889282227,29.88797378540039,30.15895652770996,84672187.0,0.0,0.0,0.2012462615966797,0.0,0.2012462615966797,71.98151497473259,27.382862091064453,30.208520889282227,98.24591838181145,-1.754081618188556,0.5399528928638162,0.42387701333408623,0.06389258034865586,1602865509.0,1.0
284,2014-02-19,GOOG,30.01997756958008,30.11761283874512,29.825706481933597,29.94625473022461,84459392.0,0.0,0.0,-0.21270179748535156,0.21270179748535156,0.0,65.14713182970974,28.07601356506348,30.208520889282227,87.70151192077618,-12.29848807922381,0.5465202273706922,0.4484056561414075,0.05173203781622382,1518406117.0,-1.0
285,2014-02-20,GOOG,29.96617889404297,30.059579849243164,29.893451690673828,29.990339279174805,68287001.0,0.0,0.0,0.04408454895019531,0.0,0.04408454895019531,65.92093265498207,28.095191955566406,30.208520889282227,89.675927555499,-10.324072444501004,0.5489541403339366,0.46851535297991337,0.038061661235357036,1586693118.0,1.0
286,2014-02-21,GOOG,30.08249282836914,30.1338005065918,29.95870780944824,29.98236846923828,74771214.0,0.0,0.0,-0.007970809936523438,0.007970809936523438,0.0,65.61700443708739,28.095191955566406,30.208520889282227,89.29875910768389,-10.701240892316106,0.5439693164743922,0.48360614567880916,0.02237905951951147,1511921904.0,-1.0
287,2014-02-24,GOOG,30.021472930908203,30.39009094238281,30.01499557495117,30.19955444335937,67223027.0,0.0,0.0,0.2171859741210902,0.0,0.2171859741210902,69.96993011069155,28.095191955566406,30.39009094238281,91.69739059897537,-8.302609401024624,0.5511901240148767,0.4971229413460227,0.033744506467209945,1579144931.0,1.0
288,2014-02-25,GOOG,30.284984588623047,30.49818420410156,30.147499084472656,30.386104583740234,57763704.0,0.0,0.0,0.18655014038086293,0.0,0.18655014038086293,73.31781586380345,28.095191955566406,30.49818420410156,95.3358309653455,-4.6641690346545035,0.5654475756020432,0.5107878681972269,0.025055024642456347,1636908635.0,1.0
289,2014-02-26,GOOG,30.48573112487793,30.607276916503903,30.230688095092773,30.39034080505371,79585191.0,0.0,0.0,0.0042362213134765625,0.0,0.0042362213134765625,73.39552997167225,28.581619262695312,30.607276916503903,89.29058367576012,-10.709416324239882,0.5705120288235221,0.522732700322486,0.028212969714960456,1716493826.0,1.0
290,2014-02-27,GOOG,30.346006393432617,30.4914608001709,30.311634063720703,30.36642837524414,50588912.0,0.0,0.0,-0.023912429809570312,0.023912429809570312,0.0,72.02912447983897,28.90565490722656,30.607276916503903,85.84594346178872,-14.154056538211282,0.5660707994388865,0.5314003201457661,0.016092950231673564,1665904914.0,-1.0
291,2014-02-28,GOOG,30.39457321166992,30.490463256835938,30.042892456054688,30.277761459350582,92890878.0,0.0,0.0,-0.08866691589355824,0.08866691589355824,0.0,66.71514102809053,29.116365432739254,30.607276916503903,77.89838895591089,-22.101611044089108,0.5490671101989832,0.5349336781564096,0.010683433092659511,1573014036.0,-1.0
292,2014-03-03,GOOG,30.05609130859375,30.083240509033203,29.69220542907715,29.95497131347656,84507572.0,0.0,0.0,-0.32279014587402344,0.32279014587402344,0.0,50.9315581036265,29.19581794738769,30.607276916503903,53.78501130388602,-46.21498869611398,0.5037383151421864,0.528694605553565,-0.0067636694938693065,1488506464.0,-1.0
293,2014-03-04,GOOG,30.261571884155277,30.28647994995117,30.12458610534668,30.25933074951172,58928052.0,0.0,0.0,0.3043594360351598,0.0,0.3043594360351598,60.97602886608586,29.381370544433597,30.607276916503903,71.61723155051605,-28.382768449483947,0.4867630795484388,0.5203083003525397,0.010454596813775252,1547434516.0,1.0
294,2014-03-05,GOOG,30.2628173828125,30.462818145751957,30.172157287597656,30.3427677154541,49597208.0,0.0,0.0,0.08343696594238281,0.0,0.08343696594238281,63.34919400593534,29.381370544433597,30.607276916503903,78.42337660721192,-21.576623392788076,0.4745721762423969,0.5111610755305112,0.011751398775405653,1597031724.0,1.0
295,2014-03-06,GOOG,30.44289207458496,30.539281845092773,30.35123634338379,30.376392364501957,50914126.0,0.0,0.0,0.033624649047855115,0.0,0.033624649047855115,64.35709247601721,29.69220542907715,30.607276916503903,74.76868690869063,-25.23131309130937,0.46229497698047695,0.5013878558205043,0.013141853541955628,1647945850.0,1.0
296,2014-03-07,GOOG,30.55547142028809,30.560203552246094,30.17290496826172,30.2563419342041,60831159.0,0.0,0.0,-0.12005043029785512,0.12005043029785512,0.0,57.80808201338617,29.69220542907715,30.607276916503903,61.64944628679721,-38.35055371320279,0.4378310973424462,0.48867650412489266,0.0018804082342087636,1587114691.0,-1.0
297,2014-03-10,GOOG,30.278757095336918,30.32732582092285,29.98984146118164,30.1761417388916,48766105.0,0.0,0.0,-0.0802001953125,0.0802001953125,0.0,53.603417408642095,29.69220542907715,30.607276916503903,52.885082363927246,-47.114917636072754,0.4072769755237289,0.4723965984046599,-0.006909830915312054,1538348586.0,-1.0
298,2014-03-11,GOOG,30.23093605041504,30.24463653564453,29.80428504943848,29.88772392272949,68776830.0,0.0,0.0,-0.2884178161621129,0.2884178161621129,0.0,41.17598608032786,29.69220542907715,30.607276916503903,21.366472055877516,-78.63352794412248,0.3556895389025456,0.4490551865042371,-0.016538705029613854,1469571756.0,-1.0
299,2014-03-12,GOOG,29.798309326171875,30.0834903717041,29.494199752807617,30.06979179382324,78866507.0,0.0,0.0,0.18206787109375,0.0,0.18206787109375,49.67438513156437,29.494199752807617,30.607276916503903,51.71178241625283,-48.28821758374717,0.325742522275025,0.4243926536583947,-0.009768570006169375,1548438263.0,1.0
300,2014-03-13,GOOG,30.08597946166992,30.149492263793945,29.508394241333008,29.615493774414062,94175675.0,0.0,0.0,-0.45429801940917613,0.45429801940917613,0.0,35.08209583777793,29.494199752807617,30.607276916503903,10.897179958634172,-89.10282004136583,0.2623272966223027,0.3919795822511763,-0.021873072942517502,1454262588.0,-1.0
301,2014-03-14,GOOG,29.439403533935547,29.66057586669922,29.203786849975582,29.210512161254883,92099924.0,0.0,0.0,-0.4049816131591797,0.4049816131591797,0.0,26.94151614321389,29.203786849975582,30.607276916503903,0.47918481503301197,-99.52081518496699,0.17734729260921966,0.349053124322785,-0.02485260775017828,1362162664.0,-1.0
302,2014-03-17,GOOG,29.37116050720215,29.81499671936035,29.34276580810547,29.69120979309082,86808163.0,0.0,0.0,0.4806976318359375,0.0,0.4806976318359375,44.560279336328264,29.203786849975582,30.607276916503903,34.72934755576358,-65.2706524442364,0.14709271544811386,0.3086610425478508,-0.018775066809105345,1448970827.0,1.0
303,2014-03-18,GOOG,29.755220413208008,30.175146102905277,29.71512031555176,30.168420791625977,72872123.0,0.0,0.0,0.47721099853515625,0.0,0.47721099853515625,56.560212430063864,29.203786849975582,30.560203552246094,71.11634205297602,-28.883657947023984,0.15978083048239,0.27888500013475864,-0.005745913670865521,1521842950.0,1.0
304,2014-03-19,GOOG,30.18187141418457,30.186603546142575,29.748743057250977,29.869293212890625,64757822.0,0.0,0.0,-0.29912757873535156,0.29912757873535156,0.0,48.90427258265187,29.203786849975582,30.560203552246094,49.06356297449367,-50.93643702550633,0.14403876811315186,0.2519157537304373,-0.016693857042876847,1457085128.0,-1.0
305,2014-03-20,GOOG,29.88672637939453,30.1273250579834,29.77240562438965,29.817237854003903,67640587.0,0.0,0.0,-0.0520553588867223,0.0520553588867223,0.0,47.61024134649282,29.203786849975582,30.560203552246094,45.22585153968262,-54.77414846031737,0.1259112117805472,0.22671484534045927,-0.014512794744159119,1389444541.0,-1.0
306,2014-03-21,GOOG,30.04513359069824,30.127824783325195,29.45086097717285,29.46555519104004,128821050.0,0.0,0.0,-0.35168266296386363,0.35168266296386363,0.0,39.469048628277996,29.203786849975582,30.560203552246094,19.29851944658906,-80.70148055341095,0.08221936733303536,0.1978157497389745,-0.023547958980314032,1260623491.0,-1.0
307,2014-03-24,GOOG,29.494199752807617,29.511882781982425,28.541767120361328,28.840150833129883,121939352.0,0.0,0.0,-0.6254043579101562,0.6254043579101562,0.0,29.217516081350936,28.541767120361328,30.560203552246094,14.782913549074786,-85.21708645092522,-0.0028389139007316544,0.1576848170110333,-0.035050279917867244,1138684139.0,-1.0
308,2014-03-25,GOOG,29.041147232055664,29.13678741455078,28.567920684814453,28.859825134277344,96769361.0,0.0,0.0,0.019674301147460938,0.0,0.019674301147460938,29.878618760453236,28.541767120361328,30.560203552246094,15.757643336779301,-84.24235666322069,-0.06787820521573096,0.11257221256568044,-0.04023861115641114,1235453500.0,1.0
309,2014-03-26,GOOG,28.941768646240234,29.17987632751465,28.181867599487305,28.193574905395508,103586819.0,0.0,0.0,-0.6662502288818359,0.6662502288818359,0.0,21.889957587853488,28.181867599487305,30.560203552246094,0.49224777915092466,-99.50775222084907,-0.17120954053962834,0.05581586194461867,-0.04801266795851988,1131866681.0,-1.0
310,2014-03-27,GOOG,28.322240829467773,28.322240829467773,27.5703067779541,27.846546173095703,262719.0,0.0,2.002,-0.3470287322998047,0.3470287322998047,0.0,18.859431354224867,27.5703067779541,30.32732582092285,10.019495362068584,-89.98050463793142,-0.27789923728015964,-0.010927157900337013,-0.046694353752836926,1131603962.0,-1.0
311,2014-03-28,GOOG,27.98317146301269,28.243955612182617,27.85701942443848,27.92283821105957,824257.0,0.0,0.0,0.07629203796386719,0.0,0.07629203796386719,21.612283156314433,27.5703067779541,30.24463653564453,13.182048028733654,-86.81795197126635,-0.35223511360948123,-0.07918874904216588,-0.059558758109033105,1132428219.0,1.0
312,2014-03-31,GOOG,28.26689338684082,28.27237892150879,27.7702579498291,27.77225112915039,216593.0,0.0,0.0,-0.1505870819091797,0.1505870819091797,0.0,20.062117990605884,27.5703067779541,30.186603546142575,7.718709652961715,-92.28129034703828,-0.41847404189845605,-0.14704580761342395,-0.0794264200644107,1132211626.0,-1.0
313,2014-04-01,GOOG,27.85901260375977,28.34468078613281,27.85901260375977,28.28035545349121,158434.0,0.0,0.0,0.5081043243408203,0.0,0.5081043243408203,37.51182834899043,27.5703067779541,30.186603546142575,27.139454673895724,-72.86054532610427,-0.4250691644931557,-0.20265047898937033,-0.05319636283571916,1132370060.0,1.0
314,2014-04-02,GOOG,29.91736221313477,30.15869903564453,28.03253746032715,28.27237892150879,2942055.0,0.0,0.0,-0.007976531982421875,0.007976531982421875,0.0,37.364088007583334,27.5703067779541,30.186603546142575,26.83457595832307,-73.16542404167693,-0.4260284948380644,-0.24732608215910917,-0.051810933663919756,1129428005.0,-1.0
315,2014-04-03,GOOG,28.41448783874512,29.283601760864254,28.129270553588867,28.40900230407715,101983228.0,0.0,0.0,0.13662338256835938,0.0,0.13662338256835938,41.88743341376936,27.5703067779541,30.186603546142575,32.056589922089024,-67.94341007791097,-0.41102634997673704,-0.2800661357226348,-0.03585721973038436,1231411233.0,1.0
316,2014-04-04,GOOG,28.653831481933597,28.809404373168945,27.075664520263672,27.08264541625977,127386783.0,0.0,0.0,-1.3263568878173793,1.3263568878173793,0.0,23.15571041858611,27.075664520263672,30.186603546142575,0.2243983549026667,-99.77560164509734,-0.5003947192680052,-0.3241318524317089,-0.06093953624026105,1104024450.0,-1.0
317,2014-04-07,GOOG,26.96297264099121,27.348913192749023,26.28533363342285,26.83382797241211,88033033.0,0.0,0.0,-0.2488174438476598,0.2488174438476598,0.0,21.112118720936635,26.28533363342285,30.186603546142575,14.059379413891454,-85.94062058610855,-0.5845588534719752,-0.3762172526397622,-0.07020129721641732,1015991417.0,-1.0
318,2014-04-08,GOOG,27.05571937561035,27.674020767211918,27.0063533782959,27.669034957885746,63024560.0,0.0,0.0,0.8352069854736364,0.0,0.8352069854736364,41.2082896241305,26.28533363342285,30.15869903564453,35.723490576676106,-64.2765094233239,-0.5772115768320987,-0.4164161174782295,-0.018604946313827697,1079015977.0,1.0
319,2014-04-09,GOOG,27.90438842773437,28.19110107421875,27.571802139282227,28.129770278930664,66616395.0,0.0,0.0,0.4607353210449183,0.0,0.4607353210449183,49.41111436188052,26.28533363342285,30.15869903564453,47.61845201720145,-52.38154798279855,-0.5281234390192253,-0.4387575817864287,0.010170888126463717,1145632372.0,1.0
320,2014-04-10,GOOG,28.172651290893555,28.172651290893555,26.92108726501465,26.97344398498535,80737057.0,0.0,0.0,-1.1563262939453125,1.1563262939453125,0.0,35.19210400668953,26.28533363342285,30.15869903564453,17.765180407916446,-82.23481959208355,-0.5758881244188991,-0.46618369031292284,-0.03400063485302096,1064895315.0,-1.0
321,2014-04-11,GOOG,26.554594039916992,26.92607307434082,26.254417419433597,26.45736122131348,78496923.0,0.0,0.0,-0.5160827636718714,0.5160827636718714,0.0,30.649954581779326,26.254417419433597,30.15869903564453,5.197980623048338,-94.80201937695166,-0.647916766498124,-0.502530305549963,-0.047345456503407934,986398392.0,-1.0
322,2014-04-14,GOOG,26.83881378173828,27.130512237548828,26.40550422668457,26.553098678588867,51501009.0,0.0,0.0,0.09573745727538707,0.0,0.09573745727538707,32.51435014175213,26.254417419433597,30.15869903564453,7.6500951651417255,-92.34990483485828,-0.6893286203502953,-0.5398899685100295,-0.06107620456690954,1037899401.0,1.0
323,2014-04-15,GOOG,26.76750946044922,26.848787307739254,25.852022171020508,26.74856185913086,77101101.0,0.0,0.0,0.1954631805419922,0.0,0.1954631805419922,36.533784072924824,25.852022171020508,30.15869903564453,20.817435723462857,-79.18256427653715,-0.6983257037486901,-0.5715771155577616,-0.05389773059452929,1115000502.0,1.0
324,2014-04-16,GOOG,27.075664520263672,27.77374649047852,26.92607307434082,27.750810623168945,97865955.0,0.0,0.0,1.002248764038086,0.0,1.002248764038086,53.07074203062621,25.852022171020508,30.15869903564453,44.0894107413885,-55.910589258611495,-0.6174651046798836,-0.580754713382186,-0.023168419427870623,1212866457.0,1.0
325,2014-04-17,GOOG,27.365367889404297,27.3997745513916,26.48478507995605,26.73160743713379,136190888.0,0.0,0.0,-1.0192031860351562,1.0192031860351562,0.0,40.64432153160995,25.852022171020508,30.15869903564453,20.423758126326707,-79.5762418736733,-0.6283801019619517,-0.5902797910981391,-0.01296173153436575,1076675569.0,-1.0
326,2014-04-21,GOOG,26.73160743713379,26.76152610778809,26.208045959472656,26.358631134033203,51334553.0,0.0,0.0,-0.37297630310058594,0.37297630310058594,0.0,36.98741975248437,25.852022171020508,30.15869903564453,11.763338159268253,-88.23666184073174,-0.6595238066098652,-0.6041285942004844,-0.017708872504789697,1025341016.0,-1.0
327,2014-04-22,GOOG,26.3596305847168,26.787954330444336,26.30328369140625,26.667285919189453,47307527.0,0.0,0.0,0.30865478515625,0.0,0.30865478515625,41.97265649822493,25.852022171020508,30.15869903564453,18.930227964528715,-81.06977203547129,-0.6517861700498777,-0.6136601093703631,-0.036204697425155086,1072648543.0,1.0
328,2014-04-23,GOOG,26.616424560546875,26.62041473388672,26.24045753479004,26.27486228942871,41046384.0,0.0,0.0,-0.3924236297607422,0.3924236297607422,0.0,37.60783129008934,25.852022171020508,29.283601760864254,12.322025683439175,-87.67797431656082,-0.6696006056595607,-0.6248482086282027,-0.06594109980668017,1031602159.0,-1.0
329,2014-04-24,GOOG,26.43093490600586,26.50971794128418,26.034521102905277,26.18610572814941,37663121.0,0.0,0.0,-0.08875656127930043,0.08875656127930043,0.0,36.61416009607741,25.852022171020508,28.809404373168945,11.296597270592972,-88.70340272940703,-0.6830073039097577,-0.6364800276845137,-0.029189385577689242,993939038.0,-1.0
330,2014-04-25,GOOG,26.05396842956543,26.163169860839844,25.700439453125,25.73833465576172,42007014.0,0.0,0.0,-0.44777107238769176,0.44777107238769176,0.0,31.733428958879855,25.700439453125,28.19110107421875,1.521491410787365,-98.47850858921264,-0.7214471980120791,-0.6534734617500269,-0.02717680571154346,951932024.0,-1.0
331,2014-04-28,GOOG,25.788198471069336,25.8590030670166,25.0711669921875,25.78670310974121,66710653.0,0.0,0.0,0.04836845397949219,0.0,0.04836845397949219,32.849114063215424,25.0711669921875,28.19110107421875,22.93433446798521,-77.06566553201479,-0.7394838515011699,-0.6706755397002555,-0.028862754517823608,1018642677.0,1.0
332,2014-04-29,GOOG,25.77423667907715,26.40051651000977,25.74531555175781,26.31275749206543,53981801.0,0.0,0.0,0.5260543823242188,0.0,0.5260543823242188,44.27740356866699,25.0711669921875,28.19110107421875,39.795408083416476,-60.204591916583524,-0.7032235141750007,-0.6771851345952046,-0.01629262796858233,1072624478.0,1.0
333,2014-04-30,GOOG,26.307771682739254,26.327716827392575,26.054466247558597,26.260900497436523,35023895.0,0.0,0.0,-0.05185699462890625,0.05185699462890625,0.0,43.43657080512479,25.0711669921875,28.172651290893555,38.36013310611898,-61.63986689388101,-0.6709372151100474,-0.6759355506981732,-0.05368888664061244,1037600583.0,-1.0
334,2014-05-01,GOOG,26.28333854675293,26.57354164123535,26.12228012084961,26.49475860595703,38110345.0,0.0,0.0,0.2338581085205078,0.0,0.2338581085205078,48.523220656145654,25.0711669921875,27.77374649047852,52.67529094591822,-47.32470905408178,-0.6193403258170562,-0.6646165057219499,-0.008860253979629529,1075710928.0,1.0
335,2014-05-02,GOOG,26.61492919921875,26.626895904541016,26.20854377746582,26.32422637939453,33770463.0,0.0,0.0,-0.1705322265625,0.1705322265625,0.0,45.10995243070803,25.0711669921875,27.77374649047852,46.365310918676236,-53.63468908132377,-0.5854611135232695,-0.6487854272822138,-0.001305255741989142,1041940465.0,-1.0
336,2014-05-05,GOOG,26.169153213500977,26.372594833374023,25.994632720947266,26.3182430267334,20482080.0,0.0,0.0,-0.0059833526611328125,0.0059833526611328125,0.0,44.98185388627861,25.0711669921875,27.77374649047852,46.14391677782241,-53.85608322217759,-0.5527229540920047,-0.629572932644172,-0.013088804519281294,1021458385.0,-1.0
337,2014-05-06,GOOG,26.18959617614746,26.26837921142578,25.6824893951416,25.68647766113281,33780490.0,0.0,0.0,-0.6317653656005895,0.6317653656005895,0.0,33.41980390879357,25.0711669921875,27.77374649047852,22.7675326233475,-77.23246737665251,-0.5711717990400587,-0.6178927059233494,-0.02239344289665901,987677895.0,-1.0
338,2014-05-07,GOOG,25.718889236450195,25.763267517089844,25.096099853515625,25.428186416625977,64486563.0,0.0,0.0,-0.2582912445068324,0.2582912445068324,0.0,29.805715133389683,25.0711669921875,27.3997745513916,15.331884628962674,-84.66811537103732,-0.5997213717201539,-0.6142584390827104,-0.02894356722575553,923191332.0,-1.0
339,2014-05-08,GOOG,25.353391647338867,25.790691375732425,25.25316619873047,25.48004531860352,40426688.0,0.0,0.0,0.051858901977542615,0.0,0.051858901977542615,31.521299068987915,25.0711669921875,26.787954330444336,23.81648077805487,-76.18351922194513,-0.6111179464915999,-0.6136303405644883,-0.010035200047427306,963618020.0,1.0
340,2014-05-09,GOOG,25.467578887939453,25.923826217651367,25.14097595214844,25.86548614501953,48789585.0,0.0,0.0,0.3854408264160121,0.0,0.3854408264160121,43.387345412108644,25.0711669921875,26.787954330444336,46.267766259189344,-53.732233740810656,-0.5823351634049097,-0.6073713051325726,0.0030551806077356858,1012407605.0,1.0
341,2014-05-12,GOOG,26.103832244873047,26.43691635131836,25.87944793701172,26.42345428466797,38250730.0,0.0,0.0,0.5579681396484375,0.0,0.5579681396484375,56.09497052563718,25.0711669921875,26.626895904541016,86.92306749218415,-13.076932507815853,-0.5086379727708277,-0.5876246386602236,0.004206962825386906,1050658335.0,1.0
342,2014-05-13,GOOG,26.47182273864746,26.730112075805664,26.403011322021484,26.581520080566406,33068541.0,0.0,0.0,0.1580657958984375,0.0,0.1580657958984375,59.09614679554052,25.0711669921875,26.730112075805664,91.04298287468454,-8.957017125315458,-0.4324923271850736,-0.5565981763651936,0.012209009480127264,1083726876.0,1.0
343,2014-05-14,GOOG,26.5770320892334,26.5770320892334,26.192588806152344,26.26040267944336,23835261.0,0.0,0.0,-0.3211174011230469,0.3211174011230469,0.0,50.9347376715164,25.0711669921875,26.730112075805664,71.68626008174623,-28.313739918253784,-0.3935215733007347,-0.5239828557523019,-0.008845369380379275,1059891615.0,-1.0
344,2014-05-15,GOOG,26.213031768798828,26.22150993347168,25.8001651763916,25.927814483642575,34087331.0,0.0,0.0,-0.3325881958007848,0.3325881958007848,0.0,43.7191944388595,25.0711669921875,26.730112075805664,51.638086149706886,-48.36191385029311,-0.3850356071212424,-0.49619340602608997,-0.015058824143156957,1025804284.0,-1.0
345,2014-05-16,GOOG,25.99812126159668,26.0185661315918,25.70143699645996,25.96022605895996,29705333.0,0.0,0.0,0.032411575317386365,0.0,0.032411575317386365,44.60165032036175,25.096099853515625,26.730112075805664,52.883705131243055,-47.11629486875695,-0.37141364918184294,-0.47123745465724054,-0.013603376464370043,1055509617.0,1.0
346,2014-05-19,GOOG,25.913854598999023,26.416473388671875,25.808292388916016,26.3705997467041,25555972.0,0.0,0.0,0.4103736877441406,0.0,0.4103736877441406,54.926451957494386,25.096099853515625,26.730112075805664,77.99818604797751,-22.001813952022488,-0.32377217827907145,-0.4417443993816068,0.026633549940031864,1081065589.0,1.0
347,2014-05-20,GOOG,26.414478302001957,26.73809051513672,26.242950439453125,26.41597557067871,35695734.0,0.0,0.0,0.045375823974609375,0.0,0.045375823974609375,55.97332425745057,25.096099853515625,26.73809051513672,80.38265673569713,-19.61734326430287,-0.27913680425439225,-0.4092228803561639,0.038846229057329706,1116761323.0,1.0
348,2014-05-21,GOOG,26.572046279907227,26.88533592224121,26.522682189941406,26.873220443725582,23925508.0,0.0,0.0,0.45724487304687145,0.0,0.45724487304687145,65.33469110234455,25.096099853515625,26.88533592224121,99.32286864056692,-0.6771313594330798,-0.20450964892934564,-0.3682802340708003,0.05467710546436422,1140686831.0,1.0
349,2014-05-22,GOOG,26.982419967651367,27.30503463745117,26.964967727661133,27.17838287353516,32316482.0,0.0,0.0,0.3051624298095774,0.0,0.3051624298095774,70.21214069343421,25.096099853515625,27.30503463745117,94.26638736294606,-5.733612637053943,-0.11936704395852615,-0.3184975960483455,0.05075863338329056,1173003313.0,1.0
350,2014-05-23,GOOG,27.2880802154541,27.6062068939209,27.110567092895508,27.559335708618164,38643806.0,0.0,0.0,0.38095283508300426,0.0,0.38095283508300426,75.2318573912881,25.096099853515625,27.6062068939209,98.13270173150995,-1.8672982684900448,-0.020910166678998365,-0.2589801101744761,0.04298762045692417,1211647119.0,1.0
351,2014-05-27,GOOG,27.72388458251953,28.22251510620117,27.64160919189453,28.22002220153809,42083223.0,0.0,0.0,0.6606864929199254,0.0,0.6606864929199254,81.47787117915581,25.096099853515625,28.22251510620117,99.92026316206916,-0.07973683793083675,0.10917104050138704,-0.18534988003930344,0.06164064793907631,1253730342.0,1.0
352,2014-05-28,GOOG,28.15121078491211,28.31426239013672,27.97319984436035,28.00710678100586,33040464.0,0.0,0.0,-0.21291542053223012,0.21291542053223012,0.0,74.49261535115471,25.14097595214844,28.31426239013672,90.32058356113663,-9.679416438863376,0.19285769587946788,-0.10970836485554918,0.06651474933131252,1220689878.0,-1.0
353,2014-05-29,GOOG,28.090377807617188,28.12278938293457,27.85901260375977,27.927326202392575,27082150.0,0.0,0.0,-0.0797805786132848,0.0797805786132848,0.0,71.83012976217125,25.14097595214844,28.31426239013672,87.80645254358303,-12.193547456416965,0.2498620925868309,-0.03779427336707314,0.07711840579588602,1193607728.0,-1.0
354,2014-05-30,GOOG,27.96322631835937,27.990652084350582,27.719396591186523,27.9178524017334,35422988.0,0.0,0.0,-0.009473800659176135,0.009473800659176135,0.0,71.48007658786821,25.70143699645996,28.31426239013672,84.82830160168132,-15.171698398318675,0.2909204809222139,0.02794867749078429,0.07540867858112432,1158184740.0,-1.0
355,2014-06-02,GOOG,27.958240509033203,27.968212127685547,27.211790084838867,27.62066650390625,28700582.0,0.0,0.0,-0.29718589782714844,0.29718589782714844,0.0,60.76211674229933,25.70143699645996,28.31426239013672,73.45418151901673,-26.545818480983275,0.29606626362703636,0.08157219471803473,0.047403804585763654,1129484158.0,-1.0
356,2014-06-03,GOOG,27.474069595336918,27.54138565063477,27.053224563598636,27.17239761352539,37332215.0,0.0,0.0,-0.4482688903808594,0.4482688903808594,0.0,48.18692446205882,25.70143699645996,28.31426239013672,56.2977005897627,-43.7022994102373,0.2609645435662564,0.11745066448767909,0.028635022046518577,1092151943.0,-1.0
357,2014-06-04,GOOG,27.00086975097656,27.355396270751957,26.863746643066406,27.15843772888184,36329469.0,0.0,0.0,-0.013959884643551135,0.013959884643551135,0.0,47.83122404796404,25.70143699645996,28.31426239013672,55.76341748468667,-44.23658251531333,0.22937563199645794,0.13983565798943487,0.010613438971839084,1055822474.0,-1.0
358,2014-06-05,GOOG,27.245197296142575,27.671527862548828,27.147964477539062,27.619171142578125,33782496.0,0.0,0.0,0.4607334136962855,0.0,0.4607334136962855,59.27834701407542,25.70143699645996,28.31426239013672,73.39694993623496,-26.603050063765032,0.23876618006996964,0.15962176240554182,0.016218340550061994,1089604970.0,1.0
359,2014-06-06,GOOG,27.826602935791016,27.826602935791016,27.37135124206543,27.740339279174805,34735104.0,0.0,0.0,0.12116813659667969,0.0,0.12116813659667969,61.82050483613949,25.808292388916016,28.31426239013672,77.09776610724207,-22.902233892757927,0.2530682992284916,0.1783110697701318,0.006567776976570627,1124340074.0,1.0
360,2014-06-09,GOOG,27.781227111816406,28.06793975830078,27.725879669189453,28.02904510498047,29350361.0,0.0,0.0,0.28870582580566406,0.0,0.28870582580566406,67.413339616818,26.242950439453125,28.31426239013672,86.23011444209936,-13.76988555790063,0.2844203581864164,0.19953292745338877,-0.006767432541113005,1153690435.0,1.0
361,2014-06-10,GOOG,27.948766708374023,28.10284423828125,27.81862449645996,27.950761795043945,27034019.0,0.0,0.0,-0.07828330993652344,0.07828330993652344,0.0,64.45908785547314,26.522682189941406,28.31426239013672,79.7106155195762,-20.289384480423802,0.29949785705382936,0.2195259133734769,-0.0020118103023810674,1126656416.0,-1.0
362,2014-06-11,GOOG,27.823610305786133,27.9173526763916,27.675018310546875,27.86549568176269,22002242.0,0.0,0.0,-0.08526611328125355,0.08526611328125355,0.0,61.09430103067478,26.863746643066406,28.31426239013672,69.06157625103856,-30.938423748961437,0.30109577610924276,0.2358398859206301,-0.002213979246770359,1104654174.0,-1.0
363,2014-06-12,GOOG,27.788705825805664,27.82311248779297,27.347915649414062,27.492021560668945,29169867.0,0.0,0.0,-0.37347412109374645,0.37347412109374645,0.0,48.341037822592504,26.863746643066406,28.31426239013672,43.31389844415691,-56.686101555843095,0.2691236087166011,0.2424966304798243,-0.015252994210901871,1075484307.0,-1.0
364,2014-06-13,GOOG,27.53739547729492,27.539390563964844,27.20331382751465,27.51246452331543,24410836.0,0.0,0.0,0.020442962646484375,0.0,0.020442962646484375,49.01325428488653,26.863746643066406,28.31426239013672,44.72325664573274,-55.27674335426725,0.24263803175437104,0.24252491073473367,-0.003917428298680581,1099895143.0,1.0
365,2014-06-16,GOOG,27.387807846069336,27.40575790405273,27.00186538696289,27.139488220214844,34051232.0,0.0,0.0,-0.37297630310058594,0.37297630310058594,0.0,38.473881204538344,26.863746643066406,28.31426239013672,19.0098989070176,-80.9901010929824,0.1893690224140876,0.23189373307060449,-0.0012111332160900101,1065843911.0,-1.0
366,2014-06-17,GOOG,27.135498046875,27.19134521484375,26.89266586303711,27.07616233825684,28891103.0,0.0,0.0,-0.06332588195800426,0.06332588195800426,0.0,36.918649987672694,26.863746643066406,28.12278938293457,16.871206073010324,-83.12879392698967,0.14042435474155823,0.21359985740479526,-0.003029459626740727,1036952808.0,-1.0
367,2014-06-18,GOOG,27.16840934753418,27.602218627929688,27.125526428222656,27.592744827270508,34835379.0,0.0,0.0,0.5165824890136683,0.0,0.5165824890136683,54.30487149456124,26.863746643066406,28.10284423828125,58.83299160771131,-41.1670083922887,0.1416859748653856,0.19921708089691334,-0.0009568105853429154,1071788187.0,1.0
368,2014-06-19,GOOG,27.636125564575195,27.674020767211918,27.35040855407715,27.669034957885746,49136535.0,0.0,0.0,0.07629013061523793,0.0,0.07629013061523793,56.354703465511754,26.863746643066406,28.10284423828125,64.98990216179968,-35.01009783820032,0.14714559108139014,0.18880278293380873,-0.002570419942289237,1120924722.0,1.0
369,2014-06-20,GOOG,27.766267776489254,27.80266761779785,27.44425201416016,27.74183464050293,90166875.0,0.0,0.0,0.07279968261718395,0.0,0.07279968261718395,58.40897125428143,26.863746643066406,28.10284423828125,70.86511997340081,-29.134880026599184,0.15555357742998055,0.18215294183304312,-0.010246887234360513,1211091597.0,1.0
370,2014-06-23,GOOG,27.68149948120117,28.172651290893555,27.63662338256836,28.17015838623047,30736155.0,0.0,0.0,0.42832374572753906,0.0,0.42832374572753906,68.48039636969841,26.863746643066406,28.172651290893555,99.8095426838598,-0.19045731614020106,0.19453661679325762,0.18462967682508605,0.007849395762280276,1241827752.0,1.0
371,2014-06-24,GOOG,28.18212509155273,28.553905487060547,27.97369766235352,28.153703689575195,44142862.0,0.0,0.0,-0.016454696655273438,0.016454696655273438,0.0,67.75314199777759,26.89266586303711,28.553905487060547,75.90944787868212,-24.09055212131789,0.22154931722453952,0.19201360490497676,0.01034282724068425,1197684890.0,-1.0
372,2014-06-25,GOOG,28.18561553955078,28.918603897094727,28.18362236022949,28.8532829284668,39387843.0,0.0,0.0,0.6995792388916051,0.0,0.6995792388916051,78.79853019384205,26.89266586303711,28.918603897094727,96.77576670510997,-3.224233294890026,0.2959952261665997,0.21280992915730138,0.04951477885297906,1237072733.0,1.0
373,2014-06-26,GOOG,28.970462799072266,29.042762756347656,28.51421356201172,28.72114562988281,34839390.0,0.0,0.0,-0.13213729858399148,0.13213729858399148,0.0,73.324829354888,26.89266586303711,29.042762756347656,85.04173800420467,-14.958261995795317,0.34040776090748537,0.2383294955073382,0.04393212776496558,1202233343.0,-1.0
374,2014-06-27,GOOG,28.779985427856445,28.91411590576172,28.611446380615234,28.78297615051269,44738493.0,0.0,0.0,0.06183052062988281,0.0,0.06183052062988281,74.28911425389464,26.89266586303711,29.042762756347656,87.91744657446735,-12.082553425532646,0.37625696486118443,0.2659149893781075,0.06055707156164036,1246971836.0,1.0
375,2014-06-30,GOOG,28.853782653808597,28.89915657043457,28.65881729125977,28.685245513916016,26275943.0,0.0,0.0,-0.09773063659667613,0.09773063659667613,0.0,69.69426832621039,26.89266586303711,29.042762756347656,83.37204041622681,-16.627959583773187,0.39225994321763835,0.29118398014601365,0.05942803694102716,1220695893.0,-1.0
376,2014-07-01,GOOG,28.836828231811523,29.13999557495117,28.753557205200195,29.053733825683597,28959290.0,0.0,0.0,0.3684883117675817,0.0,0.3684883117675817,76.11998140654143,26.89266586303711,29.13999557495117,96.16158907123149,-3.838410928768506,0.4297227694416961,0.31889173800515014,0.05294830244540094,1249655183.0,1.0
377,2014-07-02,GOOG,29.0876407623291,29.19185447692871,28.94004440307617,29.037029266357425,21127848.0,0.0,0.0,-0.016704559326171875,0.016704559326171875,0.0,75.28502392248959,26.89266586303711,29.19185447692871,93.26609354118067,-6.7339064588193445,0.452844303552002,0.34568225111452056,0.04944134519161447,1228527335.0,-1.0
378,2014-07-03,GOOG,29.0876407623291,29.170412063598636,28.966472625732425,29.156450271606445,14283107.0,0.0,0.0,0.11942100524901988,0.0,0.11942100524901988,77.33571965625981,26.89266586303711,29.19185447692871,98.4601434998262,-1.5398565001737958,0.4753253087175189,0.3716108626351203,0.05099214415466902,1242810442.0,1.0
379,2014-07-07,GOOG,29.108083724975582,29.24121856689453,28.90015411376953,29.03278923034668,21292298.0,0.0,0.0,-0.12366104125976562,0.12366104125976562,0.0,70.36032252736373,26.89266586303711,29.24121856689453,91.1252008010928,-8.874799198907187,0.4776571207698659,0.3928201142620695,0.030622151011329146,1221518144.0,-1.0
380,2014-07-08,GOOG,28.803918838500977,28.897062301635746,28.229246139526367,28.476318359375,38190565.0,0.0,0.0,-0.5564708709716797,0.5564708709716797,0.0,47.91880470962895,27.125526428222656,29.24121856689453,63.84633692500758,-36.15366307499242,0.42964981434283445,0.40018605427822246,0.011459048988970544,1183327579.0,-1.0
381,2014-07-09,GOOG,28.500751495361328,28.75704765319824,28.390853881835938,28.725135803222656,22335153.0,0.0,0.0,0.24881744384765625,0.0,0.24881744384765625,55.278023133389574,27.35040855407715,29.24121856689453,72.7057313969429,-27.29426860305711,0.40698964312610997,0.4015467720478,-0.004441336036590582,1205662732.0,1.0
382,2014-07-10,GOOG,28.218027114868164,28.750564575195312,28.17315101623535,28.476816177368164,27134293.0,0.0,0.0,-0.2483196258544922,0.2483196258544922,0.0,47.54217516887639,27.44425201416016,29.24121856689453,57.461512660699945,-42.538487339300055,0.36478891611463027,0.3941952008611661,-0.008506953575710852,1178528439.0,-1.0
383,2014-07-11,GOOG,28.5172061920166,28.96298217773437,28.492773056030277,28.879711151123047,32434806.0,0.0,0.0,0.4028949737548828,0.0,0.4028949737548828,58.43244446492657,27.63662338256836,29.24121856689453,77.47049104330358,-22.52950895669642,0.35970829979702046,0.387297820648337,0.0033608408006353674,1210963245.0,1.0
384,2014-07-14,GOOG,29.050243377685547,29.18038558959961,28.82236862182617,29.16343116760254,37081529.0,0.0,0.0,0.2837200164794922,0.0,0.2837200164794922,64.43217426048749,27.97369766235352,29.24121856689453,93.86302829300001,-6.136971706999985,0.3742614558508528,0.3846905476888402,0.01667009102134198,1248044774.0,1.0
385,2014-07-15,GOOG,29.20681381225586,29.210054397583008,28.749069213867188,29.15894317626953,32460877.0,0.0,0.0,-0.0044879913330078125,0.0044879913330078125,0.0,64.26287801854997,28.17315101623535,29.24121856689453,92.29679896423949,-7.703201035760525,0.3810403969735745,0.3839605175457871,0.0036211989556029778,1215583897.0,-1.0
386,2014-07-16,GOOG,29.319503784179688,29.339448928833008,29.030296325683597,29.0532341003418,27942506.0,0.0,0.0,-0.10570907592773082,0.10570907592773082,0.0,59.979784054047414,28.17315101623535,29.339448928833008,75.45954379239772,-24.540456207602283,0.37357655963704417,0.3818837259640385,0.0005580747891158477,1187641391.0,-1.0
387,2014-07-17,GOOG,28.89716339111328,28.96996307373047,28.352657318115234,28.60795783996582,60331186.0,0.0,0.0,-0.4452762603759801,0.4452762603759801,0.0,45.30405516890017,28.17315101623535,29.339448928833008,37.280939889709494,-62.71906011029051,0.3279509277378416,0.3710971663187992,-0.018812044214269963,1127310205.0,-1.0
388,2014-07-18,GOOG,29.568819046020508,29.758298873901367,29.02032470703125,29.672534942626957,80283816.0,0.0,0.0,1.0645771026611364,0.0,1.0645771026611364,67.34529539341199,28.17315101623535,29.758298873901367,94.58953113681837,-5.4104688631816344,0.3733905470862062,0.37155584247228063,0.02203528249402842,1207594021.0,1.0
389,2014-07-21,GOOG,29.50649070739746,29.63862609863281,29.18153190612793,29.39280128479004,41242922.0,0.0,0.0,-0.2797336578369176,0.2797336578369176,0.0,60.01297301594593,28.17315101623535,29.758298873901367,76.94236614308714,-23.05763385691286,0.38242128985835677,0.3737289319494959,0.03218403846483597,1166351099.0,-1.0
390,2014-07-22,GOOG,29.45513153076172,29.90040779113769,29.449146270751957,29.655580520629883,33983045.0,0.0,0.0,0.26277923583984375,0.0,0.26277923583984375,64.23383274848857,28.17315101623535,29.90040779113769,85.82565869387592,-14.174341306124076,0.4061010269136922,0.3802033509423352,0.03239130786991229,1200334144.0,1.0
391,2014-07-23,GOOG,29.58028793334961,29.81065559387207,29.543886184692383,29.71741104125977,24663528.0,0.0,0.0,0.061830520629886365,0.0,0.061830520629886365,65.23025423533312,28.17315101623535,29.90040779113769,89.4053534751213,-10.594646524878694,0.4249579447490177,0.38915426970367173,0.04356508312462126,1224997672.0,1.0
392,2014-07-24,GOOG,29.740846633911133,29.89292907714844,29.50748634338379,29.586271286010746,20702684.0,0.0,0.0,-0.13113975524902344,0.13113975524902344,0.0,61.06678724899546,28.17315101623535,29.90040779113769,81.81298173546273,-18.18701826453727,0.4244277666257865,0.3962089690880947,0.024465623329484876,1204294988.0,-1.0
393,2014-07-25,GOOG,29.43917465209961,29.5119743347168,29.271135330200195,29.370363235473636,18649061.0,0.0,0.0,-0.21590805053710938,0.21590805053710938,0.0,54.46304183856952,28.17315101623535,29.90040779113769,69.3129265222292,-30.687073477770806,0.40195216700917413,0.3973576086723107,0.00709560088049499,1185645927.0,-1.0
394,2014-07-28,GOOG,29.32299423217773,29.543886184692383,29.1575984954834,29.449146270751957,19736037.0,0.0,0.0,0.07878303527832031,0.0,0.07878303527832031,56.44605033100081,28.17315101623535,29.90040779113769,73.87409174230916,-26.125908257690845,0.38604711408948233,0.3950955097557451,0.009952455846157005,1205381964.0,1.0
395,2014-07-29,GOOG,29.35690116882324,29.40427017211914,29.095867156982425,29.20033073425293,26997920.0,0.0,0.0,-0.248815536499027,0.248815536499027,0.0,48.71534633394641,28.17315101623535,29.90040779113769,59.46884869365502,-40.53115130634498,0.34933796015431184,0.38594399983545846,0.005063003774488539,1178384044.0,-1.0
396,2014-07-30,GOOG,29.247201919555664,29.3942985534668,29.12005043029785,29.29058265686035,20329662.0,0.0,0.0,0.09025192260742188,0.0,0.09025192260742188,51.49565494582396,28.352657318115234,29.90040779113769,60.59926035193065,-39.40073964806935,0.3237957512090617,0.37351435011017914,0.023861361258750602,1198713706.0,1.0
397,2014-07-31,GOOG,28.950515747070312,29.102598190307617,28.42196655273437,28.501747131347656,42055146.0,0.0,0.0,-0.7888355255126953,0.7888355255126953,0.0,33.29295454220936,28.352657318115234,29.90040779113769,9.632677607345732,-90.36732239265427,0.23716701850497657,0.34624488378913865,-0.03945695281994155,1156658560.0,-1.0
398,2014-08-01,GOOG,28.441913604736328,28.719152450561523,28.06544685363769,28.22600555419922,39105069.0,0.0,0.0,-0.2757415771484375,0.2757415771484375,0.0,29.138649727297818,28.06544685363769,29.90040779113769,8.749979211016692,-91.2500207889833,0.14459626714372575,0.30591516046005607,-0.0396966495056259,1117553491.0,-1.0
399,2014-08-04,GOOG,28.374099731445312,28.68873405456543,28.127775192260746,28.579036712646484,28546159.0,0.0,0.0,0.3530311584472656,0.0,0.3530311584472656,40.167749144795934,28.06544685363769,29.90040779113769,27.989143992815517,-72.01085600718447,0.0985835342195216,0.2644488352119492,-0.03630155906860433,1146099650.0,1.0
400,2014-08-05,GOOG,28.424461364746094,28.52069664001465,28.0534782409668,28.1761417388916,31024946.0,0.0,0.0,-0.4028949737548828,0.4028949737548828,0.0,33.335491841964966,28.0534782409668,29.90040779113769,6.641482232684588,-93.3585177673154,0.02927044317629779,0.21741315680481887,-0.0518641849462681,1115074704.0,-1.0
401,2014-08-06,GOOG,28.01209259033203,28.45687294006348,27.92333602905273,28.24116325378418,26687069.0,0.0,0.0,0.06502151489257812,0.0,0.06502151489257812,35.38218220969016,27.92333602905273,29.90040779113769,16.075654451524702,-83.9243455484753,-0.0201813499650072,0.16989425545085365,-0.045463925454593324,1141761773.0,1.0
402,2014-08-07,GOOG,28.322240829467773,28.41648292541504,27.978185653686523,28.09087562561035,22218835.0,0.0,0.0,-0.15028762817382812,0.15028762817382812,0.0,32.7043860141855,27.92333602905273,29.90040779113769,8.47412824210986,-91.52587175789014,-0.07068440210992577,0.12177852393869777,-0.04356390146097733,1119542938.0,-1.0
403,2014-08-08,GOOG,28.100849151611328,28.43443298339844,27.94078826904297,28.36063575744629,29895854.0,0.0,0.0,0.2697601318359375,0.0,0.2697601318359375,41.82332378823363,27.92333602905273,29.90040779113769,22.118556178881185,-77.88144382111881,-0.08792747344897833,0.07983732446116254,-0.036962379258740796,1149438792.0,1.0
404,2014-08-11,GOOG,28.42146873474121,28.446399688720703,28.22251510620117,28.31625747680664,24294518.0,0.0,0.0,-0.04437828063964844,0.04437828063964844,0.0,40.77453714939502,27.92333602905273,29.89292907714844,19.949372188016383,-80.05062781198362,-0.10397512752975402,0.04307483406297922,-0.030276138496241112,1125144274.0,-1.0
405,2014-08-12,GOOG,28.148717880249023,28.217529296875,27.96721649169922,28.05946350097656,30840441.0,0.0,0.0,-0.2567939758300817,0.2567939758300817,0.0,34.926778988293776,27.92333602905273,29.89292907714844,6.911451685689193,-93.0885483143108,-0.13584816367031394,0.007290234516320579,-0.042031227931051185,1094303833.0,-1.0
406,2014-08-13,GOOG,28.2878360748291,28.671283721923828,28.21004867553711,28.66031265258789,28784812.0,0.0,0.0,0.6008491516113317,0.0,0.6008491516113317,53.090043926814054,27.92333602905273,29.543886184692383,45.476940097806825,-54.52305990219317,-0.1113408019576525,-0.016435972778474046,0.005563361449721027,1123088645.0,1.0
407,2014-08-14,GOOG,28.730121612548828,28.81588554382324,28.46584701538086,28.653831481933597,19709966.0,0.0,0.0,-0.006481170654293322,0.006481170654293322,0.0,52.906248587937476,27.92333602905273,29.543886184692383,45.077003654510804,-54.922996345489196,-0.09138805295340902,-0.03142638881346105,0.015157154522373872,1103378679.0,-1.0
408,2014-08-15,GOOG,28.81389045715332,28.88968276977539,28.447895050048828,28.59549140930176,30383189.0,0.0,0.0,-0.05834007263183594,0.05834007263183594,0.0,51.06992977072281,27.92333602905273,29.40427017211914,45.38725664446302,-54.612743355536985,-0.07936800692978707,-0.041014712436726254,0.00057576106643209,1072995490.0,-1.0
409,2014-08-18,GOOG,28.72663116455078,29.14548110961914,28.72114562988281,29.028303146362305,25682318.0,0.0,0.0,0.4328117370605433,0.0,0.4328117370605433,62.277700654819846,27.92333602905273,29.3942985534668,75.11864503480243,-24.881354965197577,-0.034519820827480174,-0.03971573411487704,0.030244077254000468,1098677808.0,1.0
410,2014-08-19,GOOG,29.16991424560547,29.28659439086914,29.12005043029785,29.262659072875977,19573592.0,0.0,0.0,0.23435592651367188,0.0,0.23435592651367188,67.00027252903928,27.92333602905273,29.28659439086914,98.24425665276884,-1.7557433472311565,0.019706094852942613,-0.02783136832131311,0.03617045834522847,1118251400.0,1.0
411,2014-08-20,GOOG,29.213794708251957,29.25468063354492,29.04874610900879,29.14448356628418,20734771.0,0.0,0.0,-0.11817550659179688,0.11817550659179688,0.0,62.45122162970002,27.92333602905273,29.28659439086914,89.57564988667211,-10.424350113327897,0.05253910980488996,-0.011757272696072492,0.03750712347724949,1097516629.0,-1.0
412,2014-08-21,GOOG,29.11107635498047,29.144981384277344,28.977441787719727,29.08863639831543,18296094.0,0.0,0.0,-0.05584716796875,0.05584716796875,0.0,60.221664669726074,27.92333602905273,29.28659439086914,85.479055320816,-14.520944679184,0.0732092008859162,0.005236022020325252,0.02566940484322533,1079220535.0,-1.0
413,2014-08-22,GOOG,29.099607467651367,29.18168258666992,28.952510833740234,29.048248291015625,15781209.0,0.0,0.0,-0.04038810729980469,0.04038810729980469,0.0,58.479529855265724,27.92333602905273,29.28659439086914,82.51643954444977,-17.483560455550222,0.08534758048518754,0.021258333713297713,0.02585054945232601,1063439326.0,-1.0
414,2014-08-25,GOOG,29.15595245361328,29.16991424560547,28.87073516845703,28.930570602416992,27228551.0,0.0,0.0,-0.11767768859863281,0.11767768859863281,0.0,53.29614630860795,27.92333602905273,29.28659439086914,73.88434955368393,-26.115650446316074,0.08449769098973903,0.03390620516858598,0.031045037671875608,1036210775.0,-1.0
415,2014-08-26,GOOG,28.98342514038086,29.010351181030277,28.75006675720215,28.81389045715332,32793789.0,0.0,0.0,-0.11668014526367188,0.11668014526367188,0.0,48.38922720598179,27.94078826904297,29.28659439086914,64.87577771793818,-35.12422228206182,0.07356106864617828,0.041837177864104444,0.00535855300767496,1003416986.0,-1.0
416,2014-08-27,GOOG,28.78447151184082,28.845304489135746,28.42710304260254,28.471830368041992,34067276.0,0.0,0.0,-0.3420600891113281,0.3420600891113281,0.0,36.89794238665333,27.94078826904297,29.28659439086914,39.459034283365696,-60.54096571663431,0.03686734239494882,0.04084321077027332,-0.006351719978752501,969349710.0,-1.0
417,2014-08-28,GOOG,28.40002822875977,28.584022521972656,28.27736473083496,28.38207626342773,25858801.0,0.0,0.0,-0.08975410461426137,0.08975410461426137,0.0,34.42298220560215,27.96721649169922,29.28659439086914,31.443589587904906,-68.55641041209509,0.0005386842243879642,0.03278230546109625,-0.007463244566051075,943490909.0,-1.0
418,2014-08-29,GOOG,28.488285064697266,28.5236873626709,28.275819778442383,28.501747131347656,21675347.0,0.0,0.0,0.11967086791992543,0.0,0.11967086791992543,40.55704845219219,27.96721649169922,29.28659439086914,40.51383913469628,-59.48616086530372,-0.0183836845278762,0.022549107463301757,-0.0181394004451354,965166256.0,1.0
419,2014-09-02,GOOG,28.51421356201172,28.812395095825195,28.48130416870117,28.787464141845703,31568434.0,0.0,0.0,0.2857170104980469,0.0,0.2857170104980469,52.73628838915592,28.21004867553711,29.28659439086914,53.635944863753934,-46.36405513624606,-0.010207161379202745,0.015997853694800855,-0.01623895251100882,996734690.0,1.0
420,2014-09-03,GOOG,28.920597076416016,29.06968879699707,28.671283721923828,28.817880630493164,24302540.0,0.0,0.0,0.030416488647460938,0.0,0.030416488647460938,53.896597454696675,28.275819778442383,29.28659439086914,53.62826147259013,-46.37173852740986,-0.0012583460130173307,0.012546613753237217,-0.011206338072459299,1021037230.0,1.0
421,2014-09-04,GOOG,28.920597076416016,29.219776153564453,28.881704330444336,29.01932716369629,29163850.0,0.0,0.0,0.201446533203125,0.0,0.201446533203125,61.17951575538816,28.275819778442383,29.28659439086914,73.55817767017588,-26.44182232982411,0.02183698315917937,0.01440468763442565,-0.002382691084933608,1050201080.0,1.0
422,2014-09-05,GOOG,29.119054794311523,29.247201919555664,29.017831802368164,29.223766326904297,32647388.0,0.0,0.0,0.2044391632080078,0.0,0.2044391632080078,67.23954344631315,28.275819778442383,29.28659439086914,93.78416679718534,-6.215833202814673,0.05599129700403083,0.02272200950834669,0.006042293295288159,1082848468.0,1.0
423,2014-09-08,GOOG,29.24969482421875,29.50748634338379,29.2347354888916,29.4052677154541,28620362.0,0.0,0.0,0.1815013885498047,0.0,0.1815013885498047,71.75605191343371,28.275819778442383,29.50748634338379,91.70078730402572,-8.299212695974282,0.09659104059010204,0.03749581572469777,0.016408148997844263,1111468830.0,1.0
424,2014-09-09,GOOG,29.3643798828125,29.369365692138672,28.920597076416016,28.97096061706543,25744488.0,0.0,0.0,-0.4343070983886719,0.4343070983886719,0.0,51.97292539960246,28.275819778442383,29.50748634338379,56.4390443330835,-43.560955666916506,0.09265362340756056,0.048527377261270335,0.005451195844090373,1085724342.0,-1.0
425,2014-09-10,GOOG,28.99539375305176,29.09511947631836,28.768016815185547,29.07517433166504,19547521.0,0.0,0.0,0.10421371459960938,0.0,0.10421371459960938,55.37898099356945,28.275819778442383,29.50748634338379,64.90023972199681,-35.09976027800318,0.09682621540174097,0.058187144889364474,0.021190908902726013,1105271863.0,1.0
426,2014-09-11,GOOG,28.938549041748047,29.01085090637207,28.73410987854004,28.987913131713867,24420864.0,0.0,0.0,-0.08726119995117188,0.08726119995117188,0.0,51.82780171214982,28.275819778442383,29.50748634338379,57.815432645552136,-42.184567354447864,0.09203090012584525,0.06495589593666064,0.02134575577428066,1080850999.0,-1.0
427,2014-09-12,GOOG,28.970462799072266,29.00237464904785,28.64435768127441,28.702198028564453,32033708.0,0.0,0.0,-0.28571510314941406,0.28571510314941406,0.0,41.720465589236845,28.275819778442383,29.50748634338379,34.61799339680495,-65.38200660319505,0.06443301354590503,0.06485131945850951,0.007032933675716002,1048817291.0,-1.0
428,2014-09-15,GOOG,28.568565368652344,28.668790817260746,28.332712173461918,28.5765438079834,31951483.0,0.0,0.0,-0.1256542205810547,0.1256542205810547,0.0,37.963541430322394,28.275819778442383,29.50748634338379,24.416026065895675,-75.58397393410432,0.032052759870872194,0.058291607540982046,-0.007326811865853378,1016865808.0,-1.0
429,2014-09-16,GOOG,28.559589385986328,28.99539375305176,28.55460357666016,28.91810417175293,29607064.0,0.0,0.0,0.34156036376953125,0.0,0.34156036376953125,51.6261157229738,28.275819778442383,29.50748634338379,52.14758698439639,-47.85241301560361,0.03356532222252184,0.053346350477290014,0.0034778248457909555,1046472872.0,1.0
430,2014-09-17,GOOG,28.92109680175781,29.295568466186523,28.859516143798828,29.158445358276367,33856699.0,0.0,0.0,0.2403411865234375,0.0,0.2403411865234375,58.963832904585765,28.275819778442383,29.50748634338379,71.6610814125634,-28.338918587436584,0.053540383705342975,0.053385157122900616,0.0047939841539164085,1080329571.0,1.0
431,2014-09-18,GOOG,29.26963996887207,29.39629173278809,29.16991424560547,29.38282966613769,28891103.0,0.0,0.0,0.22438430786132457,0.0,0.22438430786132457,64.7274948506435,28.275819778442383,29.50748634338379,89.87902401555996,-10.12097598444004,0.08647981673404104,0.0600040890451287,0.005442944535419381,1109220674.0,1.0
432,2014-09-19,GOOG,29.4940242767334,29.742341995239254,29.3942985534668,29.722396850585938,74732617.0,0.0,0.0,0.33956718444824574,0.0,0.33956718444824574,71.67440768656908,28.332712173461918,29.742341995239254,98.58507926370564,-1.4149207362943597,0.13838952038220853,0.07568117531254469,0.010784772925742425,1183953291.0,1.0
433,2014-09-22,GOOG,29.60970687866211,29.616138458251957,29.09312438964844,29.288089752197266,33790518.0,0.0,0.0,-0.4343070983886719,0.4343070983886719,0.0,55.533449406473096,28.332712173461918,29.742341995239254,67.77506860139756,-32.22493139860244,0.14283684706834165,0.08911230966370409,0.010946448732702008,1150162773.0,-1.0
434,2014-09-23,GOOG,29.26216125488281,29.26216125488281,28.970462799072266,28.97694396972656,29428575.0,0.0,0.0,-0.3111457824707067,0.3111457824707067,0.0,46.81794634740415,28.332712173461918,29.742341995239254,45.70219686842035,-54.29780313157965,0.11987270331117017,0.09526438839319731,-0.0033784960605206527,1120734198.0,-1.0
435,2014-09-24,GOOG,28.99339866638184,29.400779724121094,28.9465274810791,29.31900405883789,34562632.0,0.0,0.0,0.3420600891113317,0.0,0.3420600891113317,55.647560309637,28.332712173461918,29.742341995239254,69.96814838468751,-30.031851615312487,0.1278016268115998,0.10177183607687783,0.011421688950826736,1155296830.0,1.0
436,2014-09-25,GOOG,29.29706573486328,29.318506240844727,28.630395889282227,28.67427444458008,38519466.0,0.0,0.0,-0.644729614257809,0.644729614257809,0.0,40.88494877824623,28.332712173461918,29.742341995239254,24.230636003961955,-75.76936399603804,0.08112589534765036,0.09764264793103235,-0.0009728726683783107,1116777364.0,-1.0
437,2014-09-26,GOOG,28.72413825988769,28.883201599121094,28.65432929992676,28.7759952545166,28873054.0,0.0,0.0,0.10172080993651988,0.0,0.10172080993651988,43.60835199944249,28.332712173461918,29.742341995239254,31.4467723516071,-68.5532276483929,0.05174655900647096,0.08846343014612008,0.006979551056747635,1145650418.0,1.0
438,2014-09-29,GOOG,28.509227752685547,28.830345153808597,28.48030662536621,28.739097595214844,25648224.0,0.0,0.0,-0.03689765930175781,0.03689765930175781,0.0,42.78340483452869,28.332712173461918,29.742341995239254,28.829229878276387,-71.17077012172362,0.02519545305120019,0.07580983472713611,-0.006190121436554619,1120002194.0,-1.0
439,2014-09-30,GOOG,28.767518997192383,28.91311836242676,28.564077377319336,28.788959503173828,32434806.0,0.0,0.0,0.049861907958984375,0.0,0.049861907958984375,44.42275400499294,28.332712173461918,29.742341995239254,32.36646406477479,-67.63353593522523,0.008083764939939897,0.06226462076969687,-0.012671658264443941,1152437000.0,1.0
440,2014-10-01,GOOG,28.72164535522461,28.79993057250977,28.272876739501957,28.3357048034668,28909153.0,0.0,0.0,-0.4532546997070277,0.4532546997070277,0.0,34.15773332785096,28.272876739501957,29.742341995239254,4.275573288959462,-95.72442671104054,-0.0415720210491024,0.04149729240593701,-0.03563730500325679,1123527847.0,-1.0
441,2014-10-02,GOOG,28.2878360748291,28.5172061920166,28.088882446289062,28.42595672607422,23568530.0,0.0,0.0,0.09025192260741832,0.0,0.09025192260741832,37.47710208228756,28.088882446289062,29.742341995239254,20.386000975903535,-79.61399902409647,-0.07280278808551444,0.01863727630764672,-0.04361828997267292,1147096377.0,1.0
442,2014-10-03,GOOG,28.574050903320312,28.782228469848636,28.5466251373291,28.685245513916016,22834521.0,0.0,0.0,0.2592887878417969,0.0,0.2592887878417969,46.42971605206987,28.088882446289062,29.742341995239254,36.06759342891658,-63.93240657108342,-0.07575767048751203,-0.00024171305138503694,-0.020583255629910924,1169930898.0,1.0
443,2014-10-06,GOOG,28.860763549804688,28.970462799072266,28.643360137939453,28.788461685180664,24292512.0,0.0,0.0,0.10321617126464844,0.0,0.10321617126464844,49.73556837938731,28.088882446289062,29.742341995239254,42.3100304652615,-57.689969534738495,-0.06897564536838985,-0.013988499514786003,-0.006504560478938326,1194223410.0,1.0
444,2014-10-07,GOOG,28.64136505126953,28.68474578857422,28.10982322692871,28.10982322692871,38226664.0,0.0,0.0,-0.6786384582519531,0.6786384582519531,0.0,33.87602759102775,28.088882446289062,29.742341995239254,1.2664827907609884,-98.73351720923901,-0.11701244691204948,-0.03459328899423871,-0.04124222055710258,1155996746.0,-1.0
445,2014-10-08,GOOG,28.201074600219727,28.61543655395508,27.798179626464844,28.5466251373291,39817018.0,0.0,0.0,0.4368019104003906,0.0,0.4368019104003906,46.53708848212257,27.798179626464844,29.742341995239254,38.4970680888178,-61.5029319111822,-0.11847004561759533,-0.05136864031891004,-0.004451701384727058,1195813764.0,1.0
446,2014-10-09,GOOG,28.480806350708008,28.49626350402832,27.87646484375,27.96721649169922,50496258.0,0.0,0.0,-0.5794086456298828,0.5794086456298828,0.0,35.98983533162182,27.798179626464844,29.616138458251957,9.298167938610922,-90.70183206138907,-0.16448258561529272,-0.07399142937818659,-0.028106022247499474,1145317506.0,-1.0
447,2014-10-10,GOOG,27.809648513793945,28.179134368896484,27.128019332885746,27.149959564208984,61638766.0,0.0,0.0,-0.8172569274902344,0.8172569274902344,0.0,26.29182830207486,27.128019332885746,29.400779724121094,0.9653561109146718,-99.03464388908533,-0.2638521358336199,-0.11196357066927326,-0.0552953350654426,1083678740.0,-1.0
448,2014-10-13,GOOG,27.17489051818848,27.3997745513916,26.582019805908203,26.58750343322754,51633371.0,0.0,0.0,-0.5624561309814453,0.5624561309814453,0.0,21.657481428381942,26.582019805908203,29.400779724121094,0.19454041771718492,-99.80545958228282,-0.38356720544668477,-0.16628429762475558,-0.07646876121742396,1032045369.0,-1.0
449,2014-10-14,GOOG,26.871225357055664,27.28458976745605,26.585508346557617,26.82335662841797,44451708.0,0.0,0.0,0.2358531951904297,0.0,0.2358531951904297,27.813824300948724,26.582019805908203,29.318506240844727,8.819222322049033,-91.18077767795097,-0.45417542726000093,-0.22386252355180467,-0.05337252718922314,1076497077.0,1.0
450,2014-10-15,GOOG,26.47780418395996,26.56706047058105,25.84404563903809,26.428939819335938,74387672.0,0.0,0.0,-0.39441680908203125,0.39441680908203125,0.0,24.151689365392187,25.84404563903809,28.970462799072266,18.708129797095097,-81.2918702029049,-0.53578291997772,-0.2862466028369878,-0.07025328737331404,1002109405.0,-1.0
451,2014-10-16,GOOG,25.87894821166992,26.39902114868164,25.67949676513672,26.15369415283203,74171079.0,0.0,0.0,-0.27524566650390625,0.27524566650390625,0.0,21.83658131922779,25.67949676513672,28.970462799072266,14.409063563875105,-85.59093643612489,-0.6155715452756425,-0.35211159132471875,-0.08825273466304684,927938326.0,-1.0
452,2014-10-17,GOOG,26.290319442749023,26.47630882263184,25.356882095336918,25.48852157592773,110787334.0,0.0,0.0,-0.6651725769043004,0.6651725769043004,0.0,17.23090351083701,25.356882095336918,28.970462799072266,3.6429096617307555,-96.35709033826924,-0.7241311405153752,-0.4265155011628501,-0.11462717755953011,817150992.0,-1.0
453,2014-10-20,GOOG,25.40275764465332,26.016572952270508,25.33544158935547,25.9706974029541,52150788.0,0.0,0.0,0.48217582702637074,0.0,0.48217582702637074,29.642759022308624,25.33544158935547,28.970462799072266,17.4759864371775,-82.5240135628225,-0.7624685791824,-0.4937061167667601,-0.07609887144097605,869301780.0,1.0
454,2014-10-21,GOOG,26.18760108947754,26.267383575439453,25.88443374633789,26.25491714477539,46725935.0,0.0,0.0,0.28421974182128906,0.0,0.28421974182128906,36.154478034023185,25.33544158935547,28.970462799072266,25.29491583053398,-74.70508416946602,-0.7611431334436745,-0.5471935201021431,-0.0802794719701192,916027715.0,1.0
455,2014-10-22,GOOG,26.421958923339844,26.91610145568848,26.36760711669922,26.562572479248047,58385859.0,0.0,0.0,0.30765533447265625,0.0,0.30765533447265625,42.770062776561446,25.33544158935547,28.970462799072266,33.75856203018368,-66.24143796981632,-0.7268883770984935,-0.5831324915014132,-0.05022466261052738,974413574.0,1.0
456,2014-10-23,GOOG,26.892168045043945,27.28608512878418,26.71914291381836,27.124530792236328,46976621.0,0.0,0.0,0.5619583129882812,0.0,0.5619583129882812,53.02808466658795,25.33544158935547,28.970462799072266,49.218122802101796,-50.781877197898204,-0.6469383934318493,-0.5958936718875005,-0.0009366044141803087,1021390195.0,1.0
457,2014-10-24,GOOG,27.143478393554688,27.16940689086914,26.71615028381348,26.91510581970215,39462046.0,0.0,0.0,-0.2094249725341797,0.2094249725341797,0.0,49.233426267187156,25.33544158935547,28.68474578857422,47.16395216400911,-52.83604783599088,-0.5936332656509471,-0.5954415906401899,0.012321667857885021,981928149.0,-1.0
458,2014-10-27,GOOG,26.77798080444336,27.145971298217773,26.77798080444336,26.96446990966797,23706909.0,0.0,0.0,0.04936408996582031,0.0,0.04936408996582031,50.20260515064833,25.33544158935547,28.61543655395508,49.66557381624989,-50.33442618375011,-0.541167061316493,-0.5845866847754505,0.005260836039457484,1005635058.0,1.0
459,2014-10-28,GOOG,27.075664520263672,27.37384414672852,27.00685310363769,27.369855880737305,25419598.0,0.0,0.0,0.40538597106933594,0.0,0.40538597106933594,57.8308767585946,25.33544158935547,28.49626350402832,64.36345818591934,-35.63654181408066,-0.4615554327490159,-0.5599804343701636,0.03560173309384784,1031054656.0,1.0
460,2014-10-29,GOOG,27.424705505371094,27.63363265991211,27.274118423461918,27.39129638671875,35410955.0,0.0,0.0,0.021440505981445312,0.0,0.021440505981445312,58.22143629960268,25.33544158935547,28.179134368896484,72.29524975954348,-27.704750240456526,-0.3922114049583243,-0.5264266284877958,0.04732036042995125,1066465611.0,1.0
461,2014-10-30,GOOG,27.37234878540039,27.564321517944336,27.101093292236328,27.440162658691406,29113713.0,0.0,0.0,0.04886627197265625,0.0,0.04886627197265625,59.214820263827136,25.33544158935547,27.63363265991211,91.58163985147488,-8.418360148525123,-0.3295142286691295,-0.4870441485240625,0.0765694109385644,1095579324.0,1.0
462,2014-10-31,GOOG,27.89092445373535,27.90189552307129,27.66155433654785,27.87746238708496,40701440.0,0.0,0.0,0.4372997283935547,0.0,0.4372997283935547,67.25441711989438,25.33544158935547,27.90189552307129,99.0479807307138,-0.9520192692861936,-0.2417530526314522,-0.43798592934554054,0.0734198606431713,1136280764.0,1.0
463,2014-11-03,GOOG,27.69895362854004,27.81862449645996,27.58576393127441,27.68499183654785,27645693.0,0.0,0.0,-0.19247055053710938,0.19247055053710938,0.0,61.134426950819986,25.33544158935547,27.90189552307129,91.54850653370602,-8.451493466293984,-0.1855930520449931,-0.38750735388543106,0.054468832786129795,1108635071.0,-1.0
464,2014-11-04,GOOG,27.574295043945312,27.69895362854004,27.389801025390625,27.629642486572266,24884132.0,0.0,0.0,-0.05534934997558594,0.05534934997558594,0.0,59.34261377575118,25.33544158935547,27.90189552307129,89.39185960354082,-10.608140396459172,-0.14389336381097095,-0.3387845558705391,0.04017193772018368,1083750939.0,-1.0
465,2014-11-05,GOOG,27.76377487182617,27.76377487182617,27.128019332885746,27.221263885498047,40645286.0,0.0,0.0,-0.40837860107421875,0.40837860107421875,0.0,47.49233075704548,25.33544158935547,27.90189552307129,73.47968616807414,-26.52031383192587,-0.1421600678294297,-0.29945965826231724,0.0035662586756857184,1043105653.0,-1.0
466,2014-11-06,GOOG,27.20032119750977,27.26938247680664,26.974441528320312,27.027795791625977,26665008.0,0.0,0.0,-0.1934680938720703,0.1934680938720703,0.0,42.81835638693608,25.33544158935547,27.90189552307129,65.94134342478714,-34.058656575212865,-0.1546153668669703,-0.2704907999832479,0.004186867132483618,1016440645.0,-1.0
467,2014-11-07,GOOG,27.2357234954834,27.2357234954834,26.85975646972656,26.976436614990234,32675465.0,0.0,0.0,-0.05135917663574219,0.05135917663574219,0.0,41.56535670328626,25.88443374633789,27.90189552307129,54.12756173355986,-45.87243826644015,-0.16670882189163194,-0.2497344043649247,0.00044379531147309415,983765180.0,-1.0
468,2014-11-10,GOOG,26.99887466430664,27.40426254272461,26.9769344329834,27.299549102783203,22692131.0,0.0,0.0,0.32311248779296875,0.0,0.32311248779296875,51.803477898721844,26.36760711669922,27.90189552307129,60.74099121218186,-39.25900878781814,-0.14850858025633684,-0.22948923954320713,-0.002568766830941982,1006457311.0,1.0
469,2014-11-11,GOOG,27.34941291809082,27.521440505981445,27.240211486816406,27.439165115356445,19310873.0,0.0,0.0,0.1396160125732422,0.0,0.1396160125732422,55.67537931221915,26.71615028381348,27.90189552307129,60.975562676137784,-39.024437323862216,-0.1214192665162166,-0.20787524493780904,0.0017475890137461647,1025768184.0,1.0
470,2014-11-12,GOOG,27.44415283203125,27.447641372680664,27.18386650085449,27.290573120117188,22593862.0,0.0,0.0,-0.1485919952392578,0.1485919952392578,0.0,50.67596940705164,26.71615028381348,27.90189552307129,48.44403479648417,-51.55596520351583,-0.11066524236265707,-0.18843324442277867,-0.005451481481172582,1003174322.0,-1.0
471,2014-11-13,GOOG,27.41473388671875,27.41473388671875,27.099597930908203,27.194337844848636,26787343.0,0.0,0.0,-0.09623527526855113,0.09623527526855113,0.0,47.48929240749913,26.77798080444336,27.90189552307129,37.045252055562,-62.954747944438004,-0.10865547055593794,-0.17247768964941054,-0.02450454538332736,976386979.0,-1.0
472,2014-11-14,GOOG,27.25915908813477,27.25915908813477,27.033279418945312,27.145471572875977,25790614.0,0.0,0.0,-0.0488662719726598,0.0488662719726598,0.0,45.80180179639888,26.85975646972656,27.90189552307129,27.4162168889477,-72.5837831110523,-0.10974078818033206,-0.15993030935559485,-0.019487824553360955,950596365.0,-1.0
473,2014-11-17,GOOG,27.10458374023437,27.11505508422852,26.62993812561035,26.752052307128903,34520517.0,0.0,0.0,-0.39341926574707387,0.39341926574707387,0.0,34.434964794927794,26.62993812561035,27.90189552307129,9.600493048140892,-90.39950695185911,-0.14072437403476457,-0.1560891222914288,-0.03176263246510924,916075848.0,-1.0
474,2014-11-18,GOOG,26.801416397094727,27.02280807495117,26.635372161865234,26.67825508117676,39253475.0,0.0,0.0,-0.07379722595214133,0.07379722595214133,0.0,32.679604842575614,26.62993812561035,27.90189552307129,3.7986300219535174,-96.20136997804649,-0.16928252486237128,-0.1587278028056173,-0.01994796445181113,876822373.0,-1.0
475,2014-11-19,GOOG,26.676759719848636,26.838314056396484,26.431432723999023,26.77598762512207,27844237.0,0.0,0.0,0.09773254394530895,0.0,0.09773254394530895,37.54461244753316,26.431432723999023,27.90189552307129,23.431731924155518,-76.56826807584449,-0.18193167058223736,-0.16336857636094132,-0.009316637155514007,904666610.0,1.0
476,2014-11-20,GOOG,26.48977279663086,26.68224334716797,26.48129653930664,26.66828155517578,31267610.0,0.0,0.0,-0.10770606994628906,0.10770606994628906,0.0,34.38486032586415,26.431432723999023,27.81862449645996,17.073978946442125,-82.92602105355788,-0.19836061174785158,-0.17036698343832338,-0.011423119525104997,873399000.0,-1.0
477,2014-11-21,GOOG,27.0063533782959,27.03278160095215,26.754545211791992,26.801416397094727,44485801.0,0.0,0.0,0.1331348419189453,0.0,0.1331348419189453,41.416840434310124,26.431432723999023,27.76377487182617,27.76941896637379,-72.23058103362621,-0.19835132627726182,-0.1759638520061111,-0.018246920629091723,917884801.0,1.0
478,2014-11-24,GOOG,26.808895111083984,27.060705184936523,26.707674026489254,26.889673233032227,34127440.0,0.0,0.0,0.0882568359375,0.0,0.0882568359375,45.85531693915611,26.431432723999023,27.76377487182617,34.393606010327474,-65.60639398967251,-0.18904320600440983,-0.17857972280577086,-0.02002582367262673,952012241.0,1.0
479,2014-11-25,GOOG,26.87621116638184,27.124530792236328,26.856365203857425,26.97992706298828,35798014.0,0.0,0.0,0.09025382995605469,0.0,0.09025382995605469,50.29851518858442,26.431432723999023,27.521440505981445,50.32022230077098,-49.679777699229014,-0.172396444927994,-0.1773430672302155,-0.011382907048585023,987810255.0,1.0
480,2014-11-26,GOOG,26.969953536987305,27.00336265563965,26.778579711914062,26.94452476501465,30459397.0,0.0,0.0,-0.03540229797363281,0.03540229797363281,0.0,48.4972777853522,26.431432723999023,27.521440505981445,47.072328243606925,-52.92767175639307,-0.16021359383835332,-0.17391717255184308,-0.009186216677134817,957350858.0,-1.0
481,2014-11-28,GOOG,26.95698928833008,27.02580070495605,26.756540298461918,27.01732444763184,22966883.0,0.0,0.0,0.07279968261719105,0.0,0.07279968261719105,52.53070747211811,26.431432723999023,27.521440505981445,53.75115052547987,-46.24884947452013,-0.1430354470056301,-0.1677408274426005,-0.0047207551690567895,980317741.0,1.0
482,2014-12-01,GOOG,26.871225357055664,26.996381759643555,26.52018928527832,26.61692237854004,42307838.0,0.0,0.0,-0.4004020690918004,0.4004020690918004,0.0,35.09058184116377,26.431432723999023,27.521440505981445,17.01727800545253,-82.98272199454748,-0.15988765716958397,-0.1661701933879972,-0.005051198578617244,938009903.0,-1.0
483,2014-12-02,GOOG,26.602462768554688,26.701690673828125,26.41747093200684,26.614429473876957,30533600.0,0.0,0.0,-0.002492904663082385,0.002492904663082385,0.0,35.007088926780455,26.41747093200684,27.447641372680664,19.119024784023942,-80.88097521597606,-0.17146773835754914,-0.16722970238190762,-0.002392420610178414,907476303.0,-1.0
484,2014-12-03,GOOG,26.49924659729004,26.726423263549805,26.390544891357425,26.493263244628903,25559983.0,0.0,0.0,-0.12116622924805398,0.12116622924805398,0.0,30.88572738191131,26.390544891357425,27.41473388671875,10.029238132483464,-89.97076186751653,-0.18825208534389049,-0.1714341789743042,-0.01055887776956943,881916320.0,-1.0
485,2014-12-04,GOOG,26.48528480529785,26.793439865112305,26.35713577270508,26.791942596435547,27842232.0,0.0,0.0,0.2986793518066442,0.0,0.2986793518066442,48.22336893512477,26.35713577270508,27.25915908813477,48.203501649327194,-51.79649835067281,-0.17543061876065025,-0.17223346693157343,0.004637008237816653,909758552.0,1.0
486,2014-12-05,GOOG,26.4773063659668,26.571548461914062,26.14222717285156,26.191091537475582,51312493.0,0.0,0.0,-0.6008510589599645,0.6008510589599645,0.0,30.477141397380365,26.14222717285156,27.124530792236328,4.974466515213279,-95.02553348478672,-0.2113172394599232,-0.18005022143724342,-0.022772112136778877,858446059.0,-1.0
487,2014-12-08,GOOG,26.28433609008789,26.4773063659668,26.117794036865234,26.276857376098636,46587556.0,0.0,0.0,0.08576583862305398,0.0,0.08576583862305398,34.450116442274265,26.117794036865234,27.124530792236328,15.799893903224937,-84.20010609677506,-0.2301836447391672,-0.1900769060976282,-0.022790007584799765,905033615.0,1.0
488,2014-12-09,GOOG,26.035518646240234,26.636369705200195,25.953744888305664,26.595481872558597,37426473.0,0.0,0.0,0.31862449645996094,0.0,0.31862449645996094,47.347937201214826,25.953744888305664,27.124530792236328,54.812496639943994,-45.187503360056,-0.21692450220912818,-0.19544642531992823,-0.014249304289523979,942460088.0,1.0
489,2014-12-10,GOOG,26.58102226257324,26.74307632446289,26.20605087280273,26.23098373413086,34245764.0,0.0,0.0,-0.3644981384277379,0.3644981384277379,0.0,37.58602548287741,25.953744888305664,27.124530792236328,23.67972187693967,-76.32027812306033,-0.2331409856033737,-0.20298533737661736,-0.026481856225212264,908214324.0,-1.0
490,2014-12-11,GOOG,26.317745208740234,26.622907638549805,26.28284072875977,26.34467124938965,32216207.0,0.0,0.0,0.11368751525878906,0.0,0.11368751525878906,41.89720589508583,25.953744888305664,27.124530792236328,33.390080950883714,-66.60991904911629,-0.2341202407707712,-0.20921231805544813,-0.024897106282526504,940430531.0,1.0
491,2014-12-12,GOOG,26.103832244873047,26.352649688720703,25.861995697021484,25.861995697021484,39891221.0,0.0,0.0,-0.48267555236816406,0.48267555236816406,0.0,31.30441526493064,25.861995697021484,27.124530792236328,0.0,-100.0,-0.270723459215958,-0.2215145462875501,-0.028362658566687515,900539310.0,-1.0
492,2014-12-15,GOOG,26.06543731689453,26.08338737487793,25.593233108520508,25.61966133117676,56268061.0,0.0,0.0,-0.242334365844723,0.242334365844723,0.0,27.305171735909425,25.593233108520508,27.124530792236328,1.7258710006093188,-98.27412899939068,-0.31564754320232424,-0.24034114567050494,-0.03737702300462975,844271249.0,-1.0
493,2014-12-16,GOOG,25.50796890258789,25.582263946533203,24.383056640625,24.70168113708496,79285081.0,0.0,0.0,-0.9179801940918004,0.9179801940918004,0.0,17.521386139520843,24.383056640625,27.02580070495605,12.056577886614733,-87.94342211338527,-0.4204765413733007,-0.2763682248110641,-0.06762406318169045,764986168.0,-1.0
494,2014-12-17,GOOG,24.78196144104004,25.28059196472168,24.77248764038086,25.17538070678711,57663883.0,0.0,0.0,0.47369956970214844,0.0,0.47369956970214844,32.02369511059803,24.383056640625,27.02580070495605,29.98111231640086,-70.01888768359915,-0.460027767526757,-0.3131001333542027,-0.06033761396097903,822650051.0,1.0
495,2014-12-18,GOOG,25.57727813720703,25.623151779174805,25.16590690612793,25.485031127929688,58534266.0,0.0,0.0,0.3096504211425781,0.0,0.3096504211425781,39.98318662521489,24.383056640625,26.996381759643555,42.167523638181635,-57.832476361818365,-0.46107125564671136,-0.34269435781270446,-0.026958036801773888,881184317.0,1.0
496,2014-12-19,GOOG,25.50547409057617,25.81512451171875,25.276153564453125,25.74681282043457,73804074.0,0.0,0.0,0.2617816925048828,0.0,0.2617816925048828,46.13559482356131,24.383056640625,26.793439865112305,56.578396578396585,-43.42160342160342,-0.43575155997794823,-0.36130579824575326,-0.02017153528207649,954988391.0,1.0
497,2014-12-22,GOOG,25.733348846435547,26.25092887878418,25.733348846435547,26.171646118164062,54475152.0,0.0,0.0,0.4248332977294922,0.0,0.4248332977294922,54.810034036949794,24.383056640625,26.793439865112305,74.20353159483595,-25.79646840516406,-0.37705852611684065,-0.3644563438199708,-0.015936381842054592,1009463543.0,1.0
498,2014-12-23,GOOG,26.277854919433597,26.65481948852539,26.242450714111328,26.456863403320312,43952341.0,0.0,0.0,0.28521728515625,0.0,0.28521728515625,59.82225591339936,24.383056640625,26.793439865112305,86.03639212334865,-13.963607876651354,-0.3040246161434865,-0.35236999828467397,0.008611177967204675,1053415884.0,1.0
499,2014-12-24,GOOG,26.45287322998047,26.51515388488769,26.27885055541992,26.366111755371094,14118657.0,0.0,0.0,-0.09075164794921875,0.09075164794921875,0.0,57.48156824625323,24.383056640625,26.74307632446289,84.0270582625492,-15.972941737450801,-0.2505790960162315,-0.3320118178309855,0.0008138460251974067,1039297227.0,-1.0
500,2014-12-26,GOOG,26.366111755371094,26.63936233520508,26.293312072753903,26.62839126586914,20810980.0,0.0,0.0,0.2622795104980469,0.0,0.2622795104980469,62.388990439409675,24.383056640625,26.74307632446289,95.14050415006507,-4.85949584993494,-0.18492764099342196,-0.30259498246347283,0.029634045950132304,1060108207.0,1.0
501,2014-12-29,GOOG,26.536643981933597,26.700693130493164,26.42799186706543,26.443897247314453,45570772.0,0.0,0.0,-0.1844940185546875,0.1844940185546875,0.0,57.04506829588062,24.383056640625,26.74307632446289,87.32302619349728,-12.676973806502712,-0.1461013498945185,-0.271296255949682,0.03217200670543896,1014537435.0,-1.0
502,2014-12-30,GOOG,26.332204818725582,26.48478507995605,26.28433609008789,26.44838523864746,17525986.0,0.0,0.0,0.0044879913330078125,0.0,0.0044879913330078125,57.14809266103775,24.383056640625,26.74307632446289,87.51319373166415,-12.486806268335853,-0.11365890200534068,-0.2397687851608137,0.07071195243226391,1032063421.0,1.0
503,2014-12-31,GOOG,26.48977279663086,26.55708885192871,26.218017578125,26.247936248779297,27364925.0,0.0,0.0,-0.20044898986816406,0.20044898986816406,0.0,50.86149321865572,24.383056640625,26.700693130493164,80.46471551111875,-19.535284488881246,-0.10293600439498007,-0.212402229007647,0.04260334945810906,1004698496.0,-1.0
504,2015-01-02,GOOG,26.37807846069336,26.49077033996582,26.133251190185547,26.16865348815918,28951268.0,0.0,0.0,-0.07928276062011719,0.07928276062011719,0.0,48.430115924726536,24.383056640625,26.700693130493164,77.0438701383991,-22.956129861600893,-0.09968636461416835,-0.18985905612895126,0.026824466362149968,975747228.0,-1.0
505,2015-01-05,GOOG,26.091365814208984,26.14472007751465,25.582763671875,25.623151779174805,41196796.0,0.0,0.0,-0.545501708984375,0.545501708984375,0.0,35.1066348167048,24.383056640625,26.700693130493164,53.50688703647163,-46.493112963528375,-0.13952012943861902,-0.17979127079088483,-0.004802965016377447,934550432.0,-1.0
506,2015-01-06,GOOG,25.67949676513672,25.738086700439453,24.98390769958496,25.029281616210938,57998800.0,0.0,0.0,-0.5938701629638672,0.5938701629638672,0.0,26.090384218781665,24.383056640625,26.700693130493164,27.88293066712534,-72.11706933287466,-0.2165132045723972,-0.18713565754718733,-0.043648935829079694,876551632.0,-1.0
507,2015-01-07,GOOG,25.28059196472168,25.29275894165039,24.914098739624023,24.986400604248047,41301082.0,0.0,0.0,-0.042881011962890625,0.042881011962890625,0.0,25.543816491985197,24.77248764038086,26.700693130493164,11.093888331099427,-88.90611166890056,-0.2777887349953687,-0.20526627303682365,-0.05557963454155057,835250550.0,-1.0
508,2015-01-08,GOOG,24.83132553100586,25.105073928833008,24.4827823638916,25.065183639526367,67071641.0,0.0,0.0,0.07878303527832031,0.0,0.07878303527832031,28.709801983547706,24.4827823638916,26.700693130493164,26.259003942127094,-73.7409960578729,-0.31634625903679847,-0.22748227023681866,-0.049340916397341394,902322191.0,1.0
509,2015-01-09,GOOG,25.16889953613281,25.176876068115234,24.671764373779297,24.740575790405277,41427428.0,0.0,0.0,-0.3246078491210902,0.3246078491210902,0.0,23.881966626320917,24.4827823638916,26.700693130493164,11.623255109973812,-88.37674489002619,-0.36884470305570716,-0.25575475680059634,-0.07089483764209092,860894763.0,-1.0
510,2015-01-12,GOOG,24.679243087768555,24.73090171813965,24.31125259399414,24.5600700378418,46535413.0,0.0,0.0,-0.18050575256347656,0.18050575256347656,0.0,21.55616006919604,24.31125259399414,26.700693130493164,10.413209286732192,-89.5867907132678,-0.4201719234681107,-0.28863819013409925,-0.07123863747670434,814359350.0,-1.0
511,2015-01-13,GOOG,24.873708724975582,25.080141067504883,24.552091598510746,24.74107360839844,47409807.0,0.0,0.0,0.18100357055664062,0.0,0.18100357055664062,29.50010089862397,24.31125259399414,26.700693130493164,17.98835366851474,-82.01164633148525,-0.4411582423967495,-0.31914220058662934,-0.06455258477384196,861769157.0,1.0
512,2015-01-14,GOOG,24.664783477783203,25.092607498168945,24.582508087158203,24.974931716918945,44714427.0,0.0,0.0,0.23385810852050426,0.0,0.23385810852050426,38.747399561165054,24.31125259399414,26.700693130493164,27.77550279184677,-72.22449720815322,-0.43391772301559683,-0.34209730507242286,-0.048499223702570315,906483584.0,1.0
513,2015-01-15,GOOG,25.209287643432617,25.214773178100582,24.81985664367676,25.02080535888672,54316718.0,0.0,0.0,0.04587364196777344,0.0,0.04587364196777344,40.51345301280723,24.31125259399414,26.700693130493164,29.69535144541431,-70.3046485545857,-0.4196405842777686,-0.35760596091349206,-0.043863476956956915,960800302.0,1.0
514,2015-01-16,GOOG,24.932048797607425,25.33992958068848,24.931549072265625,25.334444046020508,45965854.0,0.0,0.0,0.31363868713378906,0.0,0.31363868713378906,51.53663942953625,24.31125259399414,26.700693130493164,42.82138167478877,-57.17861832521124,-0.3786529525690554,-0.3618153592446048,-0.011267455918086644,1006766156.0,1.0
515,2015-01-20,GOOG,25.48004531860352,25.554838180541992,25.23152732849121,25.275606155395508,44640224.0,0.0,0.0,-0.058837890625,0.058837890625,0.0,49.54917135232867,24.31125259399414,26.55708885192871,42.9396202859533,-57.060379714046704,-0.3469186232451982,-0.3588360120447235,0.009841454619497814,962125932.0,-1.0
516,2015-01-21,GOOG,25.293058395385746,25.892911911010746,25.24070167541504,25.83108139038086,45374234.0,0.0,0.0,0.5554752349853516,0.0,0.5554752349853516,64.47343221975564,24.31125259399414,26.55708885192871,67.67317924524295,-32.326820754757044,-0.27379064137445397,-0.3418269379106696,0.03380562088599537,1007500166.0,1.0
517,2015-01-22,GOOG,26.002609252929688,26.74307632446289,25.913854598999023,26.64634132385254,53538588.0,0.0,0.0,0.8152599334716797,0.0,0.8152599334716797,76.33078401280385,24.31125259399414,26.74307632446289,96.02212120071279,-3.9778787992872022,-0.14834153676716255,-0.3031298576819682,0.06308183123912081,1061038754.0,1.0
518,2015-01-23,GOOG,26.706178665161133,27.034276962280277,26.5770320892334,26.92358016967773,45634948.0,0.0,0.0,0.27723884582519176,0.0,0.27723884582519176,79.07158041865108,24.31125259399414,27.034276962280277,95.93478509073283,-4.065214909267169,-0.026248780080042167,-0.247753642161583,0.0882357952283006,1106673702.0,1.0
519,2015-01-26,GOOG,26.85277557373047,26.87621116638184,26.41098976135254,26.68722915649414,30874534.0,0.0,0.0,-0.2363510131835902,0.2363510131835902,0.0,70.98590472742185,24.31125259399414,27.034276962280277,87.25506059262455,-12.744939407375455,0.050852857641149996,-0.1880323422010364,0.08661046631279334,1075799168.0,-1.0
520,2015-01-27,GOOG,26.42594718933105,26.46234893798828,25.83856010437012,25.86050033569336,38080263.0,0.0,0.0,-0.8267288208007812,0.8267288208007812,0.0,50.247887754887685,24.31125259399414,27.034276962280277,56.89437669903449,-43.105623300965505,0.04473072647403242,-0.14147972846602264,0.04524568112981675,1037718905.0,-1.0
521,2015-01-28,GOOG,26.067432403564453,26.077903747558597,25.4301815032959,25.4301815032959,33676205.0,0.0,0.0,-0.43031883239746094,0.43031883239746094,0.0,42.74753981223339,24.31125259399414,27.034276962280277,41.09140271873543,-58.90859728126456,0.00509700486724185,-0.11216438179936973,0.018228269511886275,1004042700.0,-1.0
522,2015-01-29,GOOG,25.48004531860352,25.48453140258789,24.99138641357422,25.463090896606445,83727244.0,0.0,0.0,0.032909393310546875,0.0,0.032909393310546875,43.49184688150024,24.31125259399414,27.034276962280277,42.29996308616468,-57.70003691383532,-0.02338789099782801,-0.09440908363906139,0.017676710696389986,1087769944.0,1.0
523,2015-01-30,GOOG,25.72237968444824,26.919591903686523,25.70542526245117,26.65282440185547,112127002.0,0.0,0.0,1.1897335052490234,0.0,1.1897335052490234,63.36099907012294,24.31125259399414,27.034276962280277,85.99158476628348,-14.008415233716523,0.04946892765763167,-0.06563348137972277,0.052039048239625796,1199896946.0,1.0
524,2015-02-02,GOOG,26.51370620727539,26.5770320892334,25.85651016235352,26.351652145385746,56996054.0,0.0,0.0,-0.301172256469723,0.301172256469723,0.0,57.4597353693098,24.552091598510746,27.034276962280277,72.49903948116615,-27.500960518833857,0.08196159500370115,-0.03611446610303798,0.04257250976988103,1142900892.0,-1.0
525,2015-02-03,GOOG,26.327716827392575,26.59697723388672,26.091365814208984,26.38954734802246,40773638.0,0.0,0.0,0.0378952026367152,0.0,0.0378952026367152,58.02728938371806,24.582508087158203,27.034276962280277,73.70349135271917,-26.29650864728083,0.10950775686690406,-0.006990021509049562,0.02161992172149496,1183674530.0,1.0
526,2015-02-04,GOOG,26.38954734802246,26.560678482055664,25.99213981628418,26.06643486022949,33273101.0,0.0,0.0,-0.3231124877929723,0.3231124877929723,0.0,51.294497249912475,24.81985664367676,27.034276962280277,56.29365870969155,-43.70634129030845,0.10406620081764117,0.015221222956288593,-0.02176308021334039,1150401429.0,-1.0
527,2015-02-05,GOOG,26.117794036865234,26.352649688720703,26.03302574157715,26.306774139404297,36995292.0,0.0,0.0,0.24033927917480824,0.0,0.24033927917480824,55.70544749351004,24.931549072265625,27.034276962280277,65.40195113544098,-34.59804886455902,0.11778929796885862,0.035734837958802605,-0.022909510042356973,1187396721.0,1.0
528,2015-02-06,GOOG,26.30976676940918,26.786457061767575,26.24843406677246,26.4773063659668,35270570.0,0.0,0.0,0.17053222656250355,0.0,0.17053222656250355,58.762979564854554,24.99138641357422,27.034276962280277,72.7361509080232,-27.263849091976798,0.1408023944601986,0.05674834925908181,-0.007866039194116103,1222667291.0,1.0
529,2015-02-09,GOOG,26.327716827392575,26.52717018127441,26.228988647460938,26.31924057006836,25355423.0,0.0,0.0,-0.15806579589844105,0.15806579589844105,0.0,54.72307987867472,24.99138641357422,27.034276962280277,64.99879092079539,-35.00120907920461,0.1446187752924466,0.07432243446575477,0.01773903166683266,1197311868.0,-1.0
530,2015-02-10,GOOG,26.39253807067871,26.811389923095703,26.27386474609375,26.77349281311035,34997823.0,0.0,0.0,0.4542522430419922,0.0,0.4542522430419922,63.12858256091457,24.99138641357422,27.034276962280277,87.23455109550031,-12.765448904499701,0.18219738621231585,0.095897424815067,0.0528235046077179,1232309691.0,1.0
531,2015-02-11,GOOG,26.69171714782715,26.848787307739254,26.59588050842285,26.72512626647949,27555446.0,0.0,0.0,-0.04836654663086293,0.04836654663086293,0.0,61.72086754885448,24.99138641357422,27.034276962280277,84.86699661924617,-15.133003380753834,0.20570469433895866,0.11785887871984535,0.049563321868408394,1204754245.0,-1.0
532,2015-02-12,GOOG,26.788951873779297,27.166414260864254,26.66045379638672,27.072172164916992,32404724.0,0.0,0.0,0.34704589843750355,0.0,0.34704589843750355,67.68656905179012,24.99138641357422,27.166414260864254,95.66708554721805,-4.33291445278195,0.2494624610447147,0.14417959518481924,0.015733708245657008,1237158969.0,1.0
533,2015-02-13,GOOG,27.093116760253903,27.42021751403809,27.08214569091797,27.375341415405277,38006060.0,0.0,0.0,0.3031692504882848,0.0,0.3031692504882848,72.07351121443213,24.99138641357422,27.42021751403809,98.15235820126637,-1.8476417987336309,0.30508717618310754,0.1763611113844769,0.03884725194350991,1275165029.0,1.0
534,2015-02-17,GOOG,27.266639709472656,27.424705505371094,26.980424880981445,27.067686080932617,32336537.0,0.0,0.0,-0.3076553344726598,0.3076553344726598,0.0,62.187734867616506,24.99138641357422,27.424705505371094,85.32788298739575,-14.672117012604252,0.32064871063636247,0.20521863123485404,0.02569724762486203,1242828492.0,-1.0
535,2015-02-18,GOOG,26.99588394165039,27.1998233795166,26.80191421508789,26.911115646362305,29061570.0,0.0,0.0,-0.1565704345703125,0.1565704345703125,0.0,57.55229490506688,24.99138641357422,27.424705505371094,78.89344390794507,-21.10655609205493,0.3166967304771866,0.22751425108332057,0.03240492191057465,1213766922.0,-1.0
536,2015-02-19,GOOG,26.82834243774414,27.081148147583008,26.826847076416016,27.069181442260746,19782163.0,0.0,0.0,0.15806579589844105,0.0,0.15806579589844105,60.94351106676298,25.70542526245117,27.424705505371094,79.32134306932146,-20.678656930678542,0.3226006074557475,0.24653152235780595,0.028981406036951318,1233549085.0,1.0
537,2015-02-20,GOOG,27.08214569091797,27.113061904907227,26.71664810180664,26.87371826171875,28887092.0,0.0,0.0,-0.19546318054199574,0.19546318054199574,0.0,54.70729098749394,25.85651016235352,27.424705505371094,64.8648845881588,-35.13511541184119,0.30795728746744544,0.25881667537973385,0.014971760732484629,1204661993.0,-1.0
538,2015-02-23,GOOG,26.729114532470703,26.748512268066406,26.39802360534668,26.522682189941406,29157834.0,0.0,0.0,-0.35103607177734375,0.35103607177734375,0.0,45.13634178788,25.99213981628418,27.424705505371094,37.034418574926406,-62.965581425073594,0.2649722385887614,0.2600477880215394,0.007729767860567005,1175504159.0,-1.0
539,2015-02-24,GOOG,26.42744255065918,26.766014099121094,26.34018325805664,26.731109619140625,20101036.0,0.0,0.0,0.20842742919921875,0.0,0.20842742919921875,51.00830467597399,25.99213981628418,27.424705505371094,51.583659198723964,-48.416340801276036,0.24490155659897184,0.2570185417370259,-0.001583028193802627,1195605195.0,1.0
540,2015-02-25,GOOG,26.721635818481445,27.236223220825195,26.69894790649414,27.11904525756836,36519991.0,0.0,0.0,0.3879356384277344,0.0,0.3879356384277344,60.16461104108369,26.03302574157715,27.424705505371094,78.03659607944181,-21.963403920558193,0.25733219506731686,0.2570812724030841,0.014739649390654197,1232125186.0,1.0
541,2015-02-26,GOOG,27.08613586425781,27.730865478515625,27.00086975097656,27.697954177856445,46230579.0,0.0,0.0,0.5789089202880859,0.0,0.5789089202880859,69.86294487866269,26.228988647460938,27.730865478515625,97.80865514543774,-2.1913448545622645,0.3103195072228502,0.2677289193670373,0.023115323333766646,1278355765.0,1.0
542,2015-02-27,GOOG,27.636125564575195,28.158191680908203,27.569307327270508,27.843555450439453,48203982.0,0.0,0.0,0.1456012725830078,0.0,0.1456012725830078,71.8517075419239,26.228988647460938,28.158191680908203,83.69087001140927,-16.30912998859073,0.3599122948188729,0.2861655944574044,0.017103495731040974,1326559747.0,1.0
543,2015-03-02,GOOG,27.949764251708984,28.529172897338867,27.861007690429688,28.488784790039062,42592618.0,0.0,0.0,0.6452293395996094,0.0,0.6452293395996094,78.95338868829967,26.27386474609375,28.529172897338867,98.20919783057109,-1.790802169428914,0.44613676467191965,0.3181598285003075,0.052501669513136395,1369152365.0,1.0
544,2015-03-03,GOOG,28.44440650939941,28.69072914123535,28.248443603515625,28.60346984863281,34095352.0,0.0,0.0,0.11468505859374645,0.0,0.11468505859374645,79.98882262824478,26.34018325805664,28.69072914123535,96.28770094525704,-3.71229905474295,0.5177560347332459,0.35807906974689524,0.06288680946972436,1403247717.0,1.0
545,2015-03-04,GOOG,28.51521110534668,28.77649307250977,28.32274055480957,28.59000587463379,37536775.0,0.0,0.0,-0.013463973999019885,0.013463973999019885,0.0,79.45928212585224,26.34018325805664,28.77649307250977,92.3455056179774,-7.654494382022607,0.5668935955764347,0.3998419749128032,0.056182874817142237,1365710942.0,-1.0
546,2015-03-05,GOOG,28.67227935791016,28.81638526916504,28.59200096130371,28.6877384185791,27792094.0,0.0,0.0,0.0977325439453125,0.0,0.0977325439453125,80.5383844168245,26.34018325805664,28.81638526916504,94.80467062021518,-5.195329379784832,0.6067276869725617,0.44121911732475494,0.06750164376934764,1393503036.0,1.0
547,2015-03-06,GOOG,28.665298461914062,28.75505256652832,28.26041030883789,28.30653381347656,33182854.0,0.0,0.0,-0.3812046051025426,0.3812046051025426,0.0,65.13752112742364,26.34018325805664,28.81638526916504,79.4099409740702,-20.590059025929804,0.6006129731354477,0.47309788848689355,0.06725758770399426,1360320182.0,-1.0
548,2015-03-09,GOOG,28.265396118164062,28.4354305267334,28.0996036529541,28.364625930786133,21242161.0,0.0,0.0,0.058092117309573865,0.0,0.058092117309573865,66.27160405772038,26.34018325805664,28.81638526916504,81.75595785996921,-18.244042140030796,0.5936117796508924,0.4972006667196934,0.06110918457630499,1381562343.0,1.0
549,2015-03-10,GOOG,28.135255813598636,28.165172576904297,27.660558700561523,27.67452049255371,35846146.0,0.0,0.0,-0.6901054382324219,0.6901054382324219,0.0,45.834309854043504,26.34018325805664,28.81638526916504,53.88644498757167,-46.113555012428336,0.5263105614247792,0.5030226456607105,0.020482846269461952,1345716197.0,-1.0
550,2015-03-11,GOOG,27.681001663208008,27.830591201782227,27.4586124420166,27.483543395996094,36415706.0,0.0,0.0,-0.1909770965576172,0.1909770965576172,0.0,41.72554165391107,26.34018325805664,28.81638526916504,46.17394432321222,-53.826055676787774,0.45234920540913137,0.4928879576103947,-0.0077410331638054775,1309300491.0,-1.0
551,2015-03-12,GOOG,27.5997257232666,27.742332458496094,27.447641372680664,27.699451446533203,27792094.0,0.0,0.0,0.21590805053710938,0.0,0.21590805053710938,47.82660455358316,26.34018325805664,28.81638526916504,54.89326728509224,-45.106732714907764,0.40647073158890024,0.4756045124060959,-0.005175488603197609,1337092585.0,1.0
552,2015-03-13,GOOG,27.599225997924805,27.843555450439453,27.136497497558597,27.291072845458984,34071287.0,0.0,0.0,-0.40837860107421875,0.40837860107421875,0.0,38.93117680833269,26.34018325805664,28.81638526916504,38.40113137525101,-61.598868624748995,0.3333167029364894,0.44714695051217457,-0.04204152452999155,1303021298.0,-1.0
553,2015-03-16,GOOG,27.472074508666992,27.766267776489254,27.225252151489254,27.649587631225582,32819860.0,0.0,0.0,0.358514785766598,0.0,0.358514785766598,48.61272621656394,26.69894790649414,28.81638526916504,44.8957660562068,-55.104233943793204,0.30080328216812546,0.41787821684336474,-0.033348479134003406,1335841158.0,1.0
554,2015-03-17,GOOG,27.509971618652344,27.614185333251957,27.32497978210449,27.466590881347656,36110871.0,0.0,0.0,-0.18299674987792613,0.18299674987792613,0.0,44.46134930781681,27.00086975097656,28.81638526916504,25.652280341607515,-74.34771965839249,0.2573038153973144,0.3857633365541547,-0.039293975601553566,1299730287.0,-1.0
555,2015-03-18,GOOG,27.549362182617188,27.91236686706543,27.275115966796875,27.89840507507324,42690887.0,0.0,0.0,0.4318141937255824,0.0,0.4318141937255824,54.9386191230414,27.136497497558597,28.81638526916504,45.354671329385596,-54.64532867061441,0.254737515684365,0.35955817238019677,-0.027514659119823315,1342421174.0,1.0
556,2015-03-19,GOOG,27.892919540405277,27.96322631835937,27.73111343383789,27.82311248779297,23945563.0,0.0,0.0,-0.07529258728026988,0.07529258728026988,0.0,52.92973120578302,27.136497497558597,28.81638526916504,40.872670296169595,-59.1273297038304,0.2438176440956319,0.33641006672328383,-0.01707808270942157,1318475611.0,-1.0
557,2015-03-20,GOOG,28.00561141967773,28.00910186767578,27.87596702575684,27.941286087036133,52337299.0,0.0,0.0,0.11817359924316406,0.0,0.11817359924316406,55.85316769297351,27.136497497558597,28.81638526916504,47.907283038790915,-52.092716961209085,0.24191059428230588,0.31751017223508826,-0.014924922499701232,1370812910.0,1.0
558,2015-03-23,GOOG,27.94477844238281,28.041013717651367,27.71540641784668,27.863998413085938,32876014.0,0.0,0.0,-0.07728767395019531,0.07728767395019531,0.0,53.35259099144099,27.136497497558597,28.81638526916504,43.30651891296561,-56.69348108703439,0.23149425255467548,0.3003069882990057,0.006846655955004222,1337936896.0,-1.0
559,2015-03-24,GOOG,28.05098533630371,28.65083885192871,27.98367118835449,28.431440353393555,51665459.0,0.0,0.0,0.5674419403076172,0.0,0.5674419403076172,66.17970306659078,27.136497497558597,28.81638526916504,77.08508137996805,-22.914918620031955,0.26596121364668335,0.29343783336854123,0.03448961961489849,1389602355.0,1.0
560,2015-03-25,GOOG,28.4468994140625,28.53465843200684,27.860509872436523,27.86275291442871,43045859.0,0.0,0.0,-0.5686874389648438,0.5686874389648438,0.0,50.21293321234165,27.136497497558597,28.75505256652832,44.87060284778603,-55.129397152213976,0.244568966224179,0.2836640599396688,0.005895476602152838,1346556496.0,-1.0
561,2015-03-26,GOOG,27.803165435791016,27.868486404418945,27.457115173339844,27.68249893188477,31452115.0,0.0,0.0,-0.18025398254394176,0.18025398254394176,0.0,46.14153631338494,27.136497497558597,28.65083885192871,36.05537369434646,-63.94462630565354,0.21064231261359723,0.2690597104744545,0.014342641956302415,1315104381.0,-1.0
562,2015-03-27,GOOG,27.574295043945312,27.6879825592041,27.33146095275879,27.34193229675293,37949906.0,0.0,0.0,-0.3405666351318395,0.3405666351318395,0.0,39.21053807738309,27.136497497558597,28.65083885192871,13.565950543547196,-86.43404945645281,0.15449341011485984,0.24614645040253555,-0.01112694115282964,1277154475.0,-1.0
563,2015-03-30,GOOG,27.505483627319336,27.59773063659668,27.33345603942871,27.525928497314453,25750504.0,0.0,0.0,0.18399620056152344,0.0,0.18399620056152344,44.415440251833196,27.136497497558597,28.65083885192871,25.716196591477136,-74.28380340852286,0.12341925566503065,0.22160101145503458,0.002160356056677193,1302904979.0,1.0
564,2015-03-31,GOOG,27.424705505371094,27.65956115722656,27.261154174804688,27.32497978210449,31760961.0,0.0,0.0,-0.2009487152099645,0.2009487152099645,0.0,40.089871476504655,27.136497497558597,28.65083885192871,12.446485992208148,-87.55351400779186,0.08163682397773186,0.19360817395957403,-0.020554052872402195,1271144018.0,-1.0
565,2015-04-01,GOOG,27.35489654541016,27.48154830932617,26.901142120361328,27.05372428894043,39261497.0,0.0,0.0,-0.27125549316405895,0.27125549316405895,0.0,34.80967129888134,26.901142120361328,28.65083885192871,8.720492290250668,-91.27950770974932,0.02633235156031688,0.1601530094797226,-0.027652844346228278,1231882521.0,-1.0
566,2015-04-02,GOOG,26.96845817565918,26.96845817565918,26.61926651000977,26.70318603515625,34327989.0,0.0,0.0,-0.3505382537841797,0.3505382537841797,0.0,29.095576139465322,26.61926651000977,28.65083885192871,4.130767259176889,-95.86923274082311,-0.045260612619138385,0.1190702850599504,-0.04431077538890815,1197554532.0,-1.0
567,2015-04-06,GOOG,26.53813934326172,26.846792221069336,26.40600204467773,26.764766693115234,26488525.0,0.0,0.0,0.061580657958984375,0.0,0.061580657958984375,31.378872113887766,26.40600204467773,28.65083885192871,15.98176968938983,-84.01823031061016,-0.09592375870466796,0.07607147630702672,-0.0394498917088103,1224043057.0,1.0
568,2015-04-07,GOOG,26.830337524414062,27.060205459594727,26.726621627807617,26.77748107910156,26057345.0,0.0,0.0,0.012714385986324572,0.0,0.012714385986324572,31.901300385419262,26.40600204467773,28.65083885192871,16.548153220934584,-83.45184677906542,-0.1335097055168717,0.03415523994224703,-0.05817360125740445,1250100402.0,1.0
569,2015-04-08,GOOG,26.84529685974121,27.1180477142334,26.84529685974121,27.0063533782959,23570536.0,0.0,0.0,0.2288722991943395,0.0,0.2288722991943395,41.19943936607973,26.40600204467773,28.65083885192871,26.743651550927478,-73.25634844907252,-0.14317828720874815,-0.0013114654879520188,-0.030736357558169614,1273670938.0,1.0
570,2015-04-09,GOOG,26.97743225097656,27.02330780029297,26.70119285583496,26.964967727661133,31157308.0,0.0,0.0,-0.041385650634765625,0.041385650634765625,0.0,40.05826039197454,26.40600204467773,28.65083885192871,24.900058711524316,-75.09994128847568,-0.1524231448560549,-0.031533801361572605,-0.02592003005180943,1242513630.0,-1.0
571,2015-04-10,GOOG,27.040260314941406,27.040260314941406,26.791942596435547,26.926572799682617,28189181.0,0.0,0.0,-0.038394927978515625,0.038394927978515625,0.0,38.90470988883925,26.40600204467773,28.65083885192871,23.189692601413448,-76.81030739858656,-0.16099209430614891,-0.057425459950487874,-0.015191300035500399,1214324449.0,-1.0
572,2015-04-13,GOOG,26.846792221069336,27.12851905822754,26.791942596435547,26.88468742370605,32906096.0,0.0,0.0,-0.04188537597656605,0.04188537597656605,0.0,37.54383068367086,26.40600204467773,28.65083885192871,21.32383866311052,-78.67616133688948,-0.16921227450242782,-0.07978282286087587,-0.023295892586183364,1181418353.0,-1.0
573,2015-04-14,GOOG,26.73908805847168,26.804906845092773,26.332305908203125,26.446889877319336,52082601.0,0.0,0.0,-0.4377975463867152,0.4377975463867152,0.0,26.40458911305261,26.332305908203125,28.53465843200684,5.202798728984192,-94.79720127101581,-0.2086482624078272,-0.10555591077026616,-0.03213506146343892,1129335752.0,-1.0
574,2015-04-15,GOOG,26.362621307373047,26.66329574584961,26.08937263488769,26.55359649658203,46376979.0,0.0,0.0,0.10670661926269531,0.0,0.10670661926269531,32.07256747396997,26.08937263488769,27.868486404418945,26.092983464269935,-73.90701653573007,-0.22865543700896396,-0.1301758160180057,-0.018486467408956764,1175712731.0,1.0
575,2015-04-16,GOOG,26.422456741333008,26.706178665161133,26.407997131347656,26.61692237854004,25997180.0,0.0,0.0,0.06332588195800781,0.0,0.06332588195800781,35.47539991089822,26.08937263488769,27.6879825592041,33.00052974949068,-66.99947025050932,-0.236673176531621,-0.15147528812072877,-0.0032304630804219636,1201709911.0,1.0
576,2015-04-17,GOOG,26.360626220703125,26.419464111328125,25.97917366027832,26.13075828552246,43037837.0,0.0,0.0,-0.4861640930175781,0.4861640930175781,0.0,24.571591877911914,25.97917366027832,27.65956115722656,9.020813682524675,-90.97918631747532,-0.27904007187947144,-0.17698824487247733,-0.023688172397029028,1158672074.0,-1.0
577,2015-04-20,GOOG,26.208045959472656,26.731109619140625,26.153196334838867,26.695707321166992,33585958.0,0.0,0.0,0.5649490356445312,0.0,0.5649490356445312,46.58504103115451,25.97917366027832,27.65956115722656,42.64097788099309,-57.35902211900691,-0.26398640502788595,-0.19438787690355908,-0.003053825626577966,1192258032.0,1.0
578,2015-04-21,GOOG,26.80191421508789,26.895658493041992,26.610689163208008,26.62540054321289,36895018.0,0.0,0.0,-0.07030677795410156,0.07030677795410156,0.0,44.7113136096858,25.97917366027832,27.48154830932617,43.01369723884293,-56.98630276115707,-0.25479234741654366,-0.20646877100615602,-0.014106044964558806,1155363014.0,-1.0
579,2015-04-22,GOOG,26.646841049194336,26.97992706298828,26.51470375061035,26.894411087036133,31871263.0,0.0,0.0,0.2690105438232422,0.0,0.2690105438232422,53.04866147162653,25.97917366027832,27.12851905822754,79.63119079702882,-20.368809202971182,-0.22322587887000367,-0.20982019257892556,-0.002616603933577877,1187234277.0,1.0
580,2015-04-23,GOOG,26.97593879699707,27.47257423400879,26.937543869018555,27.275115966796875,83697161.0,0.0,0.0,0.3807048797607422,0.0,0.3807048797607422,62.32560623809119,25.97917366027832,27.47257423400879,86.77794352799334,-13.222056472006663,-0.1655808104965537,-0.2009723161624512,0.0129442082996305,1270931438.0,1.0
581,2015-04-24,GOOG,28.227500915527344,28.47881126403809,27.786212921142575,28.17564392089844,98650102.0,0.0,0.0,0.900527954101566,0.0,0.900527954101566,75.52465191508739,25.97917366027832,28.47881126403809,87.87154815227429,-12.128451847725712,-0.04669334679419279,-0.17011652228879953,0.04801828181398404,1369581540.0,1.0
582,2015-04-27,GOOG,28.16950035095215,28.29750061035156,27.65999984741211,27.76849937438965,47960000.0,0.0,1.0027455,-0.4071445465087926,0.4071445465087926,0.0,63.854259436815425,25.97917366027832,28.47881126403809,71.58340518721424,-28.416594812785767,0.014505452644780092,-0.1331921273020836,0.049972208573519916,1321621540.0,-1.0
583,2015-04-28,GOOG,27.73200035095215,27.801000595092773,27.518299102783203,27.68400001525879,29820000.0,0.0,0.0,-0.08449935913085938,0.08449935913085938,0.0,61.575707967654935,25.97917366027832,28.47881126403809,68.20294079494545,-31.79705920505454,0.055547236062086114,-0.09544425462924964,0.042570637044298865,1291801540.0,-1.0
584,2015-04-29,GOOG,27.523500442504883,27.68400001525879,27.34524917602539,27.45400047302246,33976000.0,0.0,0.0,-0.22999954223632812,0.22999954223632812,0.0,55.37033891164154,25.97917366027832,28.47881126403809,59.00162529663563,-40.99837470336437,0.06872192071420358,-0.062611019560559,0.03144909402288065,1257825540.0,-1.0
585,2015-04-30,GOOG,27.39349937438965,27.429500579833984,26.752500534057617,26.867000579833984,41644000.0,0.0,0.0,-0.5869998931884766,0.5869998931884766,0.0,42.69872198164471,25.97917366027832,28.47881126403809,35.51822545077177,-64.48177454922822,0.03143460899682182,-0.04380189384908283,0.02817531302638976,1216181540.0,-1.0
586,2015-05-01,GOOG,26.921499252319336,26.976999282836918,26.604999542236328,26.895000457763672,35364000.0,0.0,0.0,0.0279998779296875,0.0,0.0279998779296875,43.4114915078428,25.97917366027832,28.47881126403809,36.63838294430492,-63.36161705569508,0.004096282568795573,-0.03422225856550715,0.007465362659211605,1251545540.0,1.0
587,2015-05-04,GOOG,26.92650032043457,27.203500747680664,26.75300025939941,27.03899955749512,26160000.0,0.0,0.0,0.14399909973144887,0.0,0.14399909973144887,47.30136708457732,25.97917366027832,28.47881126403809,42.399182010331785,-57.600817989668215,-0.005882207760265601,-0.028554248404458842,0.015534001586603674,1277705540.0,1.0
588,2015-05-05,GOOG,26.910499572753903,26.98699951171875,26.519550323486328,26.540000915527344,27662000.0,0.0,0.0,-0.498998641967777,0.498998641967777,0.0,37.10349101530228,25.97917366027832,28.47881126403809,22.43634254843457,-77.56365745156543,-0.05343923905527603,-0.033531246534622285,-0.013177837222828281,1250043540.0,-1.0
589,2015-05-06,GOOG,26.562000274658203,26.61899948120117,26.05425071716309,26.211000442504883,31340000.0,0.0,0.0,-0.32900047302246094,0.32900047302246094,0.0,31.875466121787213,25.97917366027832,28.47881126403809,9.274415694413698,-90.72558430558631,-0.1163350792106499,-0.05009201306982782,-0.03901415215199755,1218703540.0,-1.0
590,2015-05-07,GOOG,26.199499130249023,26.67300033569336,26.087499618530277,26.53499984741211,30926000.0,0.0,0.0,0.32399940490722656,0.0,0.32399940490722656,41.27752229801949,26.05425071716309,28.47881126403809,19.828299642533334,-80.17170035746666,-0.138440584590942,-0.06776172737405066,-0.058229159840759936,1249629540.0,1.0
591,2015-05-08,GOOG,26.832500457763672,27.0575008392334,26.25,26.910999298095703,30552000.0,0.0,0.0,0.37599945068359375,0.0,0.37599945068359375,50.43694800042546,26.05425071716309,28.47881126403809,35.33624194441632,-64.66375805558367,-0.12418778408403597,-0.07904693871604773,-0.030880317468102048,1280181540.0,1.0
592,2015-05-11,GOOG,26.918500900268555,27.099000930786133,26.770000457763672,26.78499984741211,18106000.0,0.0,0.0,-0.12599945068359375,0.12599945068359375,0.0,47.568090737816256,26.05425071716309,28.47881126403809,30.139446556237896,-69.86055344376211,-0.12165705286866668,-0.08756896154657152,-0.03247363702323258,1262075540.0,-1.0
593,2015-05-12,GOOG,26.57999992370605,26.660449981689453,26.26300048828125,26.45199966430664,32684000.0,0.0,0.0,-0.33300018310546875,0.33300018310546875,0.0,40.536823794546834,26.05425071716309,28.47881126403809,16.404991315073865,-83.59500868492613,-0.14485199825685058,-0.09902556888862735,-0.03649744268418842,1229391540.0,-1.0
594,2015-05-13,GOOG,26.527999877929688,26.716100692749023,26.432750701904297,26.481000900268555,25046000.0,0.0,0.0,0.029001235961914062,0.0,0.029001235961914062,41.40715073055046,26.05425071716309,28.47881126403809,17.601135333803093,-82.3988646661969,-0.15906045233602484,-0.11103254557810686,-0.014367055169349885,1254437540.0,1.0
595,2015-05-14,GOOG,26.688499450683597,26.950000762939453,26.620500564575195,26.920000076293945,28078000.0,0.0,0.0,0.4389991760253906,0.0,0.4389991760253906,53.33628086007522,26.05425071716309,28.29750061035156,38.59353172197471,-61.40646827802529,-0.1333599000104364,-0.11549801646457278,0.0009295266073534592,1282515540.0,1.0
596,2015-05-15,GOOG,26.958999633789062,26.963699340820312,26.518999099731445,26.6924991607666,39426000.0,0.0,0.0,-0.22750091552734375,0.22750091552734375,0.0,47.54783166956513,26.05425071716309,27.801000595092773,36.539200698842414,-63.460799301157586,-0.12985258988275916,-0.11836893114821008,-0.012814837915571808,1243089540.0,-1.0
597,2015-05-18,GOOG,26.600500106811523,26.74099922180176,26.4424991607666,26.614999771118164,40068000.0,0.0,0.0,-0.0774993896484375,0.0774993896484375,0.0,45.60251060404143,26.05425071716309,27.68400001525879,34.4070744261273,-65.5929255738727,-0.1318071832318033,-0.12105658156492873,0.002825879917243812,1203021540.0,-1.0
598,2015-05-19,GOOG,26.698999404907227,27.03300094604492,26.652000427246094,26.868000030517575,39338000.0,0.0,0.0,0.2530002593994105,0.0,0.2530002593994105,52.86629208061567,26.05425071716309,27.429500579833984,59.17101578720316,-40.82898421279683,-0.111654126749972,-0.11917609060193739,0.025065795922359024,1242359540.0,1.0
599,2015-05-20,GOOG,26.92449951171875,27.145999908447266,26.64859962463379,26.963499069213867,28616000.0,0.0,0.0,0.09549903869629262,0.0,0.09549903869629262,55.45683576072977,26.05425071716309,27.203500747680664,79.11666981999468,-20.88333018000531,-0.08697412639954294,-0.1127356977614585,0.016148453901104753,1270975540.0,1.0
600,2015-05-21,GOOG,26.897499084472656,27.191999435424805,26.798999786376957,27.1254997253418,29254000.0,0.0,0.0,0.16200065612793324,0.0,0.16200065612793324,59.783284769554804,26.05425071716309,27.203500747680664,93.21287620033952,-6.78712379966048,-0.053723656389433216,-0.10093328948705346,0.007970734377793054,1300229540.0,1.0
601,2015-05-22,GOOG,27.00749969482422,27.20949935913086,26.975500106811523,27.00550079345703,23524000.0,0.0,0.0,-0.11999893188476918,0.11999893188476918,0.0,55.20076707199369,26.05425071716309,27.20949935913086,82.34158792635746,-17.658412073642538,-0.036633047313756606,-0.0880732410523941,0.008232254892703628,1276705540.0,-1.0
602,2015-05-26,GOOG,26.9060001373291,26.950000762939453,26.49399948120117,26.61599922180176,48130000.0,0.0,0.0,-0.3895015716552699,0.3895015716552699,0.0,42.88834695768551,26.05425071716309,27.20949935913086,48.6257662836832,-51.374233716316795,-0.053896848798885344,-0.08123796260169236,0.006199892619702885,1228575540.0,-1.0
603,2015-05-27,GOOG,26.63999938964844,27.02750015258789,26.58550071716309,26.989500045776367,30500000.0,0.0,0.0,0.3735008239746058,0.0,0.3735008239746058,54.19306642574963,26.087499618530277,27.20949935913086,80.39221352789875,-19.607786472101257,-0.03701347256505372,-0.07239306459436463,0.019202414116554545,1259075540.0,1.0
604,2015-05-28,GOOG,26.90049934387207,27.030500411987305,26.8125,26.98900032043457,20596000.0,0.0,0.0,-0.000499725341796875,0.000499725341796875,0.0,54.17651124945078,26.25,27.20949935913086,77.01936571421756,-22.980634285782443,-0.02340381431720573,-0.06259521453893285,0.0025631591361467976,1238479540.0,-1.0
605,2015-05-29,GOOG,26.86849975585937,26.93149948120117,26.57250022888184,26.605499267578125,51948000.0,0.0,0.0,-0.3835010528564453,0.3835010528564453,0.0,42.64175861372868,26.26300048828125,27.20949935913086,36.18586242891516,-63.81413757108484,-0.043066943105110056,-0.058689560252168295,-0.003259338612862095,1186531540.0,-1.0
606,2015-06-01,GOOG,26.839500427246094,26.839500427246094,26.488000869750977,26.699499130249023,38086000.0,0.0,0.0,0.09399986267089844,0.0,0.09399986267089844,45.89943271360853,26.26300048828125,27.20949935913086,46.11718570524627,-53.88281429475372,-0.05048317241983469,-0.05704828268570158,0.0031748773194639757,1224617540.0,1.0
607,2015-06-02,GOOG,26.646499633789062,27.149999618530277,26.566499710083008,26.958999633789062,38780000.0,0.0,0.0,0.25950050354003906,0.0,0.25950050354003906,54.18752301208334,26.432750701904297,27.20949935913086,67.75022099990179,-32.24977900009822,-0.035017406815132546,-0.05264210751158777,0.0033869139187183706,1263397540.0,1.0
608,2015-06-03,GOOG,26.995500564575195,27.174999237060547,26.855499267578125,27.015499114990234,34340000.0,0.0,0.0,0.056499481201171875,0.0,0.056499481201171875,55.88533577822498,26.4424991607666,27.20949935913086,74.70662399379304,-25.293376006206962,-0.017994214102344586,-0.045712528829739134,0.001928534781145741,1297737540.0,1.0
609,2015-06-04,GOOG,26.88800048828125,27.02949905395508,26.715999603271484,26.834999084472656,26966000.0,0.0,0.0,-0.18050003051757812,0.18050003051757812,0.0,49.168377854222506,26.4424991607666,27.20949935913086,51.173379686617984,-48.82662031338202,-0.018850755418775123,-0.040340174147546336,-0.010709503744100513,1270771540.0,-1.0
610,2015-06-05,GOOG,26.8174991607666,26.86000061035156,26.625999450683597,26.66650009155273,27764000.0,0.0,0.0,-0.16849899291992543,0.16849899291992543,0.0,43.532560477010605,26.4424991607666,27.20949935913086,29.20480741254626,-70.79519258745376,-0.03274852647889048,-0.03882184461381517,-0.012553024085612763,1243007540.0,-1.0
611,2015-06-08,GOOG,26.66550064086914,26.70599937438965,26.312000274658203,26.34149932861328,30412000.0,0.0,0.0,-0.3250007629394496,0.3250007629394496,0.0,34.6846077035367,26.312000274658203,27.20949935913086,3.286806021914874,-96.71319397808512,-0.06918987775502217,-0.04489545124205657,-0.010313341644661245,1212595540.0,-1.0
612,2015-06-09,GOOG,26.37800025939941,26.459999084472656,26.15049934387207,26.33449935913086,29106000.0,0.0,0.0,-0.006999969482421875,0.006999969482421875,0.0,34.510291849168325,26.15049934387207,27.20949935913086,17.37488315463572,-82.62511684536427,-0.09751070748557567,-0.0554185024907604,-0.024268722485951022,1183489540.0,-1.0
613,2015-06-10,GOOG,26.468000411987305,26.917999267578125,26.467500686645508,26.83449935913086,36300000.0,0.0,0.0,0.5,0.0,0.5,53.691706809576175,26.15049934387207,27.20949935913086,64.58923563770102,-35.41076436229898,-0.07870211872761956,-0.06007522573813224,-0.005724589998494012,1219789540.0,1.0
614,2015-06-11,GOOG,26.92124938964844,26.948999404907227,26.650999069213867,26.730499267578125,24350000.0,0.0,0.0,-0.10400009155273438,0.10400009155273438,0.0,50.16537425626337,26.15049934387207,27.20949935913086,54.768641676017296,-45.231358323982704,-0.07136545827214746,-0.06233327224493529,0.004698276801455403,1195439540.0,-1.0
615,2015-06-12,GOOG,26.57999992370605,26.6560001373291,26.507999420166016,26.616500854492188,19116000.0,0.0,0.0,-0.1139984130859375,0.1139984130859375,0.0,46.31788212405755,26.15049934387207,27.174999237060547,45.48575492475793,-54.51424507524207,-0.07389797140053389,-0.064646212076055,-0.003108607968709154,1176323540.0,-1.0
616,2015-06-15,GOOG,26.399999618530277,26.415000915527344,26.200000762939453,26.36000061035156,32654000.0,0.0,0.0,-0.25650024414062855,0.25650024414062855,0.0,38.62662499208745,26.15049934387207,27.174999237060547,20.44912526320262,-79.55087473679738,-0.09550154992088267,-0.07081727964502053,-0.022218889112144535,1143669540.0,-1.0
617,2015-06-16,GOOG,26.420000076293945,26.48200035095215,26.277999877929688,26.40749931335449,21436000.0,0.0,0.0,0.04749870300292969,0.0,0.04749870300292969,40.729573154397656,26.15049934387207,27.174999237060547,25.085407152418142,-74.91459284758186,-0.10755002345173637,-0.07816382840636371,-0.02250559203247815,1165105540.0,1.0
618,2015-06-17,GOOG,26.4685001373291,26.548999786376957,26.2549991607666,26.46299934387207,25884000.0,0.0,0.0,0.05550003051758168,0.0,0.05550003051758168,43.346748261816394,26.15049934387207,27.174999237060547,30.502687416338226,-69.49731258366178,-0.11133671653631083,-0.08479840603235314,-0.013862483819342963,1190989540.0,1.0
619,2015-06-18,GOOG,26.549999237060547,26.90749931335449,26.539499282836918,26.83650016784668,36662000.0,0.0,0.0,0.3735008239746094,0.0,0.3735008239746094,57.81209713951247,26.15049934387207,27.174999237060547,66.95957984335351,-33.04042015664649,-0.0832397668520457,-0.08448667819629166,0.0063750426831528095,1227651540.0,1.0
620,2015-06-19,GOOG,26.86050033569336,26.912500381469727,26.65049934387207,26.83449935913086,37870000.0,0.0,0.0,-0.0020008087158203125,0.0020008087158203125,0.0,57.72100102834397,26.15049934387207,27.174999237060547,66.76428370627015,-33.23571629372986,-0.060437494525725555,-0.07967684146217845,0.01871571638225089,1189781540.0,-1.0
621,2015-06-22,GOOG,26.97949981689453,27.187000274658203,26.87649917602539,26.909500122070312,25006000.0,0.0,0.0,0.07500076293945312,0.0,0.07500076293945312,60.418616835554786,26.15049934387207,27.187000274658203,73.22721626719418,-26.772783732805816,-0.035900753129297414,-0.07092162379560224,0.021834505190245324,1214787540.0,1.0
622,2015-06-23,GOOG,26.98200035095215,27.074949264526367,26.762500762939453,27.02400016784668,23950000.0,0.0,0.0,0.11450004577636719,0.0,0.11450004577636719,64.41783963937229,26.15049934387207,27.187000274658203,84.27400285227952,-15.725997147720477,-0.007133778262424784,-0.058164054688966745,0.007061835072072586,1238737540.0,1.0
623,2015-06-24,GOOG,27.0,27.0,26.78300094604492,26.892000198364254,25732000.0,0.0,0.0,-0.13199996948242543,0.13199996948242543,0.0,56.78580244667746,26.15049934387207,27.187000274658203,71.53885080737878,-28.46114919262122,0.004955834432536221,-0.04554007686466615,0.006041822457914847,1213005540.0,-1.0
624,2015-06-25,GOOG,26.943500518798828,27.045000076293945,26.761499404907227,26.761499404907227,26714000.0,0.0,0.0,-0.1305007934570277,0.1305007934570277,0.0,50.0248573491749,26.15049934387207,27.187000274658203,58.94833693701983,-41.05166306298017,0.003960956758998435,-0.035639870139933236,0.00544769394022615,1186291540.0,-1.0
625,2015-06-26,GOOG,26.863000869750977,26.88800048828125,26.5674991607666,26.58449935913086,42182000.0,0.0,0.0,-0.1770000457763672,0.1770000457763672,0.0,42.16784886881052,26.15049934387207,27.187000274658203,41.8716474214473,-58.1283525785527,-0.010983306685439231,-0.030708557449034436,0.008516644293670383,1144109540.0,-1.0
626,2015-06-29,GOOG,26.2504997253418,26.430500030517575,26.027000427246094,26.076000213623047,38756000.0,0.0,0.0,-0.5084991455078125,0.5084991455078125,0.0,27.73036079037847,26.027000427246094,27.187000274658203,4.224120070900762,-95.77587992909923,-0.06313064370737465,-0.037192974700702486,-0.012553218152079992,1105353540.0,-1.0
627,2015-06-30,GOOG,26.301000595092773,26.3125,26.024999618530277,26.02549934387207,44344000.0,0.0,0.0,-0.05050086975097656,0.05050086975097656,0.0,26.683452242156946,26.024999618530277,27.187000274658203,0.04300559893473131,-99.95699440106527,-0.10729594131201736,-0.05121356802296547,-0.016532517509256217,1061009540.0,-1.0
628,2015-07-01,GOOG,26.236499786376957,26.284500122070312,25.911500930786133,26.09199905395508,39220000.0,0.0,0.0,0.06649971008301137,0.0,0.06649971008301137,30.6608631276996,25.911500930786133,27.187000274658203,14.15117334525673,-85.84882665474328,-0.13537081650775207,-0.0680450177199228,-0.027742109039374574,1100229540.0,1.0
629,2015-07-02,GOOG,26.054000854492188,26.232500076293945,26.054000854492188,26.170000076293945,24718000.0,0.0,0.0,0.07800102233886363,0.0,0.07800102233886363,35.40366292461272,25.911500930786133,27.187000274658203,20.266505565034564,-79.73349443496544,-0.14960181020378727,-0.0843563762166957,-0.02476287237349961,1124947540.0,1.0
630,2015-07-06,GOOG,25.975000381469727,26.262500762939453,25.950000762939453,26.14299964904785,25610000.0,0.0,0.0,-0.02700042724609375,0.02700042724609375,0.0,34.46216964266753,25.911500930786133,27.187000274658203,18.14965404521114,-81.85034595478886,-0.16120046544163813,-0.0997251940616842,-0.028484381707031492,1099337540.0,-1.0
631,2015-07-07,GOOG,26.1564998626709,26.30900001525879,25.75900077819824,26.250999450683597,31944000.0,0.0,0.0,0.10799980163574574,0.0,0.10799980163574574,41.62663792143975,25.75900077819824,27.187000274658203,34.45370069842685,-65.54629930157316,-0.15983531980871035,-0.11174721921108945,-0.028604230031155864,1131281540.0,1.0
632,2015-07-08,GOOG,26.052499771118164,26.136699676513672,25.805500030517575,25.84149932861328,25934000.0,0.0,0.0,-0.40950012207031605,0.40950012207031605,0.0,28.15906954579799,25.75900077819824,27.187000274658203,5.777211449973054,-94.22278855002695,-0.18961095254283578,-0.1273199658774387,-0.039063694109851665,1105347540.0,-1.0
633,2015-07-09,GOOG,26.1560001373291,26.188499450683597,26.01749992370605,26.03400039672852,36846000.0,0.0,0.0,0.19250106811523793,0.0,0.19250106811523793,38.88411147206214,25.75900077819824,27.187000274658203,19.25768315829308,-80.74231684170692,-0.19542242058980364,-0.1409404568199117,-0.027184538398670854,1142193540.0,1.0
634,2015-07-10,GOOG,26.31450080871582,26.62800025939941,26.27750015258789,26.506500244140625,39134000.0,0.0,0.0,0.4724998474121058,0.0,0.4724998474121058,57.04559124732606,25.75900077819824,27.187000274658203,52.34591943452715,-47.65408056547285,-0.1600562334189135,-0.1447636121397121,-0.0029340072926159477,1181327540.0,1.0
635,2015-07-13,GOOG,26.643999099731445,27.355499267578125,26.6200008392334,27.32749938964844,44130000.0,0.0,0.0,0.820999145507816,0.0,0.820999145507816,73.0825024101715,25.75900077819824,27.355499267578125,98.24616946925144,-1.7538305307485564,-0.06503087022834819,-0.12881706375743932,0.047994292290715945,1225457540.0,1.0
636,2015-07-14,GOOG,27.33799934387207,28.292449951171875,27.33550071716309,28.05500030517578,64882000.0,0.0,0.0,0.7275009155273402,0.0,0.7275009155273402,80.51893219475201,25.75900077819824,28.292449951171875,90.62741623044337,-9.372583769556632,0.0681945542533775,-0.08941474015527594,0.07798124963860009,1290339540.0,1.0
637,2015-07-15,GOOG,28.006500244140625,28.32514953613281,27.839500427246094,28.01099967956543,35692000.0,0.0,0.0,-0.04400062561035156,0.04400062561035156,0.0,78.99590522847005,25.75900077819824,28.32514953613281,87.75792496066242,-12.242075039337577,0.16828628074446073,-0.037874535975328597,0.07354747413726659,1254647540.0,-1.0
638,2015-07-16,GOOG,28.256000518798828,29.03400039672852,28.25,28.99250030517578,95366000.0,0.0,0.0,0.9815006256103516,0.0,0.9815006256103516,85.8733638021075,25.75900077819824,29.03400039672852,98.7328214843774,-1.2671785156226032,0.3230842784058865,0.034317226900914446,0.10785251129741469,1350013540.0,1.0
639,2015-07-17,GOOG,32.45000076293945,33.7234001159668,32.25,33.64649963378906,223298000.0,0.0,0.0,4.653999328613281,0.0,4.653999328613281,94.93934180935744,25.75900077819824,33.7234001159668,99.03444718281442,-0.9655528171855849,0.8119420944869127,0.18984220041811414,0.2870175605504586,1573311540.0,1.0
640,2015-07-20,GOOG,32.96200180053711,33.444000244140625,32.6505012512207,33.1510009765625,117218000.0,0.0,0.0,-0.4954986572265625,0.4954986572265625,0.0,88.00141627437115,25.75900077819824,33.7234001159668,92.81302813772935,-7.186971862270658,1.1461704951763458,0.38110785936976055,0.2628471932598826,1456093540.0,-1.0
641,2015-07-21,GOOG,32.760501861572266,33.650001525878906,32.71500015258789,33.1150016784668,67544000.0,0.0,0.0,-0.035999298095703125,0.035999298095703125,0.0,87.46559478229081,25.75900077819824,33.7234001159668,92.3610254622107,-7.638974537789303,1.3920968423621254,0.5833056559682336,0.28146595742607894,1388549540.0,-1.0
642,2015-07-22,GOOG,33.04449844360352,33.93199920654297,32.95000076293945,33.10499954223633,78586000.0,0.0,0.0,-0.01000213623046875,0.01000213623046875,0.0,87.29519562236435,25.75900077819824,33.93199920654297,89.8813186915768,-10.118681308423207,1.5681119372116648,0.7802669122169199,0.2716063239515185,1309963540.0,-1.0
643,2015-07-23,GOOG,33.063499450683594,33.18149948120117,32.04999923706055,32.2140007019043,60582000.0,0.0,0.0,-0.8909988403320312,0.8909988403320312,0.0,72.73112486652676,25.75900077819824,33.93199920654297,78.97958112067548,-21.020418879324517,1.617068449477987,0.9476272196691334,0.2153245583232113,1249381540.0,-1.0
644,2015-07-24,GOOG,32.349998474121094,32.40850067138672,31.125999450683597,31.17799949645996,72514000.0,0.0,0.0,-1.036001205444336,1.036001205444336,0.0,59.42897826004519,25.75900077819824,33.93199920654297,66.30367992569438,-33.69632007430562,1.5543525899990271,1.0689722937351123,0.14090202882851677,1176867540.0,-1.0
645,2015-07-27,GOOG,31.049999237060547,31.71500015258789,31.024999618530277,31.363000869750977,53508000.0,0.0,0.0,0.18500137329101562,0.0,0.18500137329101562,60.90235765916309,25.805500030517575,33.93199920654297,68.387391899688,-31.612608100312006,1.5022607573364546,1.1556299864553807,0.11791126460850232,1230375540.0,1.0
646,2015-07-28,GOOG,31.64150047302246,31.64150047302246,31.16550064086914,31.399999618530277,34546000.0,0.0,0.0,0.03699874877930043,0.0,0.03699874877930043,61.227283958686904,26.01749992370605,33.93199920654297,68.00808873021835,-31.991911269781653,1.4472797543571652,1.2139599400357377,0.12098818241882281,1264921540.0,1.0
647,2015-07-29,GOOG,31.440000534057617,31.667999267578125,31.13249969482422,31.59650039672852,31502000.0,0.0,0.0,0.1965007781982422,0.0,0.1965007781982422,63.10622245275487,26.27750015258789,33.93199920654297,69.48854793302642,-30.511452066973575,1.4033855291515138,1.251845057858893,0.08981633402234945,1296423540.0,1.0
648,2015-07-30,GOOG,31.5,31.76099967956543,31.102500915527344,31.629499435424805,29484000.0,0.0,0.0,0.03299903869628551,0.0,0.03299903869628551,63.44943672104451,26.6200008392334,33.93199920654297,68.51066349505543,-31.489336504944575,1.35563487113253,1.2726030205136205,-0.05994680636373573,1325907540.0,1.0
649,2015-07-31,GOOG,31.569000244140625,31.64550018310547,31.274999618530277,31.280500411987305,34122000.0,0.0,0.0,-0.3489990234375,0.3489990234375,0.0,56.98081578462836,27.33550071716309,33.93199920654297,59.804450818498935,-40.195549181501065,1.2749341785513302,1.2730692521211626,-0.056423652664292834,1291785540.0,-1.0
650,2015-08-03,GOOG,31.267000198364254,31.65279960632324,31.267000198364254,31.56049919128418,26090000.0,0.0,0.0,0.279998779296875,0.0,0.279998779296875,60.69068999862866,27.839500427246094,33.93199920654297,61.075084277120204,-38.9249157228798,1.2195140607344541,1.262358213843821,-0.046942545927558865,1317875540.0,1.0
651,2015-08-04,GOOG,31.42099952697754,31.74049949645996,31.357999801635746,31.462499618530277,29818000.0,0.0,0.0,-0.0979995727539027,0.0979995727539027,0.0,58.64816494026361,28.25,33.93199920654297,56.538191959460335,-43.461808040539665,1.154378514638477,1.2407622740027522,-0.04961486018480388,1288057540.0,-1.0
652,2015-08-05,GOOG,31.71649932861328,32.393001556396484,31.65800094604492,32.18899917602539,46686000.0,0.0,0.0,0.7264995574951136,0.0,0.7264995574951136,67.89142923713979,31.024999618530277,33.93199920654297,40.04127012246524,-59.95872987753476,1.1481454615755595,1.2222389115173138,-0.0007761074481329455,1334743540.0,1.0
653,2015-08-06,GOOG,32.25,32.268951416015625,31.612499237060547,32.13399887084961,31452000.0,0.0,0.0,-0.05500030517578125,0.05500030517578125,0.0,66.59118487702449,31.024999618530277,33.93199920654297,38.14927449224291,-61.85072550775709,1.125790247947279,1.2029491788033069,0.030662627167538314,1303291540.0,-1.0
654,2015-08-07,GOOG,32.01150131225586,32.13399887084961,31.48550033569336,31.76499938964844,28078000.0,0.0,0.0,-0.3689994812011683,0.3689994812011683,0.0,57.99321747098982,31.024999618530277,33.93199920654297,25.455792087815503,-74.5442079121845,1.066010104889731,1.1755613640205917,0.012817603824549328,1275213540.0,-1.0
655,2015-08-10,GOOG,31.974000930786133,32.172000885009766,31.562450408935547,31.686500549316406,36184000.0,0.0,0.0,-0.0784988403320348,0.0784988403320348,0.0,56.21169571344993,31.024999618530277,33.93199920654297,22.755453200402766,-77.24454679959723,1.0007635314148544,1.1406017974994442,0.009124233575374063,1239029540.0,-1.0
656,2015-08-11,GOOG,33.459999084472656,33.744998931884766,32.7135009765625,33.03900146484375,100584000.0,0.0,0.0,1.3525009155273438,0.0,1.3525009155273438,72.81431099709877,31.024999618530277,33.744998931884766,74.04420421818668,-25.95579578181332,1.0461315194590597,1.1217077418913675,0.04565382399959028,1339613540.0,1.0
657,2015-08-12,GOOG,33.15399932861328,33.25,32.614498138427734,32.97800064086914,58734000.0,0.0,0.0,-0.061000823974609375,0.061000823974609375,0.0,71.40536209399365,31.024999618530277,33.744998931884766,71.80152630003019,-28.19847369996981,1.0648883501229598,1.1103438635376859,0.042634288544384225,1280879540.0,-1.0
658,2015-08-13,GOOG,32.96609878540039,33.224998474121094,32.58304977416992,32.8224983215332,36214000.0,0.0,0.0,-0.1555023193359375,0.1555023193359375,0.0,67.56016775234525,31.024999618530277,33.744998931884766,66.08452782240332,-33.91547217759668,1.0550436495265956,1.0992838207354678,0.04929581973551089,1244665540.0,-1.0
659,2015-08-14,GOOG,32.7504997253418,32.99274826049805,32.632999420166016,32.85599899291992,21442000.0,0.0,0.0,0.03350067138671875,0.0,0.03350067138671875,67.98867256022976,31.102500915527344,33.744998931884766,66.35759294948139,-33.642407050518614,1.0379796937907635,1.087022995346527,0.04104814039169291,1266107540.0,1.0
660,2015-08-17,GOOG,32.84000015258789,33.069000244140625,32.5620002746582,33.04349899291992,21034000.0,0.0,0.0,0.1875,0.0,0.1875,70.50475451226573,31.102500915527344,33.744998931884766,73.45315172906606,-26.546848270933932,1.02773893423943,1.0751661831251076,0.050250278698724005,1287141540.0,1.0
661,2015-08-18,GOOG,33.095001220703125,33.20000076293945,32.67300033569336,32.80649948120117,29122000.0,0.0,0.0,-0.23699951171875,0.23699951171875,0.0,63.25370076261042,31.102500915527344,33.744998931884766,64.48438390968869,-35.51561609031131,0.9890974785650677,1.0579524422130997,0.019183581999520527,1258019540.0,-1.0
662,2015-08-19,GOOG,32.83000183105469,33.349998474121094,32.70949935913086,33.04499816894531,42682000.0,0.0,0.0,0.23849868774414062,0.0,0.23849868774414062,67.17374128919997,31.267000198364254,33.744998931884766,71.75136720328517,-28.248632796714823,0.9665766040127259,1.039677274573025,0.028350013384798922,1300701540.0,1.0
663,2015-08-20,GOOG,32.77299880981445,33.14950180053711,32.14500045776367,32.34149932861328,57106000.0,0.0,0.0,-0.7034988403320312,0.7034988403320312,0.0,49.280852568367116,31.267000198364254,33.744998931884766,43.361568983632125,-56.638431016367875,0.881797360573291,1.008101291773078,0.018148904455912218,1243595540.0,-1.0
664,2015-08-21,GOOG,31.98900032043457,32.002498626708984,30.616500854492188,30.624000549316406,85304000.0,0.0,0.0,-1.717498779296875,1.717498779296875,0.0,28.15491193941324,30.616500854492188,33.744998931884766,0.23972189333960886,-99.7602781066604,0.6683174539965115,0.9401445242177647,-0.033531629608209323,1158291540.0,-1.0
665,2015-08-24,GOOG,28.649999618530277,29.96649932861328,28.252500534057617,29.480499267578125,115406000.0,0.0,0.0,-1.1435012817382812,1.1435012817382812,0.0,21.179840585378443,28.252500534057617,33.744998931884766,22.357744046066692,-77.6422559539333,0.40222548814672976,0.8325607170035577,-0.10770610610166798,1042885540.0,-1.0
666,2015-08-25,GOOG,30.745500564575195,30.872499465942383,29.055500030517575,29.10300064086914,70760000.0,0.0,0.0,-0.3774986267089844,0.3774986267089844,0.0,19.353504399576735,28.252500534057617,33.744998931884766,15.484758396069523,-84.51524160393048,0.15905125991559643,0.6978588255859656,-0.11750257519243812,972125540.0,-1.0
667,2015-08-26,GOOG,30.51749992370605,31.58550071716309,29.95249938964844,31.43099975585937,84718000.0,0.0,0.0,2.327999114990231,0.0,2.327999114990231,50.020239829320104,28.252500534057617,33.744998931884766,57.86982519756728,-42.13017480243272,0.15242692207087316,0.5887724448829471,-0.04239465722695879,1056843540.0,1.0
668,2015-08-27,GOOG,31.96999931335449,32.179500579833984,31.100000381469727,31.88050079345703,69826000.0,0.0,0.0,0.4495010375976598,0.0,0.4495010375976598,53.923747110050634,28.252500534057617,33.744998931884766,66.0537335948002,-33.9462664051998,0.18135748747586078,0.5072894534015299,-0.02969010924528881,1126669540.0,1.0
669,2015-08-28,GOOG,31.641000747680664,31.8439998626709,31.22800064086914,31.518999099731445,39574000.0,0.0,0.0,-0.36150169372558594,0.36150169372558594,0.0,50.279722959453544,28.252500534057617,33.744998931884766,59.47199851648689,-40.5280014835131,0.17311939092929052,0.440455440907082,-0.046136152031451716,1087095540.0,-1.0
670,2015-08-31,GOOG,31.37700080871582,31.790000915527344,30.88400077819824,30.912500381469727,43534000.0,0.0,0.0,-0.6064987182617188,0.6064987182617188,0.0,44.463130005789566,28.252500534057617,33.349998474121094,52.18246046763455,-47.817539532365444,0.11631050709637591,0.3756264541449408,-0.05773243502607606,1043561540.0,-1.0
671,2015-09-01,GOOG,30.118000030517575,30.64299964904785,29.70499992370605,29.88949966430664,74042000.0,0.0,0.0,-1.023000717163086,1.023000717163086,0.0,36.29202248012011,28.252500534057617,33.349998474121094,32.113777180430574,-67.88622281956943,-0.011130248353776295,0.2982751136451974,-0.0954909571641046,969519540.0,-1.0
672,2015-09-02,GOOG,30.27949905395508,30.71699905395508,29.98550033569336,30.71699905395508,51512000.0,0.0,0.0,0.827499389648441,0.0,0.827499389648441,45.61949137899247,28.252500534057617,33.349998474121094,48.3472195354487,-51.6527804645513,-0.04483880631736881,0.22965232965268415,-0.05022959072342592,1021031540.0,1.0
673,2015-09-03,GOOG,30.850000381469727,30.98550033569336,30.14105033874512,30.3125,35192000.0,0.0,0.0,-0.4044990539550817,0.4044990539550817,0.0,42.13965590292786,28.252500534057617,33.349998474121094,40.41197250423471,-59.588027495765296,-0.10300539242979312,0.16312078523618867,-0.010171778465546066,985839540.0,-1.0
674,2015-09-04,GOOG,30.0,30.17350006103516,29.762500762939453,30.03499984741211,41780000.0,0.0,0.0,-0.2775001525878906,0.2775001525878906,0.0,39.74010011167209,28.252500534057617,33.349998474121094,34.96812228887915,-65.03187771112084,-0.16954041773935558,0.09658854464107981,0.018809063401575843,944059540.0,-1.0
675,2015-09-08,GOOG,30.624500274658203,30.81550025939941,30.20599937438965,30.732999801635746,45590000.0,0.0,0.0,0.6979999542236364,0.0,0.6979999542236364,48.28651121373258,28.252500534057617,33.349998474121094,48.6611136825146,-51.3388863174854,-0.16405600626047345,0.04445963446076915,0.056007941616769585,989649540.0,1.0
676,2015-09-09,GOOG,31.06100082397461,31.326000213623047,30.479999542236328,30.63599967956543,34042000.0,0.0,0.0,-0.09700012207031605,0.09700012207031605,0.0,47.21281828527484,28.252500534057617,33.14950180053711,48.672626691422856,-51.32737330857715,-0.16562742003891984,0.002442223560831342,-0.02529350267153807,955607540.0,-1.0
677,2015-09-10,GOOG,30.655000686645508,31.20800018310547,30.57150077819824,31.0674991607666,38106000.0,0.0,0.0,0.4314994812011719,0.0,0.4314994812011719,52.620382874885,28.252500534057617,32.179500579833984,71.6831829359569,-28.316817064043104,-0.13054948167790315,-0.024156117486915565,-0.02550153267533628,993713540.0,1.0
678,2015-09-11,GOOG,30.987499237060547,31.28899955749512,30.871000289916992,31.28849983215332,27470000.0,0.0,0.0,0.22100067138671875,0.0,0.22100067138671875,55.324960241204465,28.252500534057617,32.179500579833984,77.31090559474355,-22.68909440525645,-0.08394933986929942,-0.03611476196339234,-0.0073130262432759,1021183540.0,1.0
679,2015-09-14,GOOG,31.28499984741211,31.292999267578125,30.97150039672852,31.16200065612793,34046000.0,0.0,0.0,-0.12649917602539062,0.12649917602539062,0.0,53.31494728467444,29.055500030517575,32.179500579833984,67.42958563407734,-32.57041436592266,-0.05657367198288554,-0.04020654396729098,0.008071177406527852,987137540.0,-1.0
680,2015-09-15,GOOG,31.334999084472656,31.934999465942383,31.18899917602539,31.756999969482425,41688000.0,0.0,0.0,0.5949993133544957,0.0,0.5949993133544957,61.004024317740395,29.70499992370605,32.179500579833984,82.92582346643293,-17.07417653356708,0.012983547762477343,-0.029568525621337317,0.06248014607637975,1028825540.0,1.0
681,2015-09-16,GOOG,31.773500442504883,31.897499084472656,31.61599922180176,31.798999786376957,25730000.0,0.0,0.0,0.04199981689453125,0.0,0.04199981689453125,61.520212271482364,29.70499992370605,32.179500579833984,84.62312820508883,-15.376871794911157,0.0706823970843331,-0.009518341080203227,0.035224819017030784,1054555540.0,1.0
682,2015-09-17,GOOG,31.88949966430664,32.54499816894531,31.750999450683597,32.14500045776367,45494000.0,0.0,0.0,0.3460006713867152,0.0,0.3460006713867152,65.82079654847769,29.70499992370605,32.54499816894531,85.915564847543,-14.084435152457006,0.1426837440188109,0.020922075939599608,0.060453623348904584,1100049540.0,1.0
683,2015-09-18,GOOG,31.839500427246094,32.0,31.35099983215332,31.462499618530277,102668000.0,0.0,0.0,-0.6825008392333949,0.6825008392333949,0.0,52.473115983821735,29.70499992370605,32.54499816894531,61.88383030765435,-38.11616969234565,0.14302451875490618,0.045342564502660936,0.04752787675612935,997381540.0,-1.0
684,2015-09-21,GOOG,31.71999931335449,31.824499130249023,31.29700088500977,31.77199935913086,35770000.0,0.0,0.0,0.3094997406005824,0.0,0.3094997406005824,57.03232527426709,29.70499992370605,32.54499816894531,72.78171523133,-27.21828476867,0.16635103645924687,0.06954425889397813,0.03380729392513815,1033151540.0,1.0
685,2015-09-22,GOOG,31.350000381469727,31.377500534057617,30.771499633789062,31.13450050354004,51258000.0,0.0,0.0,-0.6374988555908203,0.6374988555908203,0.0,46.44361172607333,29.762500762939453,32.54499816894531,49.308212745830566,-50.69178725416944,0.13187645032338935,0.08201069717986037,0.016271733554923395,981893540.0,-1.0
686,2015-09-23,GOOG,31.102500915527344,31.44650077819824,31.0,31.118000030517575,29418000.0,0.0,0.0,-0.01650047302246449,0.01650047302246449,0.0,46.18751055304454,29.762500762939453,32.54499816894531,48.715203279340166,-51.284796720659834,0.10204730435961551,0.0860180186158114,0.0016255209178455132,952475540.0,-1.0
687,2015-09-24,GOOG,30.832000732421875,31.36599922180176,30.6200008392334,31.290000915527344,44802000.0,0.0,0.0,0.17200088500976918,0.0,0.17200088500976918,49.53455791622169,29.762500762939453,32.54499816894531,54.89673231288087,-45.10326768711913,0.09123482693169294,0.08706138027898772,4.797556233371303e-05,997277540.0,1.0
688,2015-09-25,GOOG,31.488500595092773,31.488500595092773,30.549999237060547,30.598499298095703,43480000.0,0.0,0.0,-0.6915016174316406,0.6915016174316406,0.0,38.44272409067158,30.20599937438965,32.54499816894531,16.780680888748268,-83.21931911125174,0.02656127739183134,0.07496135970155644,-0.018082964705971594,953797540.0,-1.0
689,2015-09-28,GOOG,30.517000198364254,30.730249404907227,29.4689998626709,29.74449920654297,62554000.0,0.0,0.0,-0.8540000915527344,0.8540000915527344,0.0,29.143456483345062,29.4689998626709,32.54499816894531,8.956420532160484,-91.04357946783952,-0.09253693855263379,0.04146170005071839,-0.06337187910928022,891243540.0,-1.0
690,2015-09-29,GOOG,29.86400032043457,30.25,29.51099967956543,29.74850082397461,46190000.0,0.0,0.0,0.004001617431640625,0.0,0.004001617431640625,29.236005644334725,29.4689998626709,32.54499816894531,9.086512197798859,-90.91348780220115,-0.1844737372490215,-0.0037253874092295983,-0.0644831276511032,937433540.0,1.0
691,2015-09-30,GOOG,30.16399955749512,30.4379997253418,30.036500930786133,30.42099952697754,48268000.0,0.0,0.0,0.6724987030029297,0.0,0.6724987030029297,43.536843109236905,29.4689998626709,32.54499816894531,30.949290913611815,-69.05070908638818,-0.20075510764340265,-0.04313133145606422,-0.05363200828232528,985701540.0,1.0
692,2015-10-01,GOOG,30.418500900268555,30.60449981689453,29.99250030517578,30.56450080871582,37352000.0,0.0,0.0,0.14350128173828125,0.0,0.14350128173828125,46.21315919224191,29.4689998626709,32.54499816894531,35.614484696247125,-64.38551530375288,-0.19977596388046592,-0.07446025794094457,-0.02854187749550474,1023053540.0,1.0
693,2015-10-02,GOOG,30.36000061035156,31.367000579833984,30.1564998626709,31.34550094604492,53696000.0,0.0,0.0,0.781000137329098,0.0,0.781000137329098,58.55078938491286,29.4689998626709,32.54499816894531,61.00462017636153,-38.99537982363847,-0.13443017403561086,-0.08645424115987783,-0.013423719680498158,1076749540.0,1.0
694,2015-10-05,GOOG,31.600000381469727,32.1505012512207,31.350000381469727,32.07350158691406,36072000.0,0.0,0.0,0.7280006408691442,0.0,0.7280006408691442,66.75308811766777,29.4689998626709,32.54499816894531,84.67175417263746,-15.32824582736253,-0.023627237147248792,-0.07388884035735203,0.030159503707703816,1112821540.0,1.0
695,2015-10-06,GOOG,31.941999435424805,32.462501525878906,31.826499938964844,32.27199935913086,43326000.0,0.0,0.0,0.19849777221679688,0.0,0.19849777221679688,68.7016429917879,29.4689998626709,32.54499816894531,91.12487125699677,-8.875128743003232,0.07928801702642119,-0.04325346888059738,0.037084623930893734,1156147540.0,1.0
696,2015-10-07,GOOG,32.46200180053711,32.53044891357422,31.607500076293945,32.11800003051758,41854000.0,0.0,0.0,-0.15399932861328125,0.15399932861328125,0.0,65.27687031746838,29.4689998626709,32.53044891357422,86.527658105728,-13.472341894272002,0.146731212549156,-0.005256532594646698,0.0264620994171767,1114293540.0,-1.0
697,2015-10-08,GOOG,32.06800079345703,32.22249984741211,31.277999877929688,31.95800018310547,43642000.0,0.0,0.0,-0.15999984741210938,0.15999984741210938,0.0,61.5958778940587,29.4689998626709,32.53044891357422,81.30137980575435,-18.69862019424565,0.18513565183980418,0.03282190429224349,0.04443031247268969,1070651540.0,-1.0
698,2015-10-09,GOOG,32.0,32.29949951171875,31.765899658203125,32.18050003051758,32974000.0,0.0,0.0,0.22249984741210938,0.0,0.22249984741210938,64.78244357341376,29.4689998626709,32.53044891357422,88.56917501359744,-11.430824986402556,0.23086406758085332,0.07243033694996547,0.08189752354071422,1103625540.0,1.0
699,2015-10-12,GOOG,32.10449981689453,32.42499923706055,31.95050048828125,32.333499908447266,25504000.0,0.0,0.0,0.1529998779296875,0.0,0.1529998779296875,66.9577663348377,29.4689998626709,32.53044891357422,93.56680441672414,-6.433195583275859,0.276265362852925,0.11319734213055738,0.08689510438755899,1129129540.0,1.0
700,2015-10-13,GOOG,32.157501220703125,32.89059829711914,32.157501220703125,32.6150016784668,36154000.0,0.0,0.0,0.28150177001953125,0.0,0.28150177001953125,70.78829988817027,29.4689998626709,32.89059829711914,91.94538389199415,-8.05461610800584,0.33114383666760716,0.15678664103796736,0.07212130388890081,1165283540.0,1.0
701,2015-10-14,GOOG,32.660499572753906,32.96950149536133,32.442501068115234,32.55799865722656,28310000.0,0.0,0.0,-0.057003021240234375,0.057003021240234375,0.0,68.92145195973306,29.4689998626709,32.96950149536133,88.24446089977992,-11.755539100220076,0.3658188234415114,0.1985930775186762,0.06522265359368395,1136973540.0,-1.0
702,2015-10-15,GOOG,32.733001708984375,33.15650177001953,32.722999572753906,33.08700180053711,37714000.0,0.0,0.0,0.5290031433105469,0.0,0.5290031433105469,75.76521441202128,29.4689998626709,33.15650177001953,98.1152560397618,-1.8847439602382026,0.4310166413382497,0.24507779028259097,0.05555823968134499,1174687540.0,1.0
703,2015-10-16,GOOG,33.205501556396484,33.24850082397461,32.86000061035156,33.11000061035156,32222000.0,0.0,0.0,0.022998809814453125,0.0,0.022998809814453125,76.03000175654185,29.51099967956543,33.24850082397461,96.29430980027323,-3.705690199726771,0.4790203451304258,0.291866301252158,0.0323163662261432,1206909540.0,1.0
704,2015-10-19,GOOG,33.05899810791016,33.340999603271484,32.979000091552734,33.30500030517578,29546000.0,0.0,0.0,0.19499969482421875,0.0,0.19499969482421875,78.34472090481077,29.99250030517578,33.340999603271484,98.92491247896704,-1.075087521032959,0.526726694467758,0.33883837989527804,0.03200920198805868,1236455540.0,1.0
705,2015-10-20,GOOG,33.20199966430664,33.23600006103516,32.20975112915039,32.513999938964844,49964000.0,0.0,0.0,-0.7910003662109375,0.7910003662109375,0.0,53.95709512271245,29.99250030517578,33.340999603271484,75.30237904553371,-24.697620954466277,0.4950011361657367,0.37007093114936984,0.012329531978049646,1186491540.0,-1.0
706,2015-10-21,GOOG,32.70750045776367,32.79349899291992,32.08649826049805,32.13050079345703,35822000.0,0.0,0.0,-0.3834991455078125,0.3834991455078125,0.0,45.954616015366575,30.1564998626709,33.340999603271484,61.987787457437285,-38.012212542562715,0.43391136650209816,0.38283901821991556,0.005397728561337134,1150669540.0,-1.0
707,2015-10-22,GOOG,32.334999084472656,32.88999938964844,32.20050048828125,32.589500427246094,81420000.0,0.0,0.0,0.4589996337890625,0.0,0.4589996337890625,55.14234893152228,31.277999877929688,33.340999603271484,63.572502371473526,-36.42749762852647,0.4177195078769813,0.38981511615132874,0.012709572453524665,1232089540.0,1.0
708,2015-10-23,GOOG,36.375,36.5,35.07500076293945,35.099998474121094,133078000.0,0.0,0.0,2.510498046875,0.0,2.510498046875,78.35959218211941,31.277999877929688,36.5,73.19031993197538,-26.809680068024626,0.6005408929456024,0.4319602715101835,0.08556137051377699,1365167540.0,1.0
709,2015-10-26,GOOG,35.07749938964844,35.95750045776367,35.0629997253418,35.638999938964844,54332000.0,0.0,0.0,0.53900146484375,0.0,0.53900146484375,80.81896377858803,31.277999877929688,36.5,83.51206355978015,-16.48793644021985,0.7799305178393681,0.5015543207760205,0.09271801639963018,1419499540.0,1.0
710,2015-10-27,GOOG,35.36899948120117,35.680999755859375,35.227500915527344,35.42449951171875,44916000.0,0.0,0.0,-0.21450042724609375,0.21450042724609375,0.0,76.81060996862271,31.277999877929688,36.5,79.40443387322523,-20.595566126774763,0.8944787024876177,0.5801391971183399,0.08804290720295671,1374583540.0,-1.0
711,2015-10-28,GOOG,35.36650085449219,35.64899826049805,35.15399932861328,35.647499084472656,43578000.0,0.0,0.0,0.22299957275390625,0.0,0.22299957275390625,78.11277845599544,31.765899658203125,36.5,81.99233531235697,-18.007664687643025,0.9918200814204567,0.6624753739787633,0.0773868028107032,1418161540.0,1.0
712,2015-10-29,GOOG,35.525001525878906,35.91299819946289,35.5004997253418,35.84600067138672,29120000.0,0.0,0.0,0.1985015869140625,0.0,0.1985015869140625,79.3062833728525,31.95050048828125,36.5,85.62480714793598,-14.37519285206402,1.0726167860200135,0.7445036563870134,0.0826336457444754,1447281540.0,1.0
713,2015-10-30,GOOG,35.7864990234375,35.900001525878906,35.502498626708984,35.54050064086914,38176000.0,0.0,0.0,-0.3055000305175781,0.3055000305175781,0.0,72.3047143436491,32.08649826049805,36.5,78.25990753457513,-21.740092465424862,1.099325121536559,0.8154679494169226,0.06712206321000846,1409105540.0,-1.0
714,2015-11-02,GOOG,35.553001403808594,36.08100128173828,35.29249954223633,36.05550003051758,37726000.0,0.0,0.0,0.5149993896484375,0.0,0.5149993896484375,76.36364510284771,32.08649826049805,36.5,89.92863273386673,-10.071367266133263,1.1488051064113733,0.8821353808158129,0.10892231340963354,1446831540.0,1.0
715,2015-11-03,GOOG,35.94300079345703,36.23249816894531,35.73600006103516,36.108001708984375,31308000.0,0.0,0.0,0.052501678466796875,0.0,0.052501678466796875,76.76421428785385,32.08649826049805,36.5,91.11820241267515,-8.881797587324854,1.178667848325901,0.9414418743178306,0.12379206104180329,1478139540.0,1.0
716,2015-11-04,GOOG,36.09999847412109,36.65499877929688,36.095001220703125,36.40549850463867,34134000.0,0.0,0.0,0.2974967956542969,0.0,0.2974967956542969,79.08200443466482,32.08649826049805,36.65499877929688,94.53868345573025,-5.461316544269752,1.212364409327357,0.995626381319736,0.11709286817426179,1512273540.0,1.0
717,2015-11-05,GOOG,36.4734992980957,36.9739990234375,36.4734992980957,36.5625,37232000.0,0.0,0.0,0.15700149536132812,0.0,0.15700149536132812,80.27983839714236,32.08649826049805,36.9739990234375,91.58058395493703,-8.419416045062983,1.2374730660459008,1.043995718264969,0.04166671195034932,1549505540.0,1.0
718,2015-11-06,GOOG,36.57500076293945,36.77050018310547,36.35049819946289,36.6879997253418,30232000.0,0.0,0.0,0.12549972534179688,0.0,0.12549972534179688,81.26912367378094,32.08649826049805,36.9739990234375,94.14835287056412,-5.851647129435877,1.253054207478904,1.085807416107756,0.029434041027342595,1579737540.0,1.0
719,2015-11-09,GOOG,36.5099983215332,36.73550033569336,35.97150039672852,36.24449920654297,41396000.0,0.0,0.0,-0.4435005187988281,0.4435005187988281,0.0,67.468165459831,32.08649826049805,36.9739990234375,85.07417487428086,-14.925825125719133,1.215602875677753,1.1117665080217554,0.02314781312726688,1538341540.0,-1.0
720,2015-11-10,GOOG,36.220001220703125,36.52949905395508,35.92499923706055,36.41600036621094,32160000.0,0.0,0.0,0.17150115966796875,0.0,0.17150115966796875,69.75952435277586,32.20050048828125,36.9739990234375,88.31048856269739,-11.689511437302611,1.1860886441184206,1.1266309352410884,0.021558350556856398,1570501540.0,1.0
721,2015-11-11,GOOG,36.62300109863281,37.04999923706055,36.51150131225586,36.77000045776367,27328000.0,0.0,0.0,0.3540000915527344,0.0,0.3540000915527344,74.10369249422205,35.0629997253418,37.04999923706055,85.90846260175088,-14.091537398249118,1.1776876022614005,1.136842268645151,0.025776928222693396,1597829540.0,1.0
722,2015-11-12,GOOG,36.54999923706055,36.88999938964844,36.4322509765625,36.561500549316406,36744000.0,0.0,0.0,-0.20849990844726562,0.20849990844726562,0.0,67.51265756244422,35.0629997253418,37.04999923706055,75.41525879281217,-24.584741207187836,1.1410521767450206,1.137684250265125,0.02872778632930073,1561085540.0,-1.0
723,2015-11-13,GOOG,36.45849990844727,36.557498931884766,35.83649826049805,35.849998474121094,41510000.0,0.0,0.0,-0.7115020751953125,0.7115020751953125,0.0,50.0014954921706,35.15399932861328,37.04999923706055,36.708817463910265,-63.29118253608973,1.0425877641254928,1.1186649530371986,-0.005699589694292073,1519575540.0,-1.0
724,2015-11-16,GOOG,35.779998779296875,36.4744987487793,35.56650161743164,36.448001861572266,38118000.0,0.0,0.0,0.5980033874511719,0.0,0.5980033874511719,60.050378913315505,35.15399932861328,37.04999923706055,68.24908203812686,-31.750917961873142,1.0012659131903376,1.0951851450678265,0.009416199637081846,1557693540.0,1.0
725,2015-11-17,GOOG,36.464500427246094,36.59225082397461,36.15134811401367,36.26499938964844,30218000.0,0.0,0.0,-0.18300247192382812,0.18300247192382812,0.0,56.07112816638187,35.29249954223633,37.04999923706055,55.33428257632652,-44.665717423673485,0.9428823181082961,1.0647245796759204,-0.0038592828215862074,1527475540.0,-1.0
726,2015-11-18,GOOG,36.37900161743164,37.070499420166016,36.34999847412109,37.0,33686000.0,0.0,0.0,0.7350006103515625,0.0,0.7350006103515625,66.39182706742452,35.29249954223633,37.070499420166016,96.03490298052745,-3.9650970194725508,0.9450276148884953,1.0407851867184355,0.011965811965811923,1561161540.0,1.0
727,2015-11-19,GOOG,36.9370002746582,37.09999847412109,36.87149810791016,36.920501708984375,26542000.0,0.0,0.0,-0.079498291015625,0.079498291015625,0.0,64.5006121108501,35.29249954223633,37.09999847412109,90.06932939376388,-9.930670606236125,0.9295971134826928,1.0185475720712869,0.00633727609526713,1534619540.0,-1.0
728,2015-11-20,GOOG,37.32649993896485,37.89599990844727,37.150001525878906,37.83000183105469,44246000.0,0.0,0.0,0.9095001220703125,0.0,0.9095001220703125,74.20153440089496,35.56650161743164,37.89599990844727,97.16685444041211,-2.833145559587893,0.9794667062959164,1.0107313989162128,0.04374464151033153,1578865540.0,1.0
729,2015-11-23,GOOG,37.872501373291016,38.135398864746094,37.59099960327149,37.79899978637695,28290000.0,0.0,0.0,-0.031002044677734375,0.031002044677734375,0.0,73.41249690935099,35.56650161743164,38.135398864746094,86.90492277490604,-13.09507722509396,1.0049032132687827,1.0095657617867269,0.03797779564636783,1550575540.0,-1.0
730,2015-11-24,GOOG,37.59999847412109,37.76395034790039,36.88150024414063,37.41400146484375,46662000.0,0.0,0.0,-0.3849983215332031,0.3849983215332031,0.0,63.70563197276337,35.56650161743164,38.135398864746094,71.91801265478801,-28.081987345211985,0.9826680952104709,1.0041862284714758,0.017514305114568085,1503913540.0,-1.0
731,2015-11-25,GOOG,37.40700149536133,37.59999847412109,37.303001403808594,37.407501220703125,22442000.0,0.0,0.0,-0.006500244140625,0.006500244140625,0.0,63.54195472975215,35.56650161743164,38.135398864746094,71.66497629269061,-28.335023707309393,0.9535303838634306,0.9940550595498667,0.02313911241814548,1481471540.0,-1.0
732,2015-11-27,GOOG,37.42300033569336,37.670501708984375,37.3745002746582,37.51300048828125,16770000.0,0.0,0.0,0.105499267578125,0.0,0.105499267578125,65.21559727063357,35.56650161743164,38.135398864746094,75.77176832917299,-24.228231670827014,0.9282511455052997,0.9808942767409533,0.046387784796158904,1498241540.0,1.0
733,2015-11-30,GOOG,37.44049835205078,37.74649810791016,37.0634994506836,37.130001068115234,41952000.0,0.0,0.0,-0.3829994201660156,0.3829994201660156,0.0,54.697577204580895,35.56650161743164,38.135398864746094,60.86266986031027,-39.13733013968974,0.8673144534963058,0.9581783120920239,0.01871156638800575,1456289540.0,-1.0
734,2015-12-01,GOOG,37.355499267578125,38.4474983215332,37.334999084472656,38.35200119018555,42692000.0,0.0,0.0,1.2220001220703125,0.0,1.2220001220703125,71.57494883907246,35.56650161743164,38.4474983215332,96.68527453670112,-3.314725463298889,0.9071695968054598,0.9479765690347112,0.05754865119707753,1498981540.0,1.0
735,2015-12-02,GOOG,38.44499969482422,38.79774856567383,37.948001861572266,38.11899948120117,44608000.0,0.0,0.0,-0.233001708984375,0.233001708984375,0.0,66.15284679576757,35.56650161743164,38.79774856567383,78.99420578665772,-21.005794213342273,0.9094699904556833,0.9402752533189057,0.030243229221653234,1454373540.0,-1.0
736,2015-12-03,GOOG,38.30049896240234,38.44974899291992,37.28150177001953,37.62699890136719,51812000.0,0.0,0.0,-0.4920005798339844,0.4920005798339844,0.0,55.845452903439224,35.56650161743164,38.79774856567383,63.767867852268814,-36.232132147731186,0.8616600532951111,0.9245522133141468,0.01913563358243553,1402561540.0,-1.0
737,2015-12-04,GOOG,37.65499877929688,38.42449951171875,37.5,38.34049987792969,55146000.0,0.0,0.0,0.7135009765625,0.0,0.7135009765625,64.9767695043875,35.56650161743164,38.79774856567383,85.84915684043011,-14.150843159569895,0.8713000943532663,0.9139017895219709,0.013494528738191347,1457707540.0,1.0
738,2015-12-07,GOOG,38.38850021362305,38.436500549316406,37.75450134277344,38.16249847412109,36246000.0,0.0,0.0,-0.17800140380860086,0.17800140380860086,0.0,61.3260400402037,36.15134811401367,38.79774856567383,75.99569289847149,-24.00430710152851,0.8547239450852899,0.9020662206346347,0.00961662186297163,1421461540.0,-1.0
739,2015-12-08,GOOG,37.89450073242188,38.2400016784668,37.709999084472656,38.118499755859375,36590000.0,0.0,0.0,-0.043998718261711645,0.043998718261711645,0.0,60.3588167239342,36.34999847412109,38.79774856567383,72.25007519523497,-27.749924804765037,0.8284866204688655,0.8873503006014809,0.01882980337394846,1384871540.0,-1.0
740,2015-12-09,GOOG,37.95849990844727,38.21149826049805,36.85005187988281,37.58050155639648,54000000.0,0.0,0.0,-0.5379981994628977,0.5379981994628977,0.0,49.37242670253152,36.85005187988281,38.79774856567383,37.503256120036376,-62.496743879963624,0.7555716337556078,0.8609945672323064,0.004624749850909771,1330871540.0,-1.0
741,2015-12-10,GOOG,37.64250183105469,37.79249954223633,37.19150161743164,37.47299957275391,39768000.0,0.0,0.0,-0.10750198364256391,0.10750198364256391,0.0,47.383912155754984,36.85005187988281,38.79774856567383,31.983814390386144,-68.01618560961386,0.681258347649738,0.8250473233157928,-0.0010663214087561768,1291103540.0,-1.0
742,2015-12-11,GOOG,37.05799865722656,37.28549957275391,36.837501525878906,36.94350051879883,44488000.0,0.0,0.0,-0.5294990539550852,0.5294990539550852,0.0,38.558069219289095,36.837501525878906,38.79774856567383,5.40743032730259,-94.59256967269741,0.5730328189304998,0.7746444224387343,-0.005022907189640824,1246615540.0,-1.0
743,2015-12-14,GOOG,37.089500427246094,37.436500549316406,36.20849990844727,37.38850021362305,48250000.0,0.0,0.0,0.44499969482421875,0.0,0.44499969482421875,47.95794562936546,36.20849990844727,38.79774856567383,45.57307780704686,-54.42692219295314,0.5172090006443568,0.7231573380798589,-0.02512257370311788,1294865540.0,1.0
744,2015-12-15,GOOG,37.650001525878906,37.90399932861328,37.1505012512207,37.16999816894531,53324000.0,0.0,0.0,-0.21850204467773438,0.21850204467773438,0.0,44.132682507378945,36.20849990844727,38.79774856567383,37.134257376730204,-62.8657426232698,0.45014790867215737,0.6685554521983187,-0.024895756057917273,1241541540.0,-1.0
745,2015-12-16,GOOG,37.5,38.02949905395508,36.97174835205078,37.90449905395508,39866000.0,0.0,0.0,0.7345008850097656,0.0,0.7345008850097656,57.332842113081426,36.20849990844727,38.79774856567383,65.50159409272247,-34.49840590727752,0.4510699395930402,0.625058349677263,0.007375027525190259,1281407540.0,1.0
746,2015-12-17,GOOG,38.12099838256836,38.13399887084961,37.45000076293945,37.47150039672852,31068000.0,0.0,0.0,-0.4329986572265554,0.4329986572265554,0.0,49.394306638127915,36.20849990844727,38.79774856567383,48.77864799721858,-51.22135200278143,0.41211072689367967,0.5824688251205464,-0.022665314327354302,1250339540.0,-1.0
747,2015-12-18,GOOG,37.32550048828125,37.70650100708008,36.907501220703125,36.96549987792969,62974000.0,0.0,0.0,-0.5060005187988352,0.5060005187988352,0.0,41.62317232820728,36.20849990844727,38.79774856567383,29.236279310974588,-70.7637206890254,0.3365259949100263,0.5332802590784425,-0.03136583410551885,1187365540.0,-1.0
748,2015-12-21,GOOG,37.30649948120117,37.5,37.0,37.38850021362305,30514000.0,0.0,0.0,0.4230003356933594,0.0,0.4230003356933594,49.3149243939931,36.20849990844727,38.79774856567383,45.57307780704686,-54.42692219295314,0.3072157502498172,0.4880673573127174,-0.019150794152755668,1217879540.0,1.0
749,2015-12-22,GOOG,37.58250045776367,37.74250030517578,37.2765007019043,37.5,27308000.0,0.0,0.0,0.11149978637695312,0.0,0.11149978637695312,51.26783222475216,36.20849990844727,38.44974899291992,57.62412132146431,-42.3758786785357,0.28964541901333973,0.44838296965284186,-0.0021421096862070943,1245187540.0,1.0
750,2015-12-23,GOOG,37.67350006103516,37.71049880981445,37.20000076293945,37.51549911499024,31318000.0,0.0,0.0,0.01549911499024148,0.0,0.01549911499024148,51.567143107220296,36.20849990844727,38.436500549316406,58.66242507152574,-41.33757492847426,0.27381508412343436,0.4134693925469603,0.0011341377183808898,1276505540.0,1.0
751,2015-12-24,GOOG,37.477500915527344,37.567501068115234,37.33100128173828,37.41999816894531,10544000.0,0.0,0.0,-0.09550094604492898,0.09550094604492898,0.0,49.40956518807123,36.20849990844727,38.436500549316406,54.376028367094165,-45.623971632905835,0.2506736911876075,0.3809102522750898,0.012898010298293627,1265961540.0,-1.0
752,2015-12-28,GOOG,37.64599990844727,38.14950180053711,37.47600173950195,38.1254997253418,30306000.0,0.0,0.0,0.7055015563964844,0.0,0.7055015563964844,62.70905577714774,36.20849990844727,38.2400016784668,94.36367938168719,-5.636320618312804,0.28596561642121543,0.36192132510431496,0.01971193033975216,1296267540.0,1.0
753,2015-12-29,GOOG,38.33449935913086,38.999000549316406,38.32149887084961,38.83000183105469,35300000.0,0.0,0.0,0.7045021057128906,0.0,0.7045021057128906,71.37849929981296,36.20849990844727,38.999000549316406,93.94378500450435,-6.056214995495653,0.3665567159469134,0.3628484032728347,0.044659772501583594,1331567540.0,1.0
754,2015-12-30,GOOG,38.83000183105469,38.880001068115234,38.345001220703125,38.54999923706055,25866000.0,0.0,0.0,-0.2800025939941406,0.2800025939941406,0.0,64.50169543438423,36.20849990844727,38.999000549316406,83.90965027279074,-16.090349727209265,0.40318421701228147,0.37091556602072406,0.017029645535920013,1305701540.0,-1.0
755,2015-12-31,GOOG,38.47499847412109,38.47499847412109,37.91699981689453,37.94400024414063,30018000.0,0.0,0.0,-0.6059989929199148,0.6059989929199148,0.0,51.992771588223704,36.20849990844727,38.999000549316406,62.19315309502376,-37.80684690497624,0.37894448516946255,0.3725213498504718,0.012609579077686561,1275683540.0,-1.0
756,2016-01-04,GOOG,37.150001525878906,37.20299911499024,36.56290054321289,37.09199905395508,65456000.0,0.0,0.0,-0.852001190185554,0.852001190185554,0.0,39.55012241567057,36.20849990844727,38.999000549316406,31.660954760885822,-68.33904523911417,0.28766887969182875,0.35555085581874324,0.0034220875260209116,1210227540.0,-1.0
757,2016-01-05,GOOG,37.3224983215332,37.59999847412109,36.93199920654297,37.12900161743164,39014000.0,0.0,0.0,0.0370025634765625,0.0,0.0370025634765625,40.26647616832589,36.56290054321289,38.999000549316406,23.23800635443597,-76.76199364556403,0.21583014679219303,0.3276067140134332,-0.0069405992406417205,1249241540.0,1.0
758,2016-01-06,GOOG,36.5,37.35900115966797,36.44599914550781,37.180999755859375,38940000.0,0.0,0.0,0.051998138427734375,0.0,0.051998138427734375,41.39260587872889,36.44599914550781,38.999000549316406,28.789667301204027,-71.21033269879598,0.16123463608394673,0.29433229842753594,-0.008506673177083313,1288181540.0,1.0
759,2016-01-07,GOOG,36.51549911499024,36.92499923706055,35.952999114990234,36.31949996948242,59274000.0,0.0,0.0,-0.8614997863769531,0.8614997863769531,0.0,30.426776017290535,35.952999114990234,38.999000549316406,12.032195729194193,-87.9678042708058,0.047899314124805414,0.24504570156698985,-0.031880134177128094,1228907540.0,-1.0
760,2016-01-08,GOOG,36.5724983215332,36.6614990234375,35.650001525878906,35.7234992980957,49018000.0,0.0,0.0,-0.5960006713867188,0.5960006713867188,0.0,25.115488151825502,35.650001525878906,38.999000549316406,2.194619099690177,-97.80538090030983,-0.08898624027430913,0.17823931319873004,-0.045336690375830324,1179889540.0,-1.0
761,2016-01-11,GOOG,35.830501556396484,35.9427490234375,35.176998138427734,35.80149841308594,41812000.0,0.0,0.0,0.07799911499023438,0.0,0.07799911499023438,27.038700747573643,35.176998138427734,38.999000549316406,16.339609647524988,-83.660390352475,-0.18899651742226808,0.10479214707453041,-0.06095661247716344,1221701540.0,1.0
762,2016-01-12,GOOG,36.08399963378906,36.4375,35.865848541259766,36.30350112915039,40490000.0,0.0,0.0,0.5020027160644531,0.0,0.5020027160644531,38.725133490119475,35.176998138427734,38.999000549316406,29.474156989365362,-70.52584301063463,-0.2251525404883452,0.038803209561955265,-0.06506568588116068,1262191540.0,1.0
763,2016-01-13,GOOG,36.54249954223633,36.73699951171875,34.93050003051758,35.02799987792969,50034000.0,0.0,0.0,-1.2755012512207031,1.2755012512207031,0.0,26.35110783717984,34.93050003051758,38.999000549316406,2.396456555962169,-97.60354344403783,-0.3526634556319337,-0.03949012347682255,-0.09136185288805243,1212157540.0,-1.0
764,2016-01-14,GOOG,35.26900100708008,36.09624862670898,34.45500183105469,35.73600006103516,44516000.0,0.0,0.0,0.7080001831054759,0.0,0.7080001831054759,38.862990618092475,34.45500183105469,38.999000549316406,28.19099012577439,-71.80900987422561,-0.39206756593109304,-0.11000561196767668,-0.058191022794082725,1256673540.0,1.0
765,2016-01-15,GOOG,34.614498138427734,35.33700180053711,34.26850128173828,34.72249984741211,72162000.0,0.0,0.0,-1.013500213623054,1.013500213623054,0.0,30.34737635924958,34.26850128173828,38.999000549316406,9.59726532007819,-90.40273467992182,-0.49932074556069495,-0.18786863868628037,-0.0638816797955869,1184511540.0,-1.0
766,2016-01-19,GOOG,35.165000915527344,35.499000549316406,34.670501708984375,35.089500427246094,45362000.0,0.0,0.0,0.3670005798339844,0.0,0.3670005798339844,36.18940115202251,34.26850128173828,38.999000549316406,17.355443877452277,-82.64455612254771,-0.5483843500636709,-0.25997178096175855,-0.05493013820301662,1229873540.0,1.0
767,2016-01-20,GOOG,34.43050003051758,35.342498779296875,33.66299819946289,34.92250061035156,68900000.0,0.0,0.0,-0.16699981689453125,0.16699981689453125,0.0,34.66293088845228,33.66299819946289,38.880001068115234,24.142260270867485,-75.85773972913252,-0.5938970244543071,-0.3267568296602683,-0.06074336785825385,1160973540.0,-1.0
768,2016-01-21,GOOG,35.10900115966797,35.95949935913086,34.722999572753906,35.329498291015625,48244000.0,0.0,0.0,0.4069976806640625,0.0,0.4069976806640625,41.59097657574444,33.66299819946289,38.47499847412109,34.63216950192523,-65.36783049807477,-0.5903199939728552,-0.37946946252278574,-0.02725813073689476,1209217540.0,1.0
769,2016-01-22,GOOG,36.18000030517578,36.40650177001953,36.00605010986328,36.26250076293945,40236000.0,0.0,0.0,0.9330024719238281,0.0,0.9330024719238281,54.38477910335814,33.66299819946289,37.59999847412109,66.02749256100185,-33.97250743899816,-0.5063626362174247,-0.4048480972617136,0.01508814856982621,1249453540.0,1.0
770,2016-01-25,GOOG,36.17900085449219,36.48400115966797,35.5004997253418,35.583499908447266,34234000.0,0.0,0.0,-0.6790008544921875,0.6790008544921875,0.0,45.93576418587732,33.66299819946289,37.59999847412109,48.780837566771815,-51.219162433228185,-0.48897887552844566,-0.42167425291506005,-0.0060890888454822045,1215219540.0,-1.0
771,2016-01-26,GOOG,35.692501068115234,35.91400146484375,35.32400131225586,35.652000427246094,26634000.0,0.0,0.0,0.06850051879882812,0.0,0.06850051879882812,46.89610748559853,33.66299819946289,37.35900115966797,53.814952238913804,-46.185047761086196,-0.46432228231491024,-0.4302038587950301,-0.017945946854728168,1241853540.0,1.0
772,2016-01-27,GOOG,35.68349838256836,35.91175079345703,34.71950149536133,34.9995002746582,43884000.0,0.0,0.0,-0.6525001525878906,0.6525001525878906,0.0,39.235985718169395,33.66299819946289,36.92499923706055,40.971847028583326,-59.02815297141668,-0.4917643108319467,-0.4425159492024134,-0.0008136234832363254,1197969540.0,-1.0
773,2016-01-28,GOOG,36.11100006103516,36.68450164794922,35.61750030517578,36.54800033569336,53528000.0,0.0,0.0,1.5485000610351562,0.0,1.5485000610351562,58.014962896914405,33.66299819946289,36.73699951171875,93.85168850540622,-6.14831149459378,-0.3841332535381312,-0.43083941006955695,0.022722192558521925,1251497540.0,1.0
774,2016-01-29,GOOG,36.57649993896485,37.2495002746582,36.34000015258789,37.147499084472656,69486000.0,0.0,0.0,0.5994987487792969,0.0,0.5994987487792969,63.108059745138725,33.66299819946289,37.2495002746582,97.15597013337872,-2.8440298666212853,-0.24760607765274756,-0.3941927435861951,0.06983941961889828,1320983540.0,1.0
775,2016-02-01,GOOG,37.52299880981445,37.89300155639648,37.16350173950195,37.59999847412109,102784000.0,0.0,0.0,0.4524993896484304,0.0,0.4524993896484304,66.63322330162737,33.66299819946289,37.89300155639648,93.07321868208174,-6.926781317918253,-0.10172180246969731,-0.33569855536289556,0.07154556252746347,1423767540.0,1.0
776,2016-02-02,GOOG,39.22499847412109,39.493499755859375,38.23249816894531,38.23249816894531,126962000.0,0.0,0.0,0.6324996948242259,0.0,0.6324996948242259,71.08880176350681,33.66299819946289,39.493499755859375,78.37233084123523,-21.627669158764775,0.06419003325763128,-0.25572083763879017,0.09478122988743287,1550729540.0,1.0
777,2016-02-03,GOOG,38.51100158691406,38.72499847412109,36.025001525878906,36.34749984741211,123420000.0,0.0,0.0,-1.8849983215332031,1.8849983215332031,0.0,48.718130719482495,33.66299819946289,39.493499755859375,46.0423794073792,-53.957620592620806,0.043076191915915274,-0.19596143172784905,0.028814492297938088,1427309540.0,-1.0
778,2016-02-04,GOOG,36.14049911499024,36.34999847412109,35.09299850463867,35.4005012512207,103374000.0,0.0,0.0,-0.9469985961914062,0.9469985961914062,0.0,41.202174687589306,33.66299819946289,39.493499755859375,29.80023304944744,-70.19976695055256,-0.04950093580486481,-0.16666933254325222,-0.02377109944385636,1323935540.0,-1.0
779,2016-02-05,GOOG,35.19350051879883,35.199501037597656,34.00749969482422,34.17850112915039,102114000.0,0.0,0.0,-1.2220001220703125,1.2220001220703125,0.0,33.5058399982333,33.66299819946289,39.493499755859375,8.841485157000871,-91.15851484299912,-0.21895025146858416,-0.17712551632831863,-0.039484558374296874,1221821540.0,-1.0
780,2016-02-08,GOOG,33.39250183105469,34.201499938964844,33.15299987792969,34.137001037597656,84948000.0,0.0,0.0,-0.041500091552734375,0.041500091552734375,0.0,33.26237152695482,33.15299987792969,39.493499755859375,15.519299402451322,-84.48070059754868,-0.35252507587064486,-0.2122054282367839,-0.0424940920984237,1136873540.0,-1.0
781,2016-02-09,GOOG,33.61600112915039,34.994998931884766,33.438499450683594,33.90549850463867,72178000.0,0.0,0.0,-0.23150253295898438,0.23150253295898438,0.0,31.776167826663638,33.15299987792969,39.493499755859375,11.868127769047316,-88.13187223095268,-0.47162777481633356,-0.26408989755269385,-0.03125763972154927,1064695540.0,-1.0
782,2016-02-10,GOOG,34.34299850463867,35.06549835205078,34.10649871826172,34.20600128173828,52760000.0,0.0,0.0,0.3005027770996094,0.0,0.3005027770996094,36.05543511708962,33.15299987792969,39.493499755859375,16.6075455260859,-83.3924544739141,-0.5355954481838907,-0.31839100767893325,-0.06408008734934378,1117455540.0,1.0
783,2016-02-11,GOOG,33.75,34.467498779296875,33.44340133666992,34.15549850463867,60480000.0,0.0,0.0,-0.050502777099609375,0.050502777099609375,0.0,35.622155581704206,33.15299987792969,39.493499755859375,15.811034555785247,-84.18896544421474,-0.5836376309250042,-0.3714403323281475,-0.08054379577559811,1056975540.0,-1.0
784,2016-02-12,GOOG,34.51300048828125,34.6875,33.93000030517578,34.119998931884766,42828000.0,0.0,0.0,-0.03549957275390625,0.03549957275390625,0.0,35.278311934551056,33.15299987792969,39.493499755859375,15.251148530434552,-84.74885146956545,-0.6174582513444236,-0.4206439161314028,-0.09255318307077853,1014147540.0,-1.0
785,2016-02-16,GOOG,34.64899826049805,34.900001525878906,34.252498626708984,34.54999923706055,50400000.0,0.0,0.0,0.43000030517578125,0.0,0.43000030517578125,42.97181143408986,33.15299987792969,39.493499755859375,22.032953016742432,-77.96704698325757,-0.602617308509771,-0.45703859460707646,-0.09631855380237508,1064547540.0,1.0
786,2016-02-17,GOOG,34.90449905395508,35.48749923706055,34.569000244140625,35.41999816894531,49852000.0,0.0,0.0,0.8699989318847656,0.0,0.8699989318847656,55.359739538054825,33.15299987792969,39.493499755859375,35.75425178867521,-64.24574821132478,-0.514720731283731,-0.4685750219424074,-0.025517619708658845,1114399540.0,1.0
787,2016-02-18,GOOG,35.5,35.61750030517578,34.80149841308594,34.86750030517578,37664000.0,0.0,0.0,-0.5524978637695312,0.5524978637695312,0.0,47.75796925870489,33.15299987792969,39.493499755859375,27.040461481814837,-72.95953851818517,-0.48406403191977176,-0.4716728239378803,-0.015056310707649678,1076735540.0,-1.0
788,2016-02-19,GOOG,34.75149917602539,35.154048919677734,34.70249938964844,35.045501708984375,31786000.0,0.0,0.0,0.17800140380859375,0.0,0.17800140380859375,50.29519888903927,33.15299987792969,39.493499755859375,29.84783325431797,-70.15216674568204,-0.4403293089584963,-0.4654041209420035,0.02536684029992564,1108521540.0,1.0
789,2016-02-22,GOOG,35.372501373291016,35.6619987487793,35.1254997253418,35.323001861572266,38996000.0,0.0,0.0,0.2775001525878906,0.0,0.2775001525878906,54.28867625993424,33.15299987792969,39.493499755859375,34.22446219415639,-65.77553780584361,-0.3789094504894166,-0.44810518685148615,0.03474238474165836,1147517540.0,1.0
790,2016-02-23,GOOG,35.0724983215332,35.41999816894531,34.67900085449219,34.79249954223633,40186000.0,0.0,0.0,-0.5305023193359375,0.5305023193359375,0.0,46.11580514176665,33.15299987792969,38.72499847412109,29.42390662889398,-70.57609337110603,-0.36878969567588626,-0.43224208861636626,0.026160979095361414,1107331540.0,-1.0
791,2016-02-24,GOOG,34.44599914550781,35.0,34.03900146484375,34.97800064086914,39272000.0,0.0,0.0,0.1855010986328125,0.0,0.1855010986328125,49.2013018438443,33.15299987792969,36.34999847412109,57.084815899312126,-42.91518410068788,-0.3418605728321751,-0.414165785459528,0.022569120335705906,1146603540.0,1.0
792,2016-02-25,GOOG,35.0004997253418,35.29899978637695,34.52925109863281,35.287498474121094,32844000.0,0.0,0.0,0.3094978332519531,0.0,0.3094978332519531,54.24512755491432,33.15299987792969,35.6619987487793,85.07371689125598,-14.926283108744007,-0.2921771243865834,-0.3897680532449391,0.03314253982645532,1179447540.0,1.0
793,2016-02-26,GOOG,35.42900085449219,35.67150115966797,35.042999267578125,35.253501892089844,44870000.0,0.0,0.0,-0.03399658203125,0.03399658203125,0.0,53.57096824829193,33.15299987792969,35.67150115966797,83.40285666681814,-16.597143333181865,-0.25263366990451175,-0.3623411765768537,0.03322107255829465,1134577540.0,-1.0
794,2016-02-29,GOOG,35.01599884033203,35.54449844360352,34.88399887084961,34.88850021362305,49622000.0,0.0,0.0,-0.3650016784667969,0.3650016784667969,0.0,46.42357191887767,33.438499450683594,35.67150115966797,64.93504940481884,-35.06495059518115,-0.24789025775317697,-0.3394509928121184,0.009797423561138663,1084955540.0,-1.0
795,2016-03-01,GOOG,35.180999755859375,35.94049835205078,34.98849868774414,35.94049835205078,43028000.0,0.0,0.0,1.0519981384277344,0.0,1.0519981384277344,62.88942060778069,33.44340133666992,35.94049835205078,100.0,-0.0,-0.15742886958050661,-0.30304656816579606,0.01469509345039488,1127983540.0,1.0
796,2016-03-02,GOOG,35.95000076293945,36.0,35.599998474121094,35.942501068115234,32580000.0,0.0,0.0,0.002002716064453125,0.0,0.002002716064453125,62.91445674518096,33.44340133666992,36.0,97.75095979241925,-2.249040207580756,-0.08460074059015454,-0.25935740265066776,0.030831024694359277,1160563540.0,1.0
797,2016-03-03,GOOG,35.93399810791016,35.97249984741211,35.30099868774414,35.62099838256836,39160000.0,0.0,0.0,-0.321502685546875,0.321502685546875,0.0,55.92578259426317,33.93000030517578,36.0,81.69074041994847,-18.309259580051528,-0.05222449204487134,-0.21793082052950846,0.01642141346307069,1121403540.0,-1.0
798,2016-03-04,GOOG,35.7495002746582,35.824501037597656,35.30099868774414,35.54449844360352,39442000.0,0.0,0.0,-0.07649993896483664,0.07649993896483664,0.0,54.270646437603666,34.03900146484375,36.0,76.77195835538024,-23.22804164461976,-0.03236589367702436,-0.18081783515901165,0.006270604715286732,1081961540.0,-1.0
799,2016-03-07,GOOG,35.345001220703125,35.40454864501953,34.345001220703125,34.757999420166016,59702000.0,0.0,0.0,-0.7864990234375071,0.7864990234375071,0.0,40.16833041901527,34.03900146484375,36.0,36.66488997478913,-63.335110025210874,-0.07917898350717678,-0.1604900648286447,-0.000991596537306294,1022259540.0,-1.0
800,2016-03-08,GOOG,34.429500579833984,35.18949890136719,34.266998291015625,34.69850158691406,41526000.0,0.0,0.0,-0.059497833251953125,0.059497833251953125,0.0,39.27744962280715,34.03900146484375,36.0,33.630831958666626,-66.36916804133337,-0.11969984704084169,-0.1523320212710841,-0.007990709841445454,980733540.0,-1.0
801,2016-03-09,GOOG,34.92350006103516,35.28400039672852,34.70000076293945,35.262001037597656,28430000.0,0.0,0.0,0.5634994506835938,0.0,0.5634994506835938,51.12355694901205,34.03900146484375,36.0,62.36616452426157,-37.63383547573843,-0.10513133839256739,-0.14289188469538078,-0.0007225628799427675,1009163540.0,1.0
802,2016-03-10,GOOG,35.40599822998047,35.821998596191406,35.167999267578125,35.64099884033203,56670000.0,0.0,0.0,0.378997802734375,0.0,0.378997802734375,57.550305780495826,34.03900146484375,36.0,81.69294095676804,-18.30705904323197,-0.062285743781714586,-0.12677065651264754,0.010991729259359984,1065833540.0,1.0
803,2016-03-11,GOOG,36.0,36.34600067138672,35.85625076293945,36.34099960327149,39416000.0,0.0,0.0,0.7000007629394602,0.0,0.7000007629394602,66.84191444209208,34.03900146484375,36.34600067138672,99.78322194038716,-0.21677805961283161,0.02783306777217831,-0.09584991165568237,0.041632611913804185,1105249540.0,1.0
804,2016-03-14,GOOG,36.34049987792969,36.775001525878906,36.25749969482422,36.52450180053711,34366000.0,0.0,0.0,0.1835021972656179,0.0,0.1835021972656179,68.90090678841288,34.03900146484375,36.775001525878906,90.84430848853778,-9.155691511462217,0.1127601402213756,-0.05412790128027077,0.016249175032738705,1139615540.0,1.0
805,2016-03-15,GOOG,36.34600067138672,36.61449813842773,36.23849868774414,36.416500091552734,34420000.0,0.0,0.0,-0.108001708984375,0.108001708984375,0.0,66.11293122580113,34.266998291015625,36.775001525878906,85.70570287379574,-14.294297126204258,0.16939790805921717,-0.00942273941237317,0.013187702840690374,1105195540.0,-1.0
806,2016-03-16,GOOG,36.31850051879883,36.87350082397461,36.22549819946289,36.804500579833984,32488000.0,0.0,0.0,0.38800048828125,0.0,0.38800048828125,70.98041750804222,34.266998291015625,36.87350082397461,97.35276512229997,-2.647234877700032,0.24279337300236392,0.04102048307057427,0.033224846326732616,1137683540.0,1.0
807,2016-03-17,GOOG,36.8224983215332,37.15349960327149,36.79999923706055,36.88899993896485,37216000.0,0.0,0.0,0.08449935913086648,0.0,0.08449935913086648,71.99137202496472,34.266998291015625,37.15349960327149,90.83666918204419,-9.163330817955808,0.3042707559739313,0.0936705376512457,0.037825867693549675,1174899540.0,1.0
808,2016-03-18,GOOG,37.09299850463867,37.09999847412109,36.59149932861328,36.880001068115234,59614000.0,0.0,0.0,-0.00899887084961648,0.00899887084961648,0.0,71.68450638223217,34.266998291015625,37.15349960327149,90.52491214900881,-9.475087850991198,0.3482514651177979,0.14458672314455617,0.0610507417960906,1115285540.0,-1.0
809,2016-03-21,GOOG,36.82500076293945,37.125,36.67580032348633,37.10449981689453,36730000.0,0.0,0.0,0.22449874877929688,0.0,0.22449874877929688,74.77909100988693,34.266998291015625,37.15349960327149,98.30245057679652,-1.697549423203476,0.396649340103302,0.19499924653630535,0.06934011902369441,1152015540.0,1.0
810,2016-03-22,GOOG,36.87300109863281,37.25,36.87300109863281,37.03749847412109,25394000.0,0.0,0.0,-0.0670013427734446,0.0670013427734446,0.0,72.06683208473596,34.266998291015625,37.25,92.87625195658154,-7.12374804341845,0.42470284626553934,0.24093996648215218,0.05035157915826516,1126621540.0,-1.0
811,2016-03-23,GOOG,37.11800003051758,37.2859992980957,36.807498931884766,36.90299987792969,28642000.0,0.0,0.0,-0.13449859619139914,0.13449859619139914,0.0,66.481678824463,34.266998291015625,37.2859992980957,87.31370346456275,-12.68629653543725,0.4311129377646594,0.2789745607386537,0.03540868883196269,1097979540.0,-1.0
812,2016-03-24,GOOG,36.60049819946289,36.88734817504883,36.54999923706055,36.76499938964844,31898000.0,0.0,0.0,-0.13800048828125,0.13800048828125,0.0,60.894547857673096,34.266998291015625,37.2859992980957,82.74263879921104,-17.257361200788967,0.4202135353125911,0.3072223556534412,0.011667257120213437,1066081540.0,-1.0
813,2016-03-28,GOOG,36.839500427246094,36.949501037597656,36.625,36.67649841308594,26026000.0,0.0,0.0,-0.0885009765625,0.0885009765625,0.0,57.329383995368,34.266998291015625,37.2859992980957,79.81117318012214,-20.188826819877864,0.39982545223761434,0.3257429749702758,0.004161497215729115,1040055540.0,-1.0
814,2016-03-29,GOOG,36.72949981689453,37.36249923706055,36.4379997253418,37.23849868774414,38076000.0,0.0,0.0,0.5620002746582031,0.0,0.5620002746582031,70.13911752142099,34.70000076293945,37.36249923706055,95.34269970399365,-4.657300296006349,0.424127398208725,0.3454198596179657,0.022572147079616744,1078131540.0,1.0
815,2016-03-30,GOOG,37.505001068115234,37.89400100708008,37.4370002746582,37.5265007019043,35648000.0,0.0,0.0,0.28800201416015625,0.0,0.28800201416015625,74.64061317607141,35.167999267578125,37.89400100708008,86.51870613835615,-13.481293861643845,0.4613085433531836,0.36859759636500933,0.01961716938677638,1113779540.0,1.0
816,2016-03-31,GOOG,37.462501525878906,37.54249954223633,37.047000885009766,37.247501373291016,34376000.0,0.0,0.0,-0.27899932861328125,0.27899932861328125,0.0,63.87708131066093,35.85625076293945,37.89400100708008,68.2738532041394,-31.726146795860604,0.4629256360601417,0.38746320430403586,0.009718383120153051,1079403540.0,-1.0
817,2016-04-01,GOOG,36.93000030517578,37.516998291015625,36.84999847412109,37.49549865722656,31534000.0,0.0,0.0,0.24799728393554688,0.0,0.24799728393554688,68.53133073241955,36.22549819946289,37.89400100708008,76.11617145417799,-23.883828545822016,0.4787003423289917,0.4057106319090271,0.01668919661836621,1110937540.0,1.0
818,2016-04-04,GOOG,37.50299835205078,37.63999938964844,37.12149810791016,37.26449966430664,22684000.0,0.0,0.0,-0.23099899291992188,0.23099899291992188,0.0,60.1956175482964,36.22549819946289,37.89400100708008,62.271484357138284,-37.728515642861716,0.4671768980351416,0.4180038851342501,0.0043121413360018845,1088253540.0,-1.0
819,2016-04-05,GOOG,36.900001525878906,37.13999938964844,36.76850128173828,36.88999938964844,22646000.0,0.0,0.0,-0.3745002746582031,0.3745002746582031,0.0,49.03789876146866,36.22549819946289,37.89400100708008,39.82619550604955,-60.173804493950456,0.4229499394500209,0.41899309599740425,-0.0039824256645115685,1065607540.0,-1.0
820,2016-04-06,GOOG,36.78850173950195,37.3120002746582,36.77799987792969,37.28450012207031,21074000.0,0.0,0.0,0.394500732421875,0.0,0.394500732421875,58.40834580951212,36.4379997253418,37.89400100708008,58.13871233120766,-41.86128766879234,0.4149493899887773,0.4181843547956789,0.010337919556745456,1086681540.0,1.0
821,2016-04-07,GOOG,37.26850128173828,37.34999847412109,36.81399917602539,37.01399993896485,29064000.0,0.0,0.0,-0.27050018310546164,0.27050018310546164,0.0,50.99061765020998,36.4379997253418,37.89400100708008,39.56041940673175,-60.439580593268246,0.3823740230692607,0.4110222884503953,0.006772760871757821,1057617540.0,-1.0
822,2016-04-08,GOOG,37.19850158691406,37.272499084472656,36.77750015258789,36.95750045776367,25816000.0,0.0,0.0,-0.05649948120117898,0.05649948120117898,0.0,49.476296481364514,36.4379997253418,37.89400100708008,35.67996394904659,-64.3200360509534,0.3479873921040877,0.3984153091811338,0.0076616377472249475,1031801540.0,-1.0
823,2016-04-11,GOOG,37.1510009765625,37.25,36.8025016784668,36.80500030517578,24402000.0,0.0,0.0,-0.15250015258789062,0.15250015258789062,0.0,45.2875835803176,36.4379997253418,37.89400100708008,25.20606159053872,-74.79393840946128,0.3049153768439652,0.3797153227137001,-0.011641134789116325,1007399540.0,-1.0
824,2016-04-12,GOOG,36.900001525878906,37.19150161743164,36.55049896240234,37.15449905395508,27060000.0,0.0,0.0,0.3494987487792969,0.0,0.3494987487792969,55.295768069393525,36.4379997253418,37.89400100708008,49.21007540308424,-50.78992459691576,0.295574918900698,0.3628872419510997,-0.009913038545860009,1034459540.0,1.0
825,2016-04-13,GOOG,37.45800018310547,37.71900177001953,37.21305084228516,37.58599853515625,34142000.0,0.0,0.0,0.4314994812011719,0.0,0.4314994812011719,64.53695894213529,36.4379997253418,37.89400100708008,78.84600269334157,-21.15399730665842,0.3193101321873968,0.35417181999835917,0.009087781713807974,1068601540.0,1.0
826,2016-04-14,GOOG,37.70050048828125,37.865501403808594,37.635250091552734,37.65999984741211,22706000.0,0.0,0.0,0.07400131225585938,0.0,0.07400131225585938,65.93059970873117,36.4379997253418,37.89400100708008,83.92850592901945,-16.071494070980556,0.34017047369240316,0.351371550737168,0.0043872250290459824,1091307540.0,1.0
827,2016-04-15,GOOG,37.69900131225586,38.04999923706055,37.63470077514648,37.95000076293945,36186000.0,0.0,0.0,0.29000091552734375,0.0,0.29000091552734375,71.071193004924,36.4379997253418,38.04999923706055,93.79661883306198,-6.203381166938018,0.3757714356692503,0.35625152772358454,0.018395553537766007,1127493540.0,1.0
828,2016-04-18,GOOG,38.02299880981445,38.40250015258789,37.8650016784668,38.33050155639648,31176000.0,0.0,0.0,0.38050079345702414,0.0,0.38050079345702414,76.45058290136893,36.55049896240234,38.40250015258789,96.1123893130868,-3.887610686913205,0.4297349713323655,0.37094821644534076,0.03904858201630268,1158669540.0,1.0
829,2016-04-19,GOOG,38.47549819946289,38.494998931884766,37.46649932861328,37.69649887084961,40610000.0,0.0,0.0,-0.6340026855468679,0.6340026855468679,0.0,56.31685038321327,36.55049896240234,38.494998931884766,58.935455203545494,-41.064544796454506,0.4165411172774185,0.38006679661175635,0.01105013470558558,1118059540.0,-1.0
830,2016-04-20,GOOG,37.900001525878906,37.90660095214844,37.5004997253418,37.63349914550781,30584000.0,0.0,0.0,-0.06299972534179688,0.06299972534179688,0.0,54.666189862591345,36.55049896240234,38.494998931884766,55.695561846356824,-44.30443815364317,0.39643152569966844,0.3833397424293388,0.016736888949167916,1087475540.0,-1.0
831,2016-04-21,GOOG,37.76900100708008,38.022499084472656,37.477500915527344,37.95700073242188,61210000.0,0.0,0.0,0.3235015869140696,0.0,0.3235015869140696,61.37405325600597,36.55049896240234,38.494998931884766,72.33231124163589,-27.667688758364108,0.401964803896,0.3870647547226711,0.027044585328503956,1148685540.0,1.0
832,2016-04-22,GOOG,36.31499862670898,36.805999755859375,35.68050003051758,35.938499450683594,119038000.0,0.0,0.0,-2.0185012817382884,2.0185012817382884,0.0,29.717106362273896,35.68050003051758,38.494998931884766,9.166797686106337,-90.83320231389365,0.24069915261319608,0.35779163430077615,-0.023543019896954953,1029647540.0,-1.0
833,2016-04-25,GOOG,35.80500030517578,36.19649887084961,35.77949905395508,36.157501220703125,39184000.0,0.0,0.0,0.21900177001953125,0.0,0.21900177001953125,33.98020052010375,35.68050003051758,38.494998931884766,16.94799702902126,-83.05200297097875,0.12907863650870866,0.3120490347423627,-0.026833838663902654,1068831540.0,1.0
834,2016-04-26,GOOG,36.27099990844727,36.28829956054688,35.15129852294922,35.40700149536133,54892000.0,0.0,0.0,-0.7504997253417969,0.7504997253417969,0.0,27.406869017340867,35.15129852294922,38.494998931884766,7.647305115278296,-92.35269488472171,-0.019713240369746643,0.2456965797199408,-0.05797363711800252,1013939540.0,-1.0
835,2016-04-27,GOOG,35.364498138427734,35.44900131225586,34.61825180053711,35.29199981689453,61972000.0,0.0,0.0,-0.11500167846679688,0.11500167846679688,0.0,26.500479492559364,34.61825180053711,38.494998931884766,17.37920977381906,-82.62079022618094,-0.14523734343860184,0.16750979508823227,-0.06287838662007594,951967540.0,-1.0
836,2016-04-28,GOOG,35.41299819946289,35.708499908447266,34.477500915527344,34.55099868774414,57346000.0,0.0,0.0,-0.7410011291503906,0.7410011291503906,0.0,21.270540945081365,34.477500915527344,38.494998931884766,1.8294414065059255,-98.17055859349408,-0.3010385132004032,0.07380013343050516,-0.08956527027305494,894621540.0,-1.0
837,2016-04-29,GOOG,34.53499984741211,34.88100051879883,34.45000076293945,34.6505012512207,49754000.0,0.0,0.0,0.0995025634765625,0.0,0.0995025634765625,23.606486128429324,34.45000076293945,38.494998931884766,4.956751026998072,-95.04324897300192,-0.41173679198772106,-0.023307251653140112,-0.096007100240035,944375540.0,1.0
838,2016-05-02,GOOG,34.881500244140625,35.03200149536133,34.54999923706055,34.910499572753906,32906000.0,0.0,0.0,0.2599983215332031,0.0,0.2599983215332031,29.879212537729117,34.45000076293945,38.494998931884766,11.384400946083073,-88.61559905391692,-0.47303344867043506,-0.11325249105659912,-0.07390604914373344,977281540.0,1.0
839,2016-05-03,GOOG,34.84349822998047,34.891998291015625,34.599998474121094,34.61800003051758,30876000.0,0.0,0.0,-0.2924995422363281,0.2924995422363281,0.0,27.001243138865277,34.45000076293945,38.494998931884766,4.153259422165052,-95.84674057783495,-0.5390004970342019,-0.19840209225211972,-0.08012805568068426,946405540.0,-1.0
840,2016-05-04,GOOG,34.52450180053711,34.98749923706055,34.45050048828125,34.78499984741211,33870000.0,0.0,0.0,0.16699981689453125,0.0,0.16699981689453125,31.35689023991776,34.45000076293945,38.494998931884766,8.281810534416225,-91.71818946558378,-0.5712197034126945,-0.27296561448423473,-0.08356826998452305,980275540.0,1.0
841,2016-05-05,GOOG,34.8849983215332,35.11600112915039,34.7859992980957,35.07149887084961,33670000.0,0.0,0.0,0.2864990234375,0.0,0.2864990234375,38.60799375383053,34.45000076293945,38.494998931884766,15.36460789232458,-84.63539210767543,-0.5670984221710569,-0.3317921760215992,-0.024124562602390265,1013945540.0,1.0
842,2016-05-06,GOOG,34.91899871826172,35.59299850463867,34.90534973144531,35.555999755859375,36586000.0,0.0,0.0,0.4845008850097656,0.0,0.4845008850097656,49.09971421689532,34.45000076293945,38.494998931884766,27.34238550244631,-72.6576144975537,-0.5187571947909788,-0.36918517977547516,-0.016635592741108485,1050531540.0,1.0
843,2016-05-09,GOOG,35.599998474121094,35.93550109863281,35.5,35.64500045776367,30206000.0,0.0,0.0,0.08900070190429688,0.0,0.08900070190429688,50.87901241299739,34.45000076293945,38.022499084472656,33.449972183929894,-66.55002781607011,-0.4678714797995127,-0.38892243978028274,0.006721805076702836,1080737540.0,1.0
844,2016-05-10,GOOG,35.837501525878906,36.17499923706055,35.7859992980957,36.15900039672852,31392000.0,0.0,0.0,0.5139999389648509,0.0,0.5139999389648509,60.15950080064094,34.45000076293945,38.022499084472656,47.837660930114055,-52.162339069885945,-0.38166904152923564,-0.38747176013007334,0.024566490545513187,1112129540.0,1.0
845,2016-05-11,GOOG,36.170501708984375,36.2239990234375,35.63999938964844,35.76449966430664,33842000.0,0.0,0.0,-0.3945007324218821,0.3945007324218821,0.0,51.53662094225642,34.45000076293945,36.805999755859375,55.793695384311484,-44.206304615688516,-0.3412521578180332,-0.3782278396676654,0.035122023173036476,1078287540.0,-1.0
846,2016-05-12,GOOG,35.85300064086914,35.962501525878906,35.45000076293945,35.66550064086914,27214000.0,0.0,0.0,-0.0989990234375,0.0989990234375,0.0,49.48293256786561,34.45000076293945,36.28829956054688,66.12090915316254,-33.87909084683746,-0.3135949527023598,-0.3653012622746043,0.02929248792938255,1051073540.0,-1.0
847,2016-05-13,GOOG,35.59650039672852,35.833099365234375,35.4630012512207,35.541500091552734,26290000.0,0.0,0.0,-0.12400054931640625,0.12400054931640625,0.0,46.78831806258569,34.45000076293945,36.28829956054688,59.37551229614482,-40.62448770385519,-0.29824425231272755,-0.35188986028222896,0.01807480633394598,1024783540.0,-1.0
848,2016-05-16,GOOG,35.45650100708008,35.92399978637695,35.282501220703125,35.824501037597656,26342000.0,0.0,0.0,0.2830009460449219,0.0,0.2830009460449219,53.46194098825204,34.45000076293945,36.2239990234375,77.48036203103798,-22.519637968962012,-0.2602429813564413,-0.3335604844970715,0.034851840256990174,1051125540.0,1.0
849,2016-05-17,GOOG,35.79949951171875,36.07600021362305,35.205501556396484,35.311500549316406,40024000.0,0.0,0.0,-0.51300048828125,0.51300048828125,0.0,42.35210846792201,34.45000076293945,36.2239990234375,48.56260603858138,-51.43739396141862,-0.2684272897139053,-0.3205338455404383,0.015135854656140424,1011101540.0,-1.0
850,2016-05-18,GOOG,35.18349838256836,35.58000183105469,35.03150177001953,35.33150100708008,35336000.0,0.0,0.0,0.020000457763671875,0.0,0.020000457763671875,42.886027280731625,34.45000076293945,36.2239990234375,49.69002866401602,-50.30997133598398,-0.2701850185516932,-0.3104640801426893,0.007413488005971081,1046437540.0,1.0
851,2016-05-19,GOOG,35.11800003051758,35.29999923706055,34.84000015258789,35.01599884033203,33404000.0,0.0,0.0,-0.3155021667480469,0.3155021667480469,0.0,36.69931314579777,34.45050048828125,36.2239990234375,31.886034346284887,-68.11396565371511,-0.29365138899365917,-0.3071015419128833,-0.015187336011789565,1013033540.0,-1.0
852,2016-05-20,GOOG,35.08100128173828,35.729000091552734,35.0260009765625,35.48699951171875,36568000.0,0.0,0.0,0.47100067138671875,0.0,0.47100067138671875,49.29825857125171,34.45050048828125,36.2239990234375,58.443748494338706,-41.55625150566129,-0.27111756425502165,-0.299904746381311,-0.0044326257263522795,1049601540.0,1.0
853,2016-05-23,GOOG,35.326499938964844,35.57389831542969,35.20899963378906,35.21200180053711,26614000.0,0.0,0.0,-0.2749977111816406,0.2749977111816406,0.0,43.469620593813005,34.45050048828125,36.2239990234375,42.93780328320198,-57.06219671679802,-0.272310338764818,-0.2943858648580124,-0.026189844459226008,1022987540.0,-1.0
854,2016-05-24,GOOG,35.34299850463867,36.04850006103516,35.34299850463867,36.00450134277344,38590000.0,0.0,0.0,0.7924995422363281,0.0,0.7924995422363281,59.42248826965477,34.7859992980957,36.2239990234375,84.73590246257591,-15.264097537424098,-0.2069222602819636,-0.2768931439428026,0.006710611939758859,1061577540.0,1.0
855,2016-05-25,GOOG,36.03799819946289,36.3754997253418,35.98524856567383,36.26350021362305,32584000.0,0.0,0.0,0.2589988708496094,0.0,0.2589988708496094,63.32523980165422,34.84000015258789,36.3754997253418,92.70598874098806,-7.29401125901193,-0.13267331724008358,-0.2480491786022588,0.01676689130976783,1094161540.0,1.0
856,2016-05-26,GOOG,36.14350128173828,36.416500091552734,36.013999938964844,36.20600128173828,31526000.0,0.0,0.0,-0.057498931884765625,0.057498931884765625,0.0,61.80258332893586,34.84000015258789,36.416500091552734,86.64771214944226,-13.352287850557747,-0.07757593116400585,-0.21395452911460822,0.018696486880796614,1062635540.0,-1.0
857,2016-05-27,GOOG,36.20050048828125,36.6968002319336,36.20000076293945,36.632999420166016,39500000.0,0.0,0.0,0.4269981384277344,0.0,0.4269981384277344,68.32808025464135,34.84000015258789,36.6968002319336,96.56393747085217,-3.4360625291478355,0.0005381223162075344,-0.17105599882844505,0.0225683082569621,1102135540.0,1.0
858,2016-05-31,GOOG,36.58700180053711,36.98649978637695,36.5629997253418,36.7859992980957,42590000.0,0.0,0.0,0.1529998779296875,0.0,0.1529998779296875,70.41750802268474,34.84000015258789,36.98649978637695,90.65918833038323,-9.340811669616771,0.07393757758636355,-0.12205728354548333,0.04175689862627041,1144725540.0,1.0
859,2016-06-01,GOOG,36.72650146484375,36.86050033569336,36.53300094604492,36.70750045776367,25072000.0,0.0,0.0,-0.07849884033203125,0.07849884033203125,0.0,67.770743601482,34.84000015258789,36.98649978637695,87.00212549671934,-12.997874503280658,0.12433966408109143,-0.07277789402016836,0.03894540032159566,1119653540.0,-1.0
860,2016-06-02,GOOG,36.625,36.6510009765625,36.20849990844727,36.52000045776367,26836000.0,0.0,0.0,-0.1875,0.1875,0.0,61.40931274571509,34.84000015258789,36.98649978637695,78.26697376184485,-21.733026238155155,0.14745423710025563,-0.028731467796083553,0.042951841079549746,1092817540.0,-1.0
861,2016-06-03,GOOG,36.4635009765625,36.4744987487793,36.02799987792969,36.117000579833984,24526000.0,0.0,0.0,-0.4029998779296875,0.4029998779296875,0.0,49.8132839945008,34.84000015258789,36.98649978637695,59.49222665330234,-40.50777334669766,0.1317354167294269,0.0033619091090185474,0.01775301030754073,1068291540.0,-1.0
862,2016-06-06,GOOG,36.24549865722656,36.24549865722656,35.730499267578125,35.82749938964844,31306000.0,0.0,0.0,-0.2895011901855469,0.2895011901855469,0.0,43.071720729818445,34.84000015258789,36.98649978637695,46.00509692691561,-53.99490307308439,0.09482473127616942,0.02165447354244873,0.017479767057774653,1036985540.0,-1.0
863,2016-06-07,GOOG,35.992000579833984,36.0989990234375,35.82749938964844,35.83250045776367,26724000.0,0.0,0.0,0.005001068115234375,0.0,0.005001068115234375,43.22487667140734,34.84000015258789,36.98649978637695,46.238084067305024,-53.76191593269497,0.06522442495843706,0.030368463825646397,-0.004777205032567067,1063709540.0,1.0
864,2016-06-08,GOOG,36.198001861572266,36.42850112915039,36.02899932861328,36.41400146484375,31674000.0,0.0,0.0,0.5815010070800781,0.0,0.5815010070800781,58.28258271217021,34.84000015258789,36.98649978637695,73.32874823171468,-26.671251768285316,0.08767754820924978,0.04183028070236708,0.004150213033328853,1095383540.0,1.0
865,2016-06-09,GOOG,36.14350128173828,36.47700119018555,36.116798400878906,36.42900085449219,19778000.0,0.0,0.0,0.0149993896484375,0.0,0.0149993896484375,58.60930179661006,35.0260009765625,36.98649978637695,71.5634139080386,-28.436586091961402,0.10546638470865588,0.054557501503624845,0.006159188114109204,1115161540.0,1.0
866,2016-06-10,GOOG,35.9734992980957,36.29449844360352,35.82149887084961,35.97050094604492,24328000.0,0.0,0.0,-0.4584999084472656,0.4584999084472656,0.0,45.923781039740916,35.20899963378906,36.98649978637695,42.84113906528658,-57.15886093471342,0.08162611992796798,0.05997122518849347,-0.01808474557386086,1090833540.0,-1.0
867,2016-06-13,GOOG,35.82550048828125,36.27199935913086,35.82550048828125,35.917999267578125,25178000.0,0.0,0.0,-0.052501678466796875,0.052501678466796875,0.0,44.647001567737284,35.34299850463867,36.98649978637695,34.986328841270655,-65.01367115872935,0.0578294695249113,0.05954287405577704,-0.023595934515295625,1065655540.0,-1.0
868,2016-06-14,GOOG,35.82400131225586,36.12350082397461,35.65599822998047,35.91350173950195,26122000.0,0.0,0.0,-0.004497528076171875,0.004497528076171875,0.0,44.52464499005881,35.65599822998047,36.98649978637695,19.353867591023647,-80.64613240897636,0.03816756774407537,0.055267812793436705,-0.02163042180372121,1039533540.0,-1.0
869,2016-06-15,GOOG,35.95000076293945,36.14899826049805,35.865501403808594,35.94599914550781,24290000.0,0.0,0.0,0.032497406005859375,0.0,0.032497406005859375,45.763859585773815,35.65599822998047,36.98649978637695,21.79636048775313,-78.20363951224687,0.024920371469036695,0.04919832452855671,-0.015717450850519787,1063823540.0,1.0
870,2016-06-16,GOOG,35.74549865722656,35.83250045776367,35.16299819946289,35.518001556396484,39650000.0,0.0,0.0,-0.4279975891113281,0.4279975891113281,0.0,34.16593514342095,35.16299819946289,36.98649978637695,19.46822308690013,-80.53177691309988,-0.019884736669510517,0.03538171228894326,-0.016584960373812185,1024173540.0,-1.0
871,2016-06-17,GOOG,35.432498931884766,35.441001892089844,34.42259979248047,34.58599853515625,68048000.0,0.0,0.0,-0.9320030212402344,0.9320030212402344,0.0,20.87401868811466,34.42259979248047,36.98649978637695,6.373054450827318,-93.62694554917267,-0.12910966654457923,0.002483436522238753,-0.03465217711652213,956125540.0,-1.0
872,2016-06-20,GOOG,34.938499450683594,35.124000549316406,34.670501708984375,34.68550109863281,41650000.0,0.0,0.0,0.0995025634765625,0.0,0.0995025634765625,24.49268211228535,34.42259979248047,36.86050033569336,10.783922538770515,-89.21607746122947,-0.20527589239107868,-0.03906842926042475,-0.03201002845120582,997775540.0,1.0
873,2016-06-21,GOOG,34.91999816894531,35.13850021362305,34.60049819946289,34.797000885009766,29312000.0,0.0,0.0,0.11149978637695312,0.0,0.11149978637695312,28.70824946862271,34.42259979248047,36.6510009765625,16.801332507078513,-83.19866749292149,-0.25371638959811094,-0.08199802132796201,-0.044406011830233294,1027087540.0,1.0
874,2016-06-22,GOOG,34.952999114990234,35.042999267578125,34.65409851074219,34.87300109863281,23686000.0,0.0,0.0,0.07600021362304688,0.0,0.07600021362304688,31.70694395286216,34.42259979248047,36.47700119018555,21.92372467500636,-78.07627532499365,-0.28271429612830445,-0.12214127628803051,-0.04271321527797267,1050773540.0,1.0
875,2016-06-23,GOOG,34.872501373291016,35.09749984741211,34.349998474121094,35.09349822998047,43428000.0,0.0,0.0,0.22049713134765625,0.0,0.22049713134765625,40.136268303392114,34.349998474121094,36.47700119018555,34.955280040030054,-65.04471995996994,-0.28462212357433003,-0.15463744574529042,-0.024381164926780996,1094201540.0,1.0
876,2016-06-24,GOOG,33.75849914550781,34.470001220703125,33.67250061035156,33.76100158691406,88980000.0,0.0,0.0,-1.3324966430664062,1.3324966430664062,0.0,21.571083780169616,33.67250061035156,36.47700119018555,3.155676885890996,-96.844323114109,-0.3891693317202538,-0.20154382294028314,-0.06005339174365165,1005221540.0,-1.0
877,2016-06-27,GOOG,33.54999923706055,33.6150016784668,33.16419982910156,33.41299819946289,52580000.0,0.0,0.0,-0.3480033874511719,0.3480033874511719,0.0,18.93215545161094,33.16419982910156,36.47700119018555,7.510210943644342,-92.48978905635565,-0.49440551337802674,-0.26011616102783186,-0.06962572344452589,952641540.0,-1.0
878,2016-06-28,GOOG,33.94850158691406,34.01649856567383,33.650001525878906,34.00199890136719,43476000.0,0.0,0.0,0.5890007019042969,0.0,0.5890007019042969,34.56523170577816,33.16419982910156,36.47700119018555,25.289746681083468,-74.71025331891653,-0.5242354514095311,-0.31294001910417174,-0.05408112975998802,996117540.0,1.0
879,2016-06-29,GOOG,34.150001525878906,34.3714485168457,34.070499420166016,34.205501556396484,38652000.0,0.0,0.0,0.20350265502929688,0.0,0.20350265502929688,39.23655957029514,33.16419982910156,36.29449844360352,33.26525215424523,-66.73474784575477,-0.5253984622705161,-0.35543170773744065,-0.036953092586472724,1034769540.0,1.0
880,2016-06-30,GOOG,34.27349853515625,34.61600112915039,34.182498931884766,34.60499954223633,31954000.0,0.0,0.0,0.39949798583984375,0.0,0.39949798583984375,47.6946163138999,33.16419982910156,36.27199935913086,46.360767456618525,-53.639232543381475,-0.48845342105733636,-0.38203605040141986,0.0005493843718511471,1066723540.0,1.0
881,2016-07-01,GOOG,34.61000061035156,35.032501220703125,34.60649871826172,34.96049880981445,26894000.0,0.0,0.0,0.355499267578125,0.0,0.355499267578125,54.23540192380942,33.16419982910156,36.14899826049805,60.181584183976675,-39.818415816023325,-0.4255825392623436,-0.3907453481736047,0.00792831882115963,1093617540.0,1.0
882,2016-07-05,GOOG,34.803001403808594,34.84700012207031,34.444000244140625,34.747501373291016,29252000.0,0.0,0.0,-0.2129974365234375,0.2129974365234375,0.0,49.919813226883754,33.16419982910156,36.14899826049805,53.04550979171753,-46.95449020828248,-0.3884660309204193,-0.39028948472296765,-0.0014225223570940582,1064365540.0,-1.0
883,2016-07-06,GOOG,34.499000549316406,35.08399963378906,34.454498291015625,34.88850021362305,28238000.0,0.0,0.0,0.14099884033203125,0.0,0.14099884033203125,52.78919079797928,33.16419982910156,35.83250045776367,64.62166841320467,-35.37833158679531,-0.343711411413274,-0.38097387006102895,0.00044444454167846814,1092603540.0,1.0
884,2016-07-07,GOOG,34.90399932861328,34.90999984741211,34.41075134277344,34.768001556396484,26084000.0,0.0,0.0,-0.1204986572265625,0.1204986572265625,0.0,49.96618035938594,33.16419982910156,35.441001892089844,70.4409818212281,-29.559018178771883,-0.31434274016605457,-0.3676476440820341,-0.0092751275877625,1066519540.0,-1.0
885,2016-07-08,GOOG,34.974998474121094,35.285499572753906,34.82175064086914,35.28150177001953,31504000.0,0.0,0.0,0.5135002136230469,0.0,0.5135002136230469,60.383384552410554,33.16419982910156,35.285499572753906,99.8115399416637,-0.1884600583363005,-0.24678786399768882,-0.3434756880651651,0.04503717637615412,1098023540.0,1.0
886,2016-07-11,GOOG,35.40250015258789,35.82550048828125,35.36199951171875,35.75450134277344,22236000.0,0.0,0.0,0.47299957275390625,0.0,0.47299957275390625,67.56157943758481,33.16419982910156,35.82550048828125,97.33216368233654,-2.66783631766345,-0.1533156975036789,-0.30544368995286786,0.07007761259054535,1120259540.0,1.0
887,2016-07-12,GOOG,35.95600128173828,36.14699935913086,35.795501708984375,36.03200149536133,26738000.0,0.0,0.0,0.2775001525878906,0.0,0.2775001525878906,71.10564148672361,33.16419982910156,36.14699935913086,96.14463316720445,-3.8553668327955566,-0.056198566881661804,-0.2555946653386266,0.05970244866729035,1146997540.0,1.0
888,2016-07-13,GOOG,36.180999755859375,36.20000076293945,35.842498779296875,35.8489990234375,18718000.0,0.0,0.0,-0.18300247192382812,0.18300247192382812,0.0,65.64800290615901,33.16419982910156,36.20000076293945,88.43791977301314,-11.562080226986858,0.00593230484117413,-0.20328927130266647,0.048047752328124416,1128279540.0,-1.0
889,2016-07-14,GOOG,36.07899856567383,36.11050033569336,35.9015007019043,36.04750061035156,19004000.0,0.0,0.0,0.1985015869140625,0.0,0.1985015869140625,68.65873535765044,33.16419982910156,36.20000076293945,94.97660894401602,-5.023391055983977,0.0703776180548843,-0.14855589343115633,0.04168475905785307,1147283540.0,1.0
890,2016-07-15,GOOG,36.2864990234375,36.2869987487793,35.95275115966797,35.99250030517578,25586000.0,0.0,0.0,-0.05500030517578125,0.05500030517578125,0.0,66.78734924150288,33.16419982910156,36.2869987487793,90.56940740731693,-9.430592592683078,0.11567944744697911,-0.09570882525552923,0.029519072395832513,1121697540.0,-1.0
891,2016-07-18,GOOG,36.135501861572266,36.80649948120117,36.05950164794922,36.68899917602539,25910000.0,0.0,0.0,0.6964988708496094,0.0,0.6964988708496094,76.24722110218636,33.650001525878906,36.80649948120117,96.27751049299238,-3.722489507007615,0.20541521290802933,-0.03548401762281751,0.05587445790351775,1147607540.0,1.0
892,2016-07-19,GOOG,36.49449920654297,36.8494987487793,36.45000076293945,36.84799957275391,24550000.0,0.0,0.0,0.15900039672852273,0.0,0.15900039672852273,77.90491056449711,34.070499420166016,36.8494987487793,99.94605338655725,-0.05394661344274622,0.28606389028283274,0.02882556395831256,0.05616462006485823,1172157540.0,1.0
893,2016-07-20,GOOG,36.86650085449219,37.10649871826172,36.85499954223633,37.05950164794922,25794000.0,0.0,0.0,0.2115020751953054,0.0,0.2115020751953054,80.04265527841818,34.182498931884766,37.10649871826172,98.3927129361821,-1.6072870638179069,0.36286214903612546,0.09563288097387516,0.06590830617157373,1197951540.0,1.0
894,2016-07-21,GOOG,37.01800155639648,37.08449935913086,36.79154968261719,36.93149948120117,20526000.0,0.0,0.0,-0.12800216674804688,0.12800216674804688,0.0,74.97696613646852,34.41075134277344,37.10649871826172,93.50832208345008,-6.491677916549922,0.40868554474001684,0.15824341372710352,0.04676665188282114,1177425540.0,-1.0
895,2016-07-22,GOOG,37.09299850463867,37.1619987487793,36.82799911499024,37.137001037597656,25196000.0,0.0,0.0,0.20550155639648438,0.0,0.20550155639648438,77.60274173085597,34.41075134277344,37.1619987487793,99.09140446158816,-0.9085955384118365,0.4563229670155522,0.2178593243847933,0.03866645157683468,1202621540.0,1.0
896,2016-07-25,GOOG,37.03350067138672,37.13050079345703,36.875,36.98849868774414,20648000.0,0.0,0.0,-0.14850234985351562,0.14850234985351562,0.0,71.35916411276504,34.41075134277344,37.1619987487793,93.69376739233219,-6.306232607667808,0.4765991307244093,0.2696072856527165,0.026545769113213158,1181973540.0,-1.0
897,2016-07-26,GOOG,36.95199966430664,37.08449935913086,36.7135009765625,36.92100143432617,23734000.0,0.0,0.0,-0.06749725341796875,0.06749725341796875,0.0,68.47009416452994,34.41075134277344,37.1619987487793,91.24043465058658,-8.759565349413426,0.4816692885629763,0.3120196862347685,0.029903273176130174,1158239540.0,-1.0
898,2016-07-27,GOOG,36.91400146484375,37.22299957275391,36.84999847412109,37.0885009765625,30250000.0,0.0,0.0,0.16749954223632812,0.0,0.16749954223632812,71.74554217807868,34.82175064086914,37.22299957275391,94.39880662077614,-5.601193379223852,0.4935143125913868,0.34831861150609217,0.028878572677296876,1188489540.0,1.0
899,2016-07-28,GOOG,37.35200119018555,37.432498931884766,36.96500015258789,37.295501708984375,70604000.0,0.0,0.0,0.207000732421875,0.0,0.207000732421875,75.39097141435164,35.36199951171875,37.432498931884766,93.3833730371484,-6.6166269628516,0.5136833862815848,0.38139156646119077,0.03620202522082683,1259093540.0,1.0
900,2016-07-29,GOOG,38.635501861572266,38.9275016784668,38.3385009765625,38.43949890136719,76830000.0,0.0,0.0,1.1439971923828125,0.0,1.1439971923828125,86.49888249650468,35.795501708984375,38.9275016784668,84.41881283989112,-15.581187160108886,0.6148904606587848,0.42809134530070964,0.04771184182330246,1335923540.0,1.0
901,2016-08-01,GOOG,38.054500579833984,39.02149963378906,38.054500579833984,38.64400100708008,54010000.0,0.0,0.0,0.20450210571289062,0.0,0.20450210571289062,87.64880272688161,35.842498779296875,39.02149963378906,88.12524299339059,-11.87475700660942,0.7034900121432699,0.4831710786692217,0.048740812395529964,1389933540.0,1.0
902,2016-08-02,GOOG,38.43450164794922,38.79199981689453,38.39250183105469,38.55350112915039,35690000.0,0.0,0.0,-0.0904998779296875,0.0904998779296875,0.0,83.99577027317801,35.9015007019043,39.02149963378906,85.00004279309294,-14.99995720690705,0.7576692714812481,0.5380707172316271,0.04031353404030047,1354243540.0,-1.0
903,2016-08-03,GOOG,38.35900115966797,38.66049957275391,38.34099960327149,38.65900039672852,25748000.0,0.0,0.0,0.1054992675781321,0.0,0.1054992675781321,84.84534753746786,35.95275115966797,39.02149963378906,88.1873916967287,-11.812608303271304,0.7998988974761403,0.5904363532805298,0.04677581305375056,1379991540.0,1.0
904,2016-08-04,GOOG,38.61100006103516,38.70349884033203,38.43975067138672,38.58050155639648,22806000.0,0.0,0.0,-0.07849884033204546,0.07849884033204546,0.0,81.14704433173299,36.05950164794922,39.02149963378906,85.11146599353461,-14.888534006465395,0.8176071140840975,0.6358705054412433,0.03886960385781868,1357185540.0,-1.0
905,2016-08-05,GOOG,38.68899917602539,39.152000427246094,38.617000579833984,39.11100006103516,36024000.0,0.0,0.0,0.5304985046386861,0.0,0.5304985046386861,85.92951552037977,36.45000076293945,39.152000427246094,98.48259173557479,-1.51740826442521,0.864482582006417,0.6815929207542781,0.05738273919169079,1393209540.0,1.0
906,2016-08-08,GOOG,39.09999847412109,39.13150024414063,38.90454864501953,39.0880012512207,22158000.0,0.0,0.0,-0.02299880981446023,0.02299880981446023,0.0,84.85278231120049,36.7135009765625,39.152000427246094,97.37546891768011,-2.624531082319887,0.8895220597152758,0.7231787485464778,0.0586928775685871,1371051540.0,-1.0
907,2016-08-09,GOOG,39.05500030517578,39.446998596191406,39.02849960327149,39.2130012512207,26378000.0,0.0,0.0,0.125,0.0,0.125,85.95634840647129,36.7135009765625,39.446998596191406,91.4396360439315,-8.560363956068493,0.9089743905730359,0.7603378769517894,0.057281912687728864,1397429540.0,1.0
908,2016-08-10,GOOG,39.1875,39.340599060058594,39.13890075683594,39.23400115966797,15728000.0,0.0,0.0,0.020999908447265625,0.0,0.020999908447265625,86.15192202786886,36.7135009765625,39.446998596191406,92.207879202311,-7.792120797688991,0.9155313445904625,0.7913765704795241,0.05197676293000808,1413157540.0,1.0
909,2016-08-11,GOOG,39.25,39.48749923706055,39.14849853515625,39.24250030517578,19502000.0,0.0,0.0,0.0084991455078125,0.0,0.0084991455078125,86.24139879487419,36.7135009765625,39.48749923706055,91.16802143052612,-8.831978569473877,0.9109131481535613,0.8152838860143317,0.020890007069785943,1432659540.0,1.0
910,2016-08-12,GOOG,39.07500076293945,39.16975021362305,39.02000045776367,39.1609992980957,14810000.0,0.0,0.0,-0.08150100708007812,0.08150100708007812,0.0,80.4872202976339,36.7135009765625,39.48749923706055,88.2299876097895,-11.770012390210496,0.8904126216264814,0.8303096331367618,0.013378487670593575,1417849540.0,-1.0
911,2016-08-15,GOOG,39.1875,39.3745002746582,39.00550079345703,39.12200164794922,18764000.0,0.0,0.0,-0.038997650146484375,0.038997650146484375,0.0,77.6276082777246,36.84999847412109,39.48749923706055,86.14227551145859,-13.857724488541411,0.8610928795023938,0.8364662824098882,0.014745755953380346,1399085540.0,-1.0
912,2016-08-16,GOOG,39.01499938964844,39.04899978637695,38.67219924926758,38.85699844360352,20560000.0,0.0,0.0,-0.265003204345696,0.265003204345696,0.0,60.71420235740895,36.96500015258789,39.48749923706055,75.0049148743761,-24.99508512562391,0.8071686905456659,0.8306067640370437,0.005121654591248914,1378525540.0,-1.0
913,2016-08-17,GOOG,38.86600112915039,39.04050064086914,38.67649841308594,38.99549865722656,18484000.0,0.0,0.0,0.13850021362303977,0.0,0.13850021362303977,65.27651829108979,38.054500579833984,39.48749923706055,65.66636141961176,-34.33363858038823,0.7667703408481188,0.8178394793992587,0.010756653855923837,1397009540.0,1.0
914,2016-08-18,GOOG,39.0004997253418,39.14300155639648,38.84999847412109,38.875,14388000.0,0.0,0.0,-0.1204986572265625,0.1204986572265625,0.0,58.46104491867868,38.054500579833984,39.48749923706055,57.257514934034695,-42.742485065965305,0.7167686601285723,0.7976253155451215,-0.0060341096025893215,1382621540.0,-1.0
915,2016-08-19,GOOG,38.75,38.85499954223633,38.65650177001953,38.77099990844727,17230000.0,0.0,0.0,-0.10400009155272727,0.10400009155272727,0.0,52.95493469411983,38.34099960327149,39.48749923706055,37.50548997165202,-62.49451002834798,0.6611289467329371,0.7703260417826847,-0.008109939946431277,1365391540.0,-1.0
916,2016-08-22,GOOG,38.66350173950195,38.72700119018555,38.50249862670898,38.60749816894531,19028000.0,0.0,0.0,-0.16350173950196023,0.16350173950196023,0.0,45.22777157460176,38.34099960327149,39.48749923706055,23.24453997364766,-76.75546002635234,0.5969594718703064,0.7356527278002092,-0.015441385840277655,1346363540.0,-1.0
917,2016-08-23,GOOG,38.77399826049805,38.821998596191406,38.58924865722656,38.604000091552734,18564000.0,0.0,0.0,-0.003498077392578125,0.003498077392578125,0.0,45.065436573199904,38.43975067138672,39.48749923706055,15.676415654206458,-84.32358434579355,0.5396022364238746,0.6964426295249423,-0.016057527896565116,1327799540.0,-1.0
918,2016-08-24,GOOG,38.52899932861328,38.72499847412109,38.35350036621094,38.48199844360352,21440000.0,0.0,0.0,-0.12200164794921164,0.12200164794921164,0.0,39.37767664223474,38.35350036621094,39.48749923706055,11.331411405754972,-88.66858859424502,0.47878259301634074,0.652910622223222,-0.019379546554324834,1306359540.0,-1.0
919,2016-08-25,GOOG,38.34999847412109,38.59450149536133,38.15924835205078,38.47050094604492,18538000.0,0.0,0.0,-0.011497497558600855,0.011497497558600855,0.0,38.844570683976855,38.15924835205078,39.48749923706055,23.43326833106926,-76.56673166893073,0.42475848406826344,0.6072801945922304,-0.017632296530399327,1287821540.0,-1.0
920,2016-08-26,GOOG,38.45000076293945,38.80400085449219,38.29249954223633,38.47700119018555,23334000.0,0.0,0.0,0.006500244140625,0.0,0.006500244140625,39.379940711920696,38.15924835205078,39.48749923706055,23.922652092374058,-76.07734790762595,0.37810988845271254,0.5614461333643268,-0.016486898179901344,1311155540.0,1.0
921,2016-08-29,GOOG,38.4370002746582,38.7495002746582,38.33074951171875,38.60749816894531,16952000.0,0.0,0.0,0.13049697875976562,0.0,0.13049697875976562,49.6002905724994,38.15924835205078,39.48749923706055,33.74737573701941,-66.25262426298059,0.3476629142566594,0.5186894895427934,-0.006420986814520191,1328107540.0,1.0
922,2016-08-30,GOOG,38.46649932861328,38.72330093383789,38.34199905395508,38.454498291015625,22600000.0,0.0,0.0,-0.1529998779296875,0.1529998779296875,0.0,40.388472224541374,38.15924835205078,39.48749923706055,22.22847673560353,-77.77152326439646,0.3076413582937789,0.47647986329299047,-0.013873405517041193,1305507540.0,-1.0
923,2016-08-31,GOOG,38.35049819946289,38.454498291015625,38.26900100708008,38.352500915527344,24972000.0,0.0,0.0,-0.10199737548828125,0.10199737548828125,0.0,35.339862296784815,38.15924835205078,39.3745002746582,15.902263545646026,-84.09773645435398,0.2646430111808371,0.4341124928705598,-0.013440490918910752,1280535540.0,-1.0
924,2016-09-01,GOOG,38.462501525878906,38.55099868774414,38.21500015258789,38.43899917602539,18502000.0,0.0,0.0,0.08649826049804688,0.0,0.08649826049804688,42.3868323953793,38.15924835205078,39.3745002746582,23.019986125541873,-76.98001387445814,0.23483911885367093,0.394257818067182,-0.00856312019823735,1299037540.0,1.0
925,2016-09-02,GOOG,38.6505012512207,38.69599914550781,38.420501708984375,38.573001861572266,21454000.0,0.0,0.0,0.134002685546875,0.0,0.134002685546875,51.78063310949135,38.15924835205078,39.14300155639648,42.05866956201438,-57.94133043798561,0.21950193460845213,0.35930664137543605,-0.0008935131518258421,1320491540.0,1.0
926,2016-09-06,GOOG,38.67250061035156,39.09999847412109,38.54999923706055,39.00400161743164,28856000.0,0.0,0.0,0.430999755859375,0.0,0.430999755859375,69.95875327013376,38.15924835205078,39.14300155639648,85.87044612908917,-14.129553870910833,0.2393659225235325,0.3353184976050554,0.01036166005932726,1349347540.0,1.0
927,2016-09-07,GOOG,39.0,39.13650131225586,38.810001373291016,39.01750183105469,17874000.0,0.0,0.0,0.013500213623046875,0.0,0.013500213623046875,70.36256561793999,38.15924835205078,39.14300155639648,87.24276324718446,-12.757236752815547,0.25327799935544704,0.31891039795513376,0.013915685492164931,1367221540.0,1.0
928,2016-09-08,GOOG,38.929500579833984,39.01750183105469,38.67900085449219,38.76599884033203,25406000.0,0.0,0.0,-0.25150299072265625,0.25150299072265625,0.0,54.589357173653546,38.15924835205078,39.13650131225586,62.087352301692945,-37.912647698307055,0.24122849904524202,0.30337401817315546,0.0076811553533329135,1341815540.0,-1.0
929,2016-09-09,GOOG,38.505001068115234,38.66225051879883,37.983001708984375,37.983001708984375,37710000.0,0.0,0.0,-0.7829971313476562,0.7829971313476562,0.0,30.23883262737833,37.983001708984375,39.13650131225586,0.0,-100.0,0.1665776550018805,0.2760147455389005,-0.012838824906322932,1304105540.0,-1.0
930,2016-09-12,GOOG,37.75650024414063,38.51449966430664,37.70000076293945,38.45100021362305,26220000.0,0.0,0.0,0.4679985046386719,0.0,0.4679985046386719,46.65079446293036,37.70000076293945,39.13650131225586,52.27978861831798,-47.72021138168203,0.14352541966839993,0.24951688036480038,-0.004053563756901135,1330325540.0,1.0
931,2016-09-13,GOOG,38.2239990234375,38.31100082397461,37.790000915527344,37.984500885009766,27900000.0,0.0,0.0,-0.46649932861328125,0.46649932861328125,0.0,36.71604144594333,37.70000076293945,39.13650131225586,19.80508272034416,-80.19491727965584,0.08661531255572186,0.21693656680298468,-0.012222169756292645,1302425540.0,-1.0
932,2016-09-14,GOOG,37.980499267578125,38.38399887084961,37.95550155639648,38.1245002746582,21748000.0,0.0,0.0,0.1399993896484375,0.0,0.1399993896484375,41.062287715850104,37.70000076293945,39.13650131225586,29.550946703136205,-70.4490532968638,0.05220859518804133,0.18399097247999602,-0.005944870228184573,1324173540.0,1.0
933,2016-09-15,GOOG,38.14450073242188,38.68999862670898,37.99800109863281,38.5880012512207,26102000.0,0.0,0.0,0.4635009765625,0.0,0.4635009765625,53.3113854142112,37.70000076293945,39.13650131225586,61.816926467854586,-38.183073532145414,0.06163123247262092,0.159519024478521,0.003876325564903027,1350275540.0,1.0
934,2016-09-16,GOOG,38.48749923706055,38.48749923706055,38.233001708984375,38.44400024414063,40986000.0,0.0,0.0,-0.14400100708007102,0.14400100708007102,0.0,49.61492589997624,37.70000076293945,39.13650131225586,51.79249541917886,-48.20750458082113,0.05682403054990459,0.13898002569279774,-0.003344349965153981,1309289540.0,-1.0
935,2016-09-19,GOOG,38.62099838256836,38.70000076293945,38.222049713134766,38.28499984741211,23456000.0,0.0,0.0,-0.15900039672852273,0.15900039672852273,0.0,45.587800020436866,37.70000076293945,39.13650131225586,40.72390259447115,-59.27609740552885,0.039726344625833576,0.1191292894794049,-0.01843405138456855,1285833540.0,-1.0
936,2016-09-20,GOOG,38.45000076293945,38.666500091552734,38.42649841308594,38.570499420166016,19572000.0,0.0,0.0,0.28549957275390625,0.0,0.28549957275390625,53.420829631621594,37.70000076293945,39.13650131225586,60.59856069256712,-39.40143930743288,0.04865289456740385,0.10503401049700471,-0.011456459022522458,1305405540.0,1.0
937,2016-09-21,GOOG,38.632999420166016,38.858001708984375,38.4150505065918,38.81100082397461,23356000.0,0.0,0.0,0.24050140380859375,0.0,0.24050140380859375,59.13836988346515,37.70000076293945,39.13650131225586,77.34073346257004,-22.65926653742996,0.07427747850557864,0.0988827040987195,0.001160862224340642,1328761540.0,1.0
938,2016-09-22,GOOG,39.0,39.49250030517578,38.922000885009766,39.36050033569336,29724000.0,0.0,0.0,0.54949951171875,0.0,0.54949951171875,69.12852903494401,37.70000076293945,39.49250030517578,92.63598308551096,-7.364016914489044,0.1373419713748163,0.10657455755393887,0.03626618657637981,1358485540.0,1.0
939,2016-09-23,GOOG,39.329498291015625,39.44649887084961,39.20750045776367,39.345001220703125,28238000.0,0.0,0.0,-0.015499114990234375,0.015499114990234375,0.0,68.58282198288106,37.70000076293945,39.49250030517578,91.77131815115357,-8.228681848846438,0.18394992702670976,0.12204963144849305,0.0232503966636306,1330247540.0,-1.0
940,2016-09-26,GOOG,39.137001037597656,39.137001037597656,38.65349960327149,38.71049880981445,30664000.0,0.0,0.0,-0.6345024108886719,0.6345024108886719,0.0,49.95520564451751,37.70000076293945,39.49250030517578,56.3736850729847,-43.6263149270153,0.16775425919560405,0.13119055699791526,0.019113004196172012,1299583540.0,-1.0
941,2016-09-27,GOOG,38.775001525878906,39.29949951171875,38.71540069580078,39.1505012512207,23064000.0,0.0,0.0,0.44000244140625,0.0,0.44000244140625,58.88957016026431,37.70000076293945,39.49250030517578,80.92054999755264,-19.079450002447366,0.18825352605895773,0.14260315081012376,0.026911853773057715,1322647540.0,1.0
942,2016-09-28,GOOG,38.89250183105469,39.09049987792969,38.74850082397461,39.07799911499024,22196000.0,0.0,0.0,-0.07250213623046164,0.07250213623046164,0.0,56.956310319689315,37.70000076293945,39.49250030517578,76.87579938411551,-23.124200615884497,0.19638521970206568,0.15335956458851216,0.012698192388340912,1300451540.0,-1.0
943,2016-09-29,GOOG,39.071998596191406,39.290000915527344,38.71160125732422,38.7504997253418,26294000.0,0.0,0.0,-0.3274993896484446,0.3274993896484446,0.0,48.63472764929641,37.70000076293945,39.49250030517578,58.60525694147392,-41.39474305852609,0.17439288911200634,0.157566229493211,0.007972621976243932,1274157540.0,-1.0
944,2016-09-30,GOOG,38.81650161743164,39.047000885009766,38.704498291015625,38.86449813842773,31706000.0,0.0,0.0,0.1139984130859304,0.0,0.1139984130859304,51.48184011823095,37.790000915527344,39.49250030517578,63.112928523414325,-36.887071476585675,0.1642689378233868,0.15890677115924617,0.015136431848641774,1305863540.0,1.0
945,2016-10-03,GOOG,38.712501525878906,38.80324935913086,38.47499847412109,38.62799835205078,25576000.0,0.0,0.0,-0.23649978637694602,0.23649978637694602,0.0,45.451238943847216,37.95550155639648,39.49250030517578,43.753893501110916,-56.246106498889084,0.1355989766432799,0.15424521225605292,0.0014907489596751589,1280287540.0,-1.0
946,2016-10-04,GOOG,38.80149841308594,38.93550109863281,38.64450073242188,38.82149887084961,24028000.0,0.0,0.0,0.19350051879882812,0.0,0.19350051879882812,50.882966326942906,37.99800109863281,39.49250030517578,55.10192100547765,-44.89807899452235,0.12702740768391863,0.14880165134162607,0.00027049152694136325,1304315540.0,1.0
947,2016-10-05,GOOG,38.96549987792969,39.10350036621094,38.782501220703125,38.82350158691406,29224000.0,0.0,0.0,0.002002716064453125,0.0,0.002002716064453125,50.94130468776874,38.222049713134766,39.49250030517578,47.34161859951177,-52.65838140048823,0.11902394601795407,0.14284611027689167,-0.013643087465845305,1333539540.0,1.0
948,2016-10-06,GOOG,38.95000076293945,39.02399826049805,38.777000427246094,38.84299850463867,21414000.0,0.0,0.0,0.019496917724609375,0.0,0.019496917724609375,51.58722149358607,38.222049713134766,39.49250030517578,48.876264483952426,-51.123735516047574,0.11295233904951374,0.1368673560314161,-0.01275899607293196,1354953540.0,1.0
949,2016-10-07,GOOG,38.983001708984375,38.983001708984375,38.53749847412109,38.75400161743164,18664000.0,0.0,0.0,-0.08899688720703125,0.08899688720703125,0.0,48.24187192117213,38.4150505065918,39.49250030517578,31.458645338771525,-68.54135466122848,0.09980870909419792,0.12945562664397245,0.0011237986839414127,1336289540.0,-1.0
950,2016-10-10,GOOG,38.885501861572266,39.46900177001953,38.79349899291992,39.297000885009766,23498000.0,0.0,0.0,0.542999267578125,0.0,0.542999267578125,64.46483138620022,38.4150505065918,39.49250030517578,81.85535693422129,-18.144643065778713,0.1316897530204031,0.1299024519192586,0.003741960616264084,1359787540.0,1.0
951,2016-10-11,GOOG,39.33300018310547,39.61399841308594,39.02899932861328,39.15349960327149,27450000.0,0.0,0.0,-0.14350128173827414,0.14350128173827414,0.0,58.84095604284342,38.47499847412109,39.61399841308594,59.569900395872025,-40.430099604127975,0.14371964526812064,0.132665890589031,0.0019320459079565921,1332337540.0,-1.0
952,2016-10-12,GOOG,39.1879997253418,39.40650177001953,39.10300064086914,39.30699920654297,18748000.0,0.0,0.0,0.15349960327147727,0.0,0.15349960327147727,62.84192702767487,38.47499847412109,39.61399841308594,73.04660026391427,-26.953399736085732,0.16375192640388292,0.1388830977520014,0.014361091731605047,1351085540.0,1.0
953,2016-10-13,GOOG,39.06100082397461,39.06100082397461,38.650001525878906,38.90950012207031,27306000.0,0.0,0.0,-0.39749908447265625,0.39749908447265625,0.0,48.697545115876004,38.47499847412109,39.61399841308594,38.14764453316046,-61.85235546683955,0.14587128606623168,0.14028073541484745,0.0011579201018445673,1323779540.0,-1.0
954,2016-10-14,GOOG,39.08250045776367,39.1974983215332,38.79999923706055,38.92649841308594,17050000.0,0.0,0.0,0.016998291015625,0.0,0.016998291015625,49.261043975582545,38.47499847412109,39.61399841308594,39.64003188403893,-60.359968115961074,0.13155587555717574,0.13853576344331311,0.007727557051097067,1340829540.0,1.0
955,2016-10-17,GOOG,38.9900016784668,39.29249954223633,38.875,38.99800109863281,21860000.0,0.0,0.0,0.071502685546875,0.0,0.071502685546875,51.82910090439692,38.47499847412109,39.61399841308594,45.91770434922434,-54.08229565077567,0.12454480377110855,0.1357375715088722,0.00454650729407402,1362689540.0,1.0
956,2016-10-18,GOOG,39.39250183105469,40.08050155639648,39.27825164794922,39.76300048828125,41138000.0,0.0,0.0,0.7649993896484375,0.0,0.7649993896484375,70.35295034125852,38.47499847412109,40.08050155639648,80.22420064960258,-19.77579935039742,0.1786580771440569,0.14432167263590914,0.024199231469730575,1403827540.0,1.0
957,2016-10-19,GOOG,39.9119987487793,40.22999954223633,39.9015007019043,40.07500076293945,35336000.0,0.0,0.0,0.3120002746582031,0.0,0.3120002746582031,74.89585585645867,38.47499847412109,40.22999954223633,91.16816609899082,-8.831833901009174,0.24390743771218837,0.16423882565116502,0.03171748592358692,1439163540.0,1.0
958,2016-10-20,GOOG,40.165000915527344,40.19850158691406,39.80149841308594,39.8484992980957,35150000.0,0.0,0.0,-0.22650146484375,0.22650146484375,0.0,66.37608694989879,38.47499847412109,40.22999954223633,78.26210758091835,-21.737892419081646,0.2741806667428506,0.18622719386950215,0.028242184935342474,1404013540.0,-1.0
959,2016-10-21,GOOG,39.75,39.97499847412109,39.70000076293945,39.96849822998047,25324000.0,0.0,0.0,0.11999893188476562,0.0,0.11999893188476562,68.56221802123997,38.53749847412109,40.22999954223633,84.54941523038059,-15.450584769619413,0.3043470069400982,0.20985115648362138,0.017087750460540896,1429337540.0,1.0
960,2016-10-24,GOOG,40.244998931884766,40.75899887084961,40.24100112915039,40.65549850463867,33950000.0,0.0,0.0,0.6870002746582031,0.0,0.6870002746582031,78.00772902002363,38.53749847412109,40.75899887084961,95.34097016757879,-4.659029832421214,0.3793167027147817,0.24374426572985347,0.03836180460460503,1463287540.0,1.0
961,2016-10-25,GOOG,40.83399963378906,40.83399963378906,40.25699996948242,40.38349914550781,31528000.0,0.0,0.0,-0.2719993591308594,0.2719993591308594,0.0,68.59291592965936,38.53749847412109,40.83399963378906,80.38318045759739,-19.61681954240261,0.4120329918074219,0.2774020109453672,0.027386978418481034,1431759540.0,-1.0
962,2016-10-26,GOOG,40.31700134277344,40.3489990234375,39.81600189208984,39.95349884033203,32954000.0,0.0,0.0,-0.43000030517578125,0.43000030517578125,0.0,56.21669234288946,38.53749847412109,40.83399963378906,61.65903118532139,-38.34096881467861,0.3986678607200105,0.30165518090029586,0.02683146056840613,1398805540.0,-1.0
963,2016-10-27,GOOG,40.04999923706055,40.17449951171875,39.57500076293945,39.76750183105469,54984000.0,0.0,0.0,-0.18599700927734375,0.18599700927734375,0.0,51.57248065687257,38.650001525878906,40.83399963378906,51.167640719483266,-48.83235928051673,0.3688160124246238,0.31508734720516146,0.021604908025480984,1343821540.0,-1.0
964,2016-10-28,GOOG,40.41749954223633,40.77450180053711,39.679500579833984,39.76850128173828,85398000.0,0.0,0.0,0.00099945068359375,0.0,0.00099945068359375,51.59727313061987,38.650001525878906,40.83399963378906,51.21340315306661,-48.78659684693339,0.34130450897223596,0.32033077955857636,0.019757427596269306,1429219540.0,1.0
965,2016-10-31,GOOG,39.77349853515625,39.84299850463867,39.20000076293945,39.22700119018555,48546000.0,0.0,0.0,-0.5415000915527344,0.5415000915527344,0.0,39.08747444501058,38.650001525878906,40.83399963378906,26.41942143708015,-73.58057856291985,0.2726638136765871,0.3107973863821785,-0.01347985040147237,1380673540.0,-1.0
966,2016-11-01,GOOG,39.14450073242188,39.4744987487793,38.777000427246094,39.18050003051758,48128000.0,0.0,0.0,-0.04650115966796875,0.04650115966796875,0.0,38.170484859479274,38.650001525878906,40.83399963378906,24.290245615015667,-75.70975438498434,0.21206871700504593,0.291051652506752,-0.02232066663487353,1332545540.0,-1.0
967,2016-11-02,GOOG,38.90999984741211,39.08250045776367,38.17250061035156,38.435001373291016,37448000.0,0.0,0.0,-0.7454986572265625,0.7454986572265625,0.0,26.61878289074471,38.17250061035156,40.83399963378906,9.86289157455396,-90.13710842544604,0.10270721029553442,0.2533827640645085,-0.03547179817816215,1295097540.0,-1.0
968,2016-11-03,GOOG,38.36249923706055,38.497501373291016,37.95149993896485,38.10649871826172,38864000.0,0.0,0.0,-0.3285026550292969,0.3285026550292969,0.0,23.06910482687205,37.95149993896485,40.83399963378906,5.377234890091478,-94.62276510990853,-0.010350674397109572,0.20063607637218486,-0.04658667686248119,1256233540.0,-1.0
969,2016-11-04,GOOG,37.53300094604492,38.51800155639648,37.52804946899414,38.10100173950195,42696000.0,0.0,0.0,-0.005496978759765625,0.005496978759765625,0.0,23.009860354326122,37.52804946899414,40.83399963378906,17.33094093822659,-82.66905906177341,-0.09924933820954607,0.14065899345583868,-0.06283274979017306,1213537540.0,-1.0
970,2016-11-07,GOOG,38.72499847412109,39.259498596191406,38.62749862670898,39.1259994506836,31702000.0,0.0,0.0,1.0249977111816477,0.0,1.0249977111816477,50.41021011187076,37.52804946899414,40.83399963378906,48.33557379981213,-51.664426200187876,-0.08600204271807854,0.09532678622105523,-0.03113894836832365,1245239540.0,1.0
971,2016-11-08,GOOG,39.16999816894531,39.78165054321289,39.009498596191406,39.5255012512207,27338000.0,0.0,0.0,0.39950180053710227,0.0,0.39950180053710227,57.252146928577424,37.52804946899414,40.83399963378906,60.419899957883075,-39.580100042116925,-0.042773937743533,0.06770664142813758,-0.01071239319544337,1272577540.0,1.0
972,2016-11-09,GOOG,38.99700164794922,39.56135177612305,38.58349990844727,39.26549911499024,52142000.0,0.0,0.0,-0.26000213623046164,0.26000213623046164,0.0,51.87725360181738,37.52804946899414,40.83399963378906,52.55522797948407,-47.44477202051592,-0.02915922320073605,0.04833346850236285,-0.012623441075004349,1220435540.0,-1.0
973,2016-11-10,GOOG,39.55849838256836,39.55849838256836,37.60900115966797,38.12799835205078,94904000.0,0.0,0.0,-1.1375007629394602,1.1375007629394602,0.0,35.196902064422886,37.52804946899414,40.83399963378906,18.147547698858226,-81.85245230114178,-0.10890092681962926,0.016886589437964422,-0.041251313899546393,1125531540.0,-1.0
974,2016-11-11,GOOG,37.82699966430664,38.03900146484375,37.51900100708008,37.70100021362305,48636000.0,0.0,0.0,-0.4269981384277344,0.4269981384277344,0.0,30.89432093328662,37.51900100708008,40.83399963378906,5.490174417467293,-94.5098255825327,-0.20419811389624698,-0.027330351228877874,-0.03890180055222525,1076895540.0,-1.0
975,2016-11-14,GOOG,37.77999877929688,37.89250183105469,36.37699890136719,36.80400085449219,73088000.0,0.0,0.0,-0.8969993591308594,0.8969993591308594,0.0,23.832605527012717,36.37699890136719,40.77450180053711,9.710100548327128,-90.28989945167287,-0.348089612603232,-0.09148220350374872,-0.060655151776377036,1003807540.0,-1.0
976,2016-11-15,GOOG,37.3484992980957,38.22079849243164,37.3484992980957,37.92449951171875,47680000.0,0.0,0.0,1.1204986572265625,0.0,1.1204986572265625,42.707889450774644,36.37699890136719,40.77450180053711,35.19043979808792,-64.80956020191208,-0.3674737758273494,-0.1466805179684689,-0.013282212653360825,1051487540.0,1.0
977,2016-11-16,GOOG,37.7599983215332,38.31800079345703,37.5255012512207,38.2239990234375,29452000.0,0.0,0.0,0.29949951171875,0.0,0.29949951171875,46.77575498142217,36.37699890136719,40.77450180053711,42.00111209520646,-57.99888790479355,-0.3545813640187916,-0.18826068717853345,0.003083471563328777,1080939540.0,1.0
978,2016-11-17,GOOG,38.34600067138672,38.6349983215332,38.21149826049805,38.561500549316406,26080000.0,0.0,0.0,0.33750152587890625,0.0,0.33750152587890625,51.274160715782486,36.37699890136719,39.84299850463867,63.0265983264197,-36.973401673580305,-0.31351645966540787,-0.21331184167590836,0.012086265158142151,1107019540.0,1.0
979,2016-11-18,GOOG,38.56850051879883,38.75,38.0,38.027000427246094,30942000.0,0.0,0.0,-0.5345001220703125,0.5345001220703125,0.0,44.414619976698795,36.37699890136719,39.78165054321289,48.46315275252127,-51.53684724747873,-0.32040845078258684,-0.23473116349724407,-0.028088714380900104,1076077540.0,-1.0
980,2016-11-21,GOOG,38.13050079345703,38.48500061035156,38.02999877929688,38.459999084472656,26612000.0,0.0,0.0,0.4329986572265625,0.0,0.4329986572265625,50.59296198480133,36.37699890136719,39.78165054321289,61.1810076985218,-38.8189923014782,-0.2876155771408335,-0.24530804622596197,-0.02695733470844064,1102689540.0,1.0
981,2016-11-22,GOOG,38.63150024414063,38.84799957275391,38.34999847412109,38.41350173950195,31862000.0,0.0,0.0,-0.046497344970703125,0.046497344970703125,0.0,49.90565518572143,36.37699890136719,39.78165054321289,59.815307184577414,-40.18469281542259,-0.2623546742893694,-0.2487173718386435,-0.02169837120860696,1070827540.0,-1.0
982,2016-11-23,GOOG,38.38650131225586,38.41415023803711,37.76250076293945,38.04949951171875,29568000.0,0.0,0.0,-0.3640022277832031,0.3640022277832031,0.0,44.45101609894256,36.37699890136719,39.78165054321289,49.12398642478675,-50.87601357521325,-0.2686107865304521,-0.25269605477700524,-0.002058824059086972,1041259540.0,-1.0
983,2016-11-25,GOOG,38.2130012512207,38.25,38.0260009765625,38.08399963378906,11748000.0,0.0,0.0,0.0345001220703125,0.0,0.0345001220703125,45.10715605797842,36.37699890136719,39.78165054321289,50.13730953973573,-49.86269046026426,-0.2676990608957084,-0.25569665600074587,0.010158866289908586,1053007540.0,1.0
984,2016-11-28,GOOG,38.0,38.97650146484375,37.9900016784668,38.4119987487793,43764000.0,0.0,0.0,0.3279991149902344,0.0,0.3279991149902344,51.40397314928862,36.37699890136719,39.78165054321289,59.77116197147592,-40.22883802852408,-0.2377688728248799,-0.2521110993655727,0.04369084493407294,1096771540.0,1.0
985,2016-11-29,GOOG,38.57649993896485,38.92499923706055,38.4119987487793,38.54199981689453,32332000.0,0.0,0.0,0.13000106811523438,0.0,0.13000106811523438,53.82624401357736,36.37699890136719,39.56135177612305,67.98872488945912,-32.011275110540886,-0.2012392229160369,-0.24193672407566552,0.016282358716031897,1129103540.0,1.0
986,2016-11-30,GOOG,38.50350189208984,38.64950180053711,37.74150085449219,37.902000427246094,47858000.0,0.0,0.0,-0.6399993896484375,0.6399993896484375,0.0,41.94882050731586,36.37699890136719,39.55849838256836,47.93342054241491,-52.06657945758509,-0.22137988472105263,-0.237825356204743,-0.008423990278829008,1081245540.0,-1.0
987,2016-12-01,GOOG,37.87200164794922,37.99250030517578,36.85124969482422,37.39599990844727,60358000.0,0.0,0.0,-0.506000518798821,0.506000518798821,0.0,34.91947108440722,36.37699890136719,38.97650146484375,39.19984620893307,-60.80015379106693,-0.2750014715696665,-0.24526057927772768,-0.030224462851972556,1020887540.0,-1.0
988,2016-12-02,GOOG,37.22949981689453,37.70000076293945,37.15499877929688,37.525001525878906,29050000.0,0.0,0.0,0.12900161743163352,0.0,0.12900161743163352,37.97679653704733,36.37699890136719,38.97650146484375,44.16239632310212,-55.837603676897885,-0.30358803911668275,-0.2569260712455187,-0.013201117514583416,1049937540.0,1.0
989,2016-12-05,GOOG,37.885501861572266,38.19499969482422,37.64500045776367,38.1259994506836,27884000.0,0.0,0.0,0.6009979248046946,0.0,0.6009979248046946,50.481739193710894,36.85124969482422,38.97650146484375,59.98111724182529,-40.01888275817472,-0.27458237536863095,-0.26045733207014116,-0.008684338058757235,1077821540.0,1.0
990,2016-12-06,GOOG,38.23649978637695,38.44150161743164,37.867000579833984,37.95550155639648,33814000.0,0.0,0.0,-0.17049789428712359,0.17049789428712359,0.0,47.356379835914225,36.85124969482422,38.97650146484375,51.95863742591356,-48.04136257408644,-0.26232896798358496,-0.2608316592528299,-0.011922895918507148,1044007540.0,-1.0
991,2016-12-07,GOOG,38.04999923706055,38.56800079345703,37.790000915527344,38.55950164794922,35220000.0,0.0,0.0,0.6040000915527415,0.0,0.6040000915527415,57.98810642803674,36.85124969482422,38.97650146484375,80.37880392445462,-19.62119607554539,-0.20155687263800104,-0.24897670192986415,0.01340364900393487,1079227540.0,1.0
992,2016-12-08,GOOG,38.624000549316406,38.90900039672852,38.36149978637695,38.82099914550781,29762000.0,0.0,0.0,0.26149749755859375,0.0,0.26149749755859375,61.8381521564973,36.85124969482422,38.97650146484375,92.68311070106728,-7.316889298932729,-0.13078626397069115,-0.2253386143380296,0.019351946192775138,1108989540.0,1.0
993,2016-12-09,GOOG,39.0,39.47150039672852,38.9510498046875,39.464500427246094,36438000.0,0.0,0.0,0.6435012817382812,0.0,0.6435012817382812,69.71785805025257,36.85124969482422,39.47150039672852,99.73285115514551,-0.2671488448544887,-0.022515328563088133,-0.1847739571830413,0.02740033616449722,1145427540.0,1.0
994,2016-12-12,GOOG,39.25199890136719,39.5625,39.217750549316406,39.4635009765625,42082000.0,0.0,0.0,-0.00099945068359375,0.00099945068359375,0.0,69.69206968371252,36.85124969482422,39.5625,96.34858414774502,-3.65141585225498,0.062489184064268954,-0.13532132893357926,0.02390901261080991,1103345540.0,-1.0
995,2016-12-13,GOOG,39.69499969482422,40.21900177001953,39.66699981689453,39.80500030517578,42904000.0,0.0,0.0,0.34149932861328125,0.0,0.34149932861328125,73.54943788568224,36.85124969482422,40.21900177001953,87.70689006791748,-12.293109932082515,0.1556181454244836,-0.07713343406196667,0.05020842848605178,1146249540.0,1.0
996,2016-12-14,GOOG,39.869998931884766,40.20000076293945,39.70050048828125,39.85350036621094,34084000.0,0.0,0.0,0.04850006103515625,0.0,0.04850006103515625,74.08982562818233,36.85124969482422,40.21900177001953,89.14702164388403,-10.852978356115973,0.23067795596963236,-0.015571156055646846,0.06571559695636187,1180333540.0,1.0
997,2016-12-15,GOOG,39.867000579833984,40.150001525878906,39.64599990844727,39.89250183105469,32530000.0,0.0,0.0,0.03900146484375,0.0,0.03900146484375,74.57185314945156,36.85124969482422,40.21900177001953,90.30510763040928,-9.694892369590729,0.2899679191937352,0.04553665899422959,0.06309127805212866,1212863540.0,1.0
998,2016-12-16,GOOG,40.02000045776367,40.04280090332031,39.51449966430664,39.540000915527344,48876000.0,0.0,0.0,-0.35250091552734375,0.35250091552734375,0.0,62.45485735559369,36.85124969482422,40.21900177001953,79.83815793646838,-20.16184206353162,0.3049959607182018,0.09742851933902405,0.0370875907573982,1163987540.0,-1.0
999,2016-12-19,GOOG,39.51100158691406,39.882999420166016,39.3134994506836,39.709999084472656,24642000.0,0.0,0.0,0.1699981689453125,0.0,0.1699981689453125,65.56809960681524,36.85124969482422,40.21900177001953,84.88598108822023,-15.114018911779764,0.32685543737581924,0.1433139029463831,0.046225117733439625,1188629540.0,1.0
1000,2016-12-20,GOOG,39.8380012512207,39.932498931884766,39.66350173950195,39.82099914550781,19020000.0,0.0,0.0,0.11100006103515625,0.0,0.11100006103515625,67.59265423904313,36.85124969482422,40.21900177001953,88.18194998844633,-11.818050011553675,0.34911166541094474,0.18447345543929544,0.03271560688403463,1207649540.0,1.0
1001,2016-12-21,GOOG,39.79199981689453,39.83380126953125,39.35499954223633,39.72800064086914,24226000.0,0.0,0.0,-0.09299850463867188,0.09299850463867188,0.0,63.95720061853075,37.15499877929688,40.21900177001953,83.97517461186983,-16.024825388130164,0.3551517164597513,0.21860910764338665,0.02336368242253961,1183423540.0,-1.0
1002,2016-12-22,GOOG,39.61800003051758,39.66600036621094,39.42900085449219,39.5629997253418,19444000.0,0.0,0.0,-0.16500091552734375,0.16500091552734375,0.0,57.61351337645368,37.64500045776367,40.21900177001953,74.51430807147442,-25.485691928525593,0.342674170983436,0.24342212031139657,0.0024958962366010695,1163979540.0,-1.0
1003,2016-12-23,GOOG,39.54499816894531,39.637001037597656,39.36399841308594,39.49549865722656,12468000.0,0.0,0.0,-0.06750106811523438,0.06750106811523438,0.0,55.03673438267747,37.790000915527344,40.21900177001953,70.2139621954054,-29.786037804594596,0.32360849691749394,0.25945939563261605,0.0008108170809038029,1151511540.0,-1.0
1004,2016-12-27,GOOG,39.53400039672852,39.89300155639648,39.382850646972656,39.57749938964844,15782000.0,0.0,0.0,0.082000732421875,0.0,0.082000732421875,57.68925332547331,37.790000915527344,40.21900177001953,73.58986600664628,-26.41013399335373,0.3115245258406034,0.26987242167421355,-0.005715385348150859,1167293540.0,1.0
1005,2016-12-28,GOOG,39.685001373291016,39.71149826049805,39.15999984741211,39.25249862670898,23076000.0,0.0,0.0,-0.32500076293946023,0.32500076293946023,0.0,45.432357897993185,38.36149978637695,40.21900177001953,47.96758486280415,-52.032415137195855,0.27258090329981854,0.27041411799933457,-0.015080274856145603,1144217540.0,-1.0
1006,2016-12-29,GOOG,39.166500091552734,39.29650115966797,38.94599914550781,39.13949966430664,14886000.0,0.0,0.0,-0.11299896240233664,0.11299896240233664,0.0,41.864031344578045,38.94599914550781,40.21900177001953,15.200323634293248,-84.79967636570676,0.22994902079503987,0.26232109855847563,-0.01887578196867723,1129331540.0,-1.0
1007,2016-12-30,GOOG,39.13750076293945,39.13899993896485,38.52050018310547,38.59099960327149,35400000.0,0.0,0.0,-0.5485000610351491,0.5485000610351491,0.0,29.074355394252706,38.52050018310547,40.21900177001953,4.150683208610374,-95.84931679138963,0.15017248096318525,0.23989137503941754,-0.024001044266116378,1093931540.0,-1.0
1008,2017-01-03,GOOG,38.94049835205078,39.48149871826172,38.790000915527344,39.30699920654297,33146000.0,0.0,0.0,0.7159996032714773,0.0,0.7159996032714773,51.42589028445173,38.52050018310547,40.21900177001953,46.30546297377664,-53.69453702622336,0.14307490407997392,0.22052808084752884,-0.010148574344522432,1127077540.0,1.0
1009,2017-01-04,GOOG,39.417999267578125,39.56700134277344,39.15800094604492,39.345001220703125,21460000.0,0.0,0.0,0.03800201416015625,0.0,0.03800201416015625,52.345595911795705,38.52050018310547,40.20000076293945,49.09203649570378,-50.90796350429622,0.13891514093831603,0.20420549286568626,-0.011953440019557782,1148537540.0,1.0
1010,2017-01-05,GOOG,39.30400085449219,39.7239990234375,39.2509994506836,39.70100021362305,26704000.0,0.0,0.0,0.3559989929199219,0.0,0.3559989929199219,60.44163178252892,38.52050018310547,40.150001525878906,72.44547761515483,-27.554522384845164,0.1624717687846129,0.19585874804947162,-0.0006796321690127893,1175241540.0,1.0
1011,2017-01-06,GOOG,39.76300048828125,40.39500045776367,39.610198974609375,40.307498931884766,32804000.0,0.0,0.0,0.6064987182617188,0.0,0.6064987182617188,70.34522918559821,38.52050018310547,40.39500045776367,95.33200783900332,-4.667992160996684,0.2274579502487768,0.20217858848933268,0.018818067682215833,1208045540.0,1.0
1012,2017-01-09,GOOG,40.31999969482422,40.49829864501953,40.14149856567383,40.33250045776367,25492000.0,0.0,0.0,0.02500152587890625,0.0,0.02500152587890625,70.6942028725977,38.52050018310547,40.49829864501953,91.61703325952614,-8.382966740473858,0.2777753600102031,0.21729794279350678,0.021192334037893223,1233537540.0,1.0
1013,2017-01-10,GOOG,40.39300155639648,40.45650100708008,40.17549896240234,40.23949813842773,23536000.0,0.0,0.0,-0.0930023193359446,0.0930023193359446,0.0,67.29515650923646,38.52050018310547,40.49829864501953,86.91471797680825,-13.08528202319176,0.30661331244024126,0.23516101672285367,0.016726644153582715,1210001540.0,-1.0
1014,2017-01-11,GOOG,40.25,40.407501220703125,40.06850051879883,40.39550018310547,21318000.0,0.0,0.0,0.15600204467774148,0.0,0.15600204467774148,70.07952193822989,38.52050018310547,40.49829864501953,94.8023793175278,-5.197620682472206,0.3381575885641084,0.25576033109110463,0.02911920505408916,1231319540.0,1.0
1015,2017-01-12,GOOG,40.35699844360352,40.36949920654297,39.95849990844727,40.31800079345703,27062000.0,0.0,0.0,-0.0774993896484375,0.0774993896484375,0.0,66.81869288531884,38.52050018310547,40.49829864501953,90.88391183255283,-9.116088167447172,0.35283582978819084,0.27517543083052187,0.030110275789374086,1204257540.0,-1.0
1016,2017-01-13,GOOG,40.374000549316406,40.56119918823242,40.33449935913086,40.39400100708008,21984000.0,0.0,0.0,0.07600021362304688,0.0,0.07600021362304688,68.47832062808303,38.52050018310547,40.56119918823242,91.80681811809174,-8.193181881908265,0.36637765029791325,0.29341587472400016,0.046720774852790914,1226241540.0,1.0
1017,2017-01-17,GOOG,40.354000091552734,40.35699844360352,40.01850128173828,40.230499267578125,27242000.0,0.0,0.0,-0.16350173950195312,0.16350173950195312,0.0,60.915241606361775,38.52050018310547,40.56119918823242,83.7947722901093,-16.2052277098907,0.3597692210469958,0.3066865439885993,0.02349454498377046,1198999540.0,-1.0
1018,2017-01-18,GOOG,40.29050064086914,40.31024932861328,40.04949951171875,40.30350112915039,25888000.0,0.0,0.0,0.07300186157226562,0.0,0.07300186157226562,63.019402408824824,38.52050018310547,40.56119918823242,87.37206915696028,-12.627930843039719,0.3563152529439577,0.316612285779671,0.024361415140658593,1224887540.0,1.0
1019,2017-01-19,GOOG,40.25600051879883,40.4739990234375,40.09000015258789,40.10874938964844,18386000.0,0.0,0.0,-0.19475173950195312,0.19475173950195312,0.0,54.06064043462027,38.52050018310547,40.56119918823242,77.82868529620137,-22.171314703798622,0.33401282859590964,0.32009239434291875,0.010270501343325744,1206501540.0,-1.0
1020,2017-01-20,GOOG,40.34550094604492,40.34550094604492,40.08449935913086,40.2509994506836,33400000.0,0.0,0.0,0.14225006103516336,0.0,0.14225006103516336,58.97575188786235,38.52050018310547,40.56119918823242,84.7993390122948,-15.200660987705206,0.32408058842179344,0.3208900331586937,-0.0014017114109868833,1239901540.0,1.0
1021,2017-01-23,GOOG,40.36249923706055,41.04349899291992,40.1870002746582,40.96549987792969,39272000.0,0.0,0.0,0.7145004272460866,0.0,0.7145004272460866,74.6776103688736,38.790000915527344,41.04349899291992,96.53875387013937,-3.4612461298606325,0.36960287777027645,0.33063260208101025,0.01569452458889553,1279173540.0,1.0
1022,2017-01-24,GOOG,41.1150016784668,41.29499816894531,40.89104843139648,41.19350051879883,29480000.0,0.0,0.0,0.22800064086914062,0.0,0.22800064086914062,77.80541071323448,39.15800094604492,41.29499816894531,95.25045474749241,-4.749545252507582,0.4192445757876371,0.34835499682233567,0.023708108314105747,1308653540.0,1.0
1023,2017-01-25,GOOG,41.48099899291992,41.78850173950195,41.25299835205078,41.78350067138672,29890000.0,0.0,0.0,0.5900001525878906,0.0,0.5900001525878906,83.78544157311885,39.2509994506836,41.78850173950195,99.8029137495847,-0.1970862504152948,0.500425467309249,0.3787690909197184,0.03436027483233772,1338543540.0,1.0
1024,2017-01-26,GOOG,41.89049911499024,41.900001525878906,41.35049819946289,41.60749816894531,59478000.0,0.0,0.0,-0.17600250244140625,0.17600250244140625,0.0,76.67457821191996,39.610198974609375,41.900001525878906,87.22582622805527,-12.77417377194473,0.5442857899042437,0.41187243071662355,0.031983167570589055,1279065540.0,-1.0
1025,2017-01-27,GOOG,41.73550033569336,42.09749984741211,41.02199935913086,41.16550064086914,59316000.0,0.0,0.0,-0.4419975280761719,0.4419975280761719,0.0,61.54028403134728,39.95849990844727,42.09749984741211,56.42827334562678,-43.57172665437323,0.537187541379673,0.4369354528492335,0.01909936165159376,1219749540.0,-1.0
1026,2017-01-30,GOOG,40.733001708984375,40.79199981689453,39.9900016784668,40.11600112915039,64932000.0,0.0,0.0,-1.04949951171875,1.04949951171875,0.0,39.94097864385774,39.95849990844727,42.09749984741211,7.36331113591991,-92.63668886408009,0.44178368144262237,0.43790509856791127,-0.0028460531316351068,1154817540.0,-1.0
1027,2017-01-31,GOOG,39.84299850463867,40.0625,39.5260009765625,39.839500427246094,43212000.0,0.0,0.0,-0.2765007019042969,0.2765007019042969,0.0,36.09033678687001,39.5260009765625,42.09749984741211,12.19131201018242,-87.80868798981759,0.3399454596141922,0.4183131707771675,-0.011512664877858403,1111605540.0,-1.0
1028,2017-02-01,GOOG,39.98400115966797,40.05950164794922,39.55950164794922,39.78475189208984,40594000.0,0.0,0.0,-0.054748535156257105,0.054748535156257105,0.0,35.31253752870147,39.5260009765625,42.09749984741211,10.062260515084214,-89.9377394849158,0.25191625213371793,0.38503378704847757,-0.008077975566154638,1071011540.0,-1.0
1029,2017-02-02,GOOG,39.68999862670898,40.1349983215332,39.59999847412109,39.92649841308594,30642000.0,0.0,0.0,0.14174652099610086,0.0,0.14174652099610086,39.22533166242144,39.5260009765625,42.09749984741211,15.574474523922902,-84.4255254760771,0.19138407413435488,0.34630384446565304,-0.008061937393511132,1101653540.0,1.0
1030,2017-02-03,GOOG,40.14950180053711,40.29999923706055,40.01850128173828,40.074501037597656,29268000.0,0.0,0.0,0.14800262451171875,0.0,0.14800262451171875,43.35338908947729,39.5260009765625,42.09749984741211,21.329974796136494,-78.6700252038635,0.15358404062997977,0.3077598836985184,-0.02174998091045044,1130921540.0,1.0
1031,2017-02-06,GOOG,39.98500061035156,40.08349990844727,39.76250076293945,40.06700134277344,23690000.0,0.0,0.0,-0.00749969482421875,0.00749969482421875,0.0,43.181895883114215,39.5260009765625,42.09749984741211,21.03832797065137,-78.96167202934863,0.12162011803367534,0.2705319305655498,-0.027346527045238767,1107231540.0,-1.0
1032,2017-02-07,GOOG,40.199501037597656,40.525001525878906,40.0890007019043,40.3484992980957,24824000.0,0.0,0.0,0.2814979553222656,0.0,0.2814979553222656,51.49216876204567,39.5260009765625,42.09749984741211,31.985171405556716,-68.01482859444327,0.11764685183112533,0.2399549148186649,-0.034343732579441344,1132055540.0,1.0
1033,2017-02-08,GOOG,40.34999847412109,40.59199905395508,40.15950012207031,40.41899871826172,23106000.0,0.0,0.0,0.07049942016601562,0.0,0.07049942016601562,53.4592405918841,39.5260009765625,42.09749984741211,34.72674057228643,-65.27325942771357,0.11881707448532808,0.21572734675199756,-0.028564549732304156,1155161540.0,1.0
1034,2017-02-09,GOOG,40.47549819946289,40.53300094604492,40.22700119018555,40.47800064086914,19794000.0,0.0,0.0,0.059001922607421875,0.0,0.059001922607421875,55.21307323403664,39.5260009765625,42.09749984741211,37.02119705742298,-62.978802942577026,0.12308658093824931,0.19719919358924792,-0.016700877902537825,1174955540.0,1.0
1035,2017-02-10,GOOG,40.584999084472656,40.76250076293945,40.48899841308594,40.68349838256836,22700000.0,0.0,0.0,0.20549774169921875,0.0,0.20549774169921875,61.103585324818944,39.5260009765625,42.09749984741211,45.012557428167504,-54.98744257183249,0.14142192201623516,0.1860437392746454,0.014146406357676389,1197655540.0,1.0
1036,2017-02-13,GOOG,40.79999923706055,41.047950744628906,40.77450180053711,40.96200180053711,24266000.0,0.0,0.0,0.27850341796875,0.0,0.27850341796875,67.73878366281295,39.5260009765625,42.09749984741211,55.84294981627437,-44.15705018372563,0.1763923687726745,0.18411346517425126,0.02817558858050684,1221921540.0,1.0
1037,2017-02-14,GOOG,40.95000076293945,41.150001525878906,40.79999923706055,41.022499084472656,21094000.0,0.0,0.0,0.060497283935546875,0.0,0.060497283935546875,69.06158800142678,39.5260009765625,42.09749984741211,58.19555765216889,-41.80444234783111,0.20660669165906143,0.18861211047121332,0.03111109491747044,1243015540.0,1.0
1038,2017-02-15,GOOG,40.96799850463867,41.150001525878906,40.92350006103516,40.94900131225586,26272000.0,0.0,0.0,-0.07349777221679688,0.07349777221679688,0.0,65.30782950249686,39.5260009765625,42.09749984741211,55.337389093358134,-44.662610906641866,0.2220613195936849,0.19530195229570765,0.025609631192571536,1216743540.0,-1.0
1039,2017-02-16,GOOG,40.99649810791016,41.220001220703125,40.94900131225586,41.20800018310547,25752000.0,0.0,0.0,0.2589988708496094,0.0,0.2589988708496094,71.58719166744388,39.5260009765625,41.220001220703125,99.29155632419968,-0.7084436758003206,0.25229991158068543,0.20670154415270323,0.028284797468703937,1242495540.0,1.0
1040,2017-02-17,GOOG,41.1510009765625,41.40349960327149,41.08274841308594,41.40349960327149,32220000.0,0.0,0.0,0.19549942016602273,0.0,0.19549942016602273,75.456367057826,39.5260009765625,41.40349960327149,100.0,-0.0,0.28871129880219115,0.22310349508260083,0.03335658311597367,1274715540.0,1.0
1041,2017-02-21,GOOG,41.43299865722656,41.67250061035156,41.41749954223633,41.58300018310547,25246000.0,0.0,0.0,0.17950057983397727,0.0,0.17950057983397727,78.55081598453864,39.55950164794922,41.67250061035156,95.76429383834919,-4.23570616165081,0.3282677162553398,0.24413633931714865,0.03059595540070137,1299961540.0,1.0
1042,2017-02-22,GOOG,41.43299865722656,41.66249847412109,41.43199920654297,41.53799819946289,19658000.0,0.0,0.0,-0.045001983642578125,0.045001983642578125,0.0,75.78673122689757,39.59999847412109,41.67250061035156,93.51014367911299,-6.489856320887011,0.35192836694652385,0.26569474484302374,0.027684987671295236,1280303540.0,-1.0
1043,2017-02-23,GOOG,41.50600051879883,41.62300109863281,41.14400100708008,41.56650161743164,29456000.0,0.0,0.0,0.02850341796875,0.0,0.02850341796875,76.3938027722142,39.76250076293945,41.67250061035156,94.4503140634518,-5.549685936548198,0.3687291110360178,0.2863016180816226,0.026891174448559152,1309759540.0,1.0
1044,2017-02-24,GOOG,41.38650131225586,41.45000076293945,41.209999084472656,41.43199920654297,27844000.0,0.0,0.0,-0.13450241088867188,0.13450241088867188,0.0,67.21783259485971,39.76250076293945,41.67250061035156,87.40830245958118,-12.591697540418817,0.3669605089721486,0.3024333962597278,0.018398143073539597,1281915540.0,-1.0
1045,2017-02-27,GOOG,41.227500915527344,41.525001525878906,41.20000076293945,41.4640007019043,22030000.0,0.0,0.0,0.032001495361328125,0.0,0.032001495361328125,68.26431014931902,40.0890007019043,41.67250061035156,86.83296997145301,-13.167030028546995,0.36394579178316633,0.31473587536441555,0.012255233614110184,1303945540.0,1.0
1046,2017-02-28,GOOG,41.28049850463867,41.42699813842773,41.0099983215332,41.16049957275391,45216000.0,0.0,0.0,-0.3035011291503835,0.3035011291503835,0.0,50.59143535479038,40.15950012207031,41.67250061035156,66.15988946710281,-33.840110532897185,0.33322538719536965,0.3184337777306064,0.003364019534672691,1258729540.0,-1.0
1047,2017-03-01,GOOG,41.442501068115234,41.81275177001953,41.36299896240234,41.762001037597656,29930000.0,0.0,0.0,0.6015014648437429,0.0,0.6015014648437429,68.96489656781469,40.22700119018555,41.81275177001953,96.79957661266072,-3.2004233873392756,0.35334227666888296,0.3254154775182617,0.01985395734421669,1288659540.0,1.0
1048,2017-03-02,GOOG,41.692501068115234,41.72549819946289,41.48199844360352,41.53150177001953,18850000.0,0.0,0.0,-0.230499267578125,0.230499267578125,0.0,59.22653621676871,40.48899841308594,41.81275177001953,78.7535949558231,-21.246405044176893,0.3466892738379812,0.32967023678220564,0.007850455869651496,1269809540.0,-1.0
1049,2017-03-03,GOOG,41.52799987792969,41.56800079345703,41.28755187988281,41.45399856567383,17928000.0,0.0,0.0,-0.07750320434570312,0.07750320434570312,0.0,56.150379459572896,40.77450180053711,41.81275177001953,65.44635541626404,-34.55364458373596,0.33134334051738534,0.33000485752924164,0.0012196785993023873,1251881540.0,-1.0
1050,2017-03-06,GOOG,41.34749984741211,41.44400024414063,41.119998931884766,41.38899993896485,22180000.0,0.0,0.0,-0.06499862670897727,0.06499862670897727,0.0,53.46330111711774,40.79999923706055,41.81275177001953,58.158403236317355,-41.841596763682645,0.3103591052664285,0.32607570707667904,-0.004665373909683357,1229701540.0,-1.0
1051,2017-03-07,GOOG,41.369998931884766,41.670501708984375,41.32600021362305,41.59550094604492,20752000.0,0.0,0.0,0.20650100708007102,0.0,0.20650100708007102,60.408646968781255,40.92350006103516,41.81275177001953,75.56925426404456,-24.430745735955444,0.3068546240218808,0.3222314904657194,0.0013843408222491416,1250453540.0,1.0
1052,2017-03-08,GOOG,41.67549896240234,41.907501220703125,41.589500427246094,41.76850128173828,19796000.0,0.0,0.0,0.17300033569335938,0.0,0.17300033569335938,65.40028920810684,40.94900131225586,41.907501220703125,85.4981792131813,-14.501820786818698,0.31441262562038474,0.3206677174966525,0.0048596744120013025,1270249540.0,1.0
1053,2017-03-09,GOOG,41.79999923706055,42.09999847412109,41.71049880981445,41.93399810791016,25230000.0,0.0,0.0,0.1654968261718821,0.0,0.1654968261718821,69.62716143023624,41.0099983215332,42.09999847412109,84.77061073644767,-15.229389263552342,0.32995311299907115,0.3225247965971363,0.012116212371618307,1295479540.0,1.0
1054,2017-03-10,GOOG,42.16400146484375,42.24549865722656,41.97499847412109,42.16249847412109,34080000.0,0.0,0.0,0.2285003662109233,0.0,0.2285003662109233,74.57535505215824,41.0099983215332,42.24549865722656,93.28205904056705,-6.717940959432955,0.3565965085291225,0.32933913898353356,0.016845884632273656,1329559540.0,1.0
1055,2017-03-13,GOOG,42.20000076293945,42.43424987792969,42.16249847412109,42.277000427246094,24472000.0,0.0,0.0,0.1145019531250071,0.0,0.1145019531250071,76.76409791087457,41.0099983215332,42.43424987792969,88.95915191544867,-11.04084808455133,0.3825412447802634,0.33997956014287956,0.02712554186857452,1354031540.0,1.0
1056,2017-03-14,GOOG,42.18199920654297,42.36199951171875,42.040000915527344,42.28099822998047,15598000.0,0.0,0.0,0.003997802734375,0.0,0.003997802734375,76.84440468279325,41.0099983215332,42.43424987792969,89.23984690338254,-10.760153096617465,0.3988277859953797,0.3517492053133796,0.012427498191850628,1369629540.0,1.0
1057,2017-03-15,GOOG,42.37950134277344,42.43149948120117,42.03850173950195,42.36000061035156,27630000.0,0.0,0.0,0.07900238037109375,0.0,0.07900238037109375,78.5359044673672,41.0099983215332,42.43424987792969,94.78678697982372,-5.213213020176291,0.4133450348289003,0.3640683712164838,0.01994868485420631,1397259540.0,1.0
1058,2017-03-16,GOOG,42.45149993896485,42.54249954223633,42.30649948120117,42.43899917602539,19552000.0,0.0,0.0,0.07899856567382812,0.0,0.07899856567382812,80.20435235619816,41.0099983215332,42.54249954223633,93.24631101021566,-6.753688989784336,0.42631034288807257,0.3765167655508016,0.02376129310640729,1416811540.0,1.0
1059,2017-03-17,GOOG,42.58050155639648,42.66999816894531,42.355499267578125,42.60599899291992,34246000.0,0.0,0.0,0.16699981689453125,0.0,0.16699981689453125,83.35944769013267,41.0099983215332,42.66999816894531,96.14462759589024,-3.855372404109762,0.44493203296717354,0.390199819034076,0.0294039250948257,1451057540.0,1.0
1060,2017-03-20,GOOG,42.5004997253418,42.51100158691406,42.25749969482422,42.41999816894531,24630000.0,0.0,0.0,-0.18600082397460938,0.18600082397460938,0.0,69.18783451704346,41.119998931884766,42.66999816894531,83.87095980291541,-16.129040197084585,0.4396135531056231,0.4000825658483855,0.01982178851433658,1426427540.0,-1.0
1061,2017-03-21,GOOG,42.56999969482422,42.67499923706055,41.45100021362305,41.52299880981445,49270000.0,0.0,0.0,-0.8969993591308594,0.8969993591308594,0.0,35.55393165738046,41.119998931884766,42.67499923706055,25.916385777437608,-74.0836142225624,0.3588813074360715,0.39184231416592274,-0.005877694061078631,1377157540.0,-1.0
1062,2017-03-22,GOOG,41.59550094604492,41.77750015258789,41.35900115966797,41.47949981689453,28030000.0,0.0,0.0,-0.043498992919921875,0.043498992919921875,0.0,34.612443706493366,41.119998931884766,42.67499923706055,23.119023437691656,-76.88097656230835,0.28806972740578374,0.371087796813895,-0.010838420172721297,1349127540.0,-1.0
1063,2017-03-23,GOOG,41.04999923706055,41.12850189208984,40.61285018920898,40.87900161743164,69742000.0,0.0,0.0,-0.6004981994628906,0.6004981994628906,0.0,24.344085479737018,40.61285018920898,42.67499923706055,12.906507824929081,-87.09349217507092,0.18140473309549776,0.33315118407021554,-0.03044166980467833,1279385540.0,-1.0
1064,2017-03-24,GOOG,41.00400161743164,41.09650039672852,40.44449996948242,40.72150039672852,39620000.0,0.0,0.0,-0.1575012207031179,0.1575012207031179,0.0,22.338492792216144,40.44449996948242,42.67499923706055,12.418763425413172,-87.58123657458682,0.08320380276102668,0.2831617078083778,-0.03679305567561275,1239765540.0,-1.0
1065,2017-03-27,GOOG,40.34749984741211,41.08150100708008,40.16849899291992,40.97549819946289,37886000.0,0.0,0.0,0.2539978027343679,0.0,0.2539978027343679,32.661508717237595,40.16849899291992,42.67499923706055,32.196254854930416,-67.80374514506958,0.02557949342638466,0.23164526493197915,-0.030876755165914704,1277651540.0,1.0
1066,2017-03-28,GOOG,41.02050018310547,41.29949951171875,40.70135116577149,41.04600143432617,32410000.0,0.0,0.0,0.07050323486328125,0.0,0.07050323486328125,35.41120639179907,40.16849899291992,42.67499923706055,35.00907065369584,-64.99092934630416,-0.014235071999721072,0.18246919754563912,-0.03101981012966004,1310061540.0,1.0
1067,2017-03-29,GOOG,41.25,41.63824844360352,41.11899948120117,41.570499420166016,35726000.0,0.0,0.0,0.5244979858398438,0.0,0.5244979858398438,52.174626315262095,40.16849899291992,42.67499923706055,55.93458171502319,-44.0654182849768,-0.003426301631243689,0.14529009771026255,-0.020464661578306176,1345787540.0,1.0
1068,2017-03-30,GOOG,41.67499923706055,41.68399810791016,41.45000076293945,41.57500076293945,21106000.0,0.0,0.0,0.0045013427734375,0.0,0.0045013427734375,52.29722766130572,40.16849899291992,42.67499923706055,56.114168482826635,-43.885831517173365,0.0054402358488587765,0.11732012533798179,-0.02419842872717981,1366893540.0,1.0
1069,2017-03-31,GOOG,41.44850158691406,41.58200073242188,41.36949920654297,41.47800064086914,28038000.0,0.0,0.0,-0.0970001220703125,0.0970001220703125,0.0,49.163523670095685,40.16849899291992,42.67499923706055,52.24422582883859,-47.755774171161406,0.004587054782376754,0.09477351122686078,-0.022206449050858,1338855540.0,-1.0
1070,2017-04-03,GOOG,41.46099853515625,42.04249954223633,41.46099853515625,41.9275016784668,33430000.0,0.0,0.0,0.44950103759765625,0.0,0.44950103759765625,61.4990368641729,40.16849899291992,42.67499923706055,70.1776387079493,-29.822361292050697,0.039723966578158354,0.08376360229712031,0.009741658363960237,1372285540.0,1.0
1071,2017-04-04,GOOG,41.56800079345703,41.75899887084961,41.45180130004883,41.72850036621094,20908000.0,0.0,0.0,-0.19900131225585938,0.19900131225585938,0.0,54.716762932394005,40.16849899291992,42.67499923706055,62.23822945710007,-37.76177054289993,0.05092544274443611,0.07719597038658348,0.006002978589799479,1351377540.0,-1.0
1072,2017-04-05,GOOG,41.7755012512207,42.122501373291016,41.5359992980957,41.570499420166016,31106000.0,0.0,0.0,-0.15800094604492188,0.15800094604492188,0.0,49.69589096094906,40.16849899291992,42.67499923706055,55.93458171502319,-44.0654182849768,0.04651711706207351,0.07106019972168148,0.016915721406451922,1320271540.0,-1.0
1073,2017-04-06,GOOG,41.619998931884766,41.81949996948242,41.323001861572266,41.39400100708008,25088000.0,0.0,0.0,-0.1764984130859375,0.1764984130859375,0.0,44.43983248299879,40.16849899291992,42.67499923706055,48.892954111015065,-51.107045888984935,0.028453545559777638,0.06253886888930071,0.016514632412846453,1295183540.0,-1.0
1074,2017-04-07,GOOG,41.39799880981445,41.42425155639648,41.02565002441406,41.23350143432617,21146000.0,0.0,0.0,-0.16049957275390625,0.16049957275390625,0.0,40.00079039615349,40.16849899291992,42.67499923706055,42.48962049358966,-57.51037950641034,0.0011735330740805239,0.05026580172625667,0.0062965246598676305,1274037540.0,-1.0
1075,2017-04-10,GOOG,41.26950073242188,41.46749877929688,41.1884994506836,41.23649978637695,19578000.0,0.0,0.0,0.00299835205078125,0.0,0.00299835205078125,40.12969989934465,40.16849899291992,42.122501373291016,54.65708763641332,-45.34291236358667,-0.019973884898675465,0.03621786440127025,0.004641094026066828,1293615540.0,1.0
1076,2017-04-11,GOOG,41.23550033569336,41.3713493347168,40.85100173950195,41.16749954223633,21594000.0,0.0,0.0,-0.069000244140625,0.069000244140625,0.0,37.963863167850135,40.16849899291992,42.122501373291016,51.12586142943599,-48.874138570564,-0.0418190451233329,0.020610482496349617,-0.009694371815369363,1272021540.0,-1.0
1077,2017-04-12,GOOG,41.09650039672852,41.33300018310547,41.05099868774414,41.21599960327149,18010000.0,0.0,0.0,0.048500061035163355,0.0,0.048500061035163355,40.56545011760149,40.16849899291992,42.122501373291016,53.607949553911695,-46.392050446088305,-0.0545886780928555,0.00557065037850859,-0.008635024728321339,1290031540.0,1.0
1078,2017-04-13,GOOG,41.10699844360352,41.31900024414063,41.071998596191406,41.178001403808594,22448000.0,0.0,0.0,-0.03799819946289773,0.03799819946289773,0.0,39.08375607718593,40.16849899291992,42.122501373291016,51.663315307576674,-48.336684692423326,-0.06700247848946361,-0.008943975395085854,-0.0072327313859229525,1267583540.0,-1.0
1079,2017-04-17,GOOG,41.2504997253418,41.88750076293945,41.2234992980957,41.85850143432617,17900000.0,0.0,0.0,0.6805000305175781,0.0,0.6805000305175781,65.28536209504821,40.70135116577149,42.122501373291016,81.42350206417454,-18.57649793582547,-0.021679926753336076,-0.0114911656667359,-0.0016457036879939935,1285483540.0,1.0
1080,2017-04-18,GOOG,41.71099853515625,41.94649887084961,41.635501861572266,41.84099960327149,16734000.0,0.0,0.0,-0.017501831054680395,0.017501831054680395,0.0,64.46254091898317,40.85100173950195,42.122501373291016,77.86064875373575,-22.139351246264248,0.012680102206552135,-0.006656912092078293,0.0026959808302060573,1268749540.0,-1.0
1081,2017-04-19,GOOG,41.98949813842773,42.11100006103516,41.81449890136719,41.91049957275391,19084000.0,0.0,0.0,0.06949996948242188,0.0,0.06949996948242188,66.4027241279689,40.85100173950195,42.122501373291016,83.32663298491578,-16.673367015084224,0.04500000733661125,0.0036744717936596184,0.008178880632426555,1287833540.0,1.0
1082,2017-04-20,GOOG,42.071998596191406,42.2599983215332,41.96599960327149,42.08250045776367,19180000.0,0.0,0.0,0.17200088500975852,0.0,0.17200088500975852,70.93413638336514,40.85100173950195,42.2599983215332,87.40253411306043,-12.59746588693957,0.08352991805367793,0.019645561045663285,0.016632831664806558,1307013540.0,1.0
1083,2017-04-21,GOOG,42.14400100708008,42.19400024414063,42.02999877929688,42.15950012207031,26472000.0,0.0,0.0,0.07699966430664062,0.0,0.07699966430664062,72.82721935657877,40.85100173950195,42.2599983215332,92.86739224604722,-7.132607753952783,0.11890768550542674,0.039497985937615984,0.022457435229433775,1333485540.0,1.0
1084,2017-04-24,GOOG,42.560001373291016,43.17250061035156,42.49300003051758,43.13800048828125,27450000.0,0.0,0.0,0.9785003662109375,0.0,0.9785003662109375,86.10092814709182,40.85100173950195,43.17250061035156,98.51388589916968,-1.4861141008303111,0.2233272455086066,0.07626383785181412,0.046112078177219296,1360935540.0,1.0
1085,2017-04-25,GOOG,43.25,43.75,43.14049911499024,43.6150016784668,33440000.0,0.0,0.0,0.4770011901855469,0.0,0.4770011901855469,89.0967747038415,40.85100173950195,43.75,95.34327690455356,-4.656723095446441,0.3406437792523036,0.12913982613191205,0.05945229036122113,1394375540.0,1.0
1086,2017-04-26,GOOG,43.71149826049805,43.8025016784668,43.38740158081055,43.58649826049805,24744000.0,0.0,0.0,-0.02850341796875,0.02850341796875,0.0,87.79206345235498,40.85100173950195,43.8025016784668,92.68157132185111,-7.318428678148886,0.4264026851194913,0.18859239792942792,0.057514040179639236,1369631540.0,-1.0
1087,2017-04-27,GOOG,43.68000030517578,43.77000045776367,43.51900100708008,43.712501525878906,40536000.0,0.0,0.0,0.12600326538085938,0.0,0.12600326538085938,88.6405455158519,40.85100173950195,43.8025016784668,96.95069779945665,-3.0493022005433508,0.49878496376239667,0.2506309110960217,0.061549857585752044,1410167540.0,1.0
1088,2017-04-28,GOOG,45.53300094604492,45.84249877929688,45.28850173950195,45.29800033569336,65526000.0,0.0,0.0,1.5854988098144531,0.0,1.5854988098144531,94.3459868489614,40.85100173950195,45.84249877929688,89.09148018595452,-10.908519814045466,0.676289104635778,0.33576254980397297,0.08216966168183504,1475693540.0,1.0
1089,2017-05-01,GOOG,45.09700012207031,45.78400039672852,45.0724983215332,45.62850189208984,42320000.0,0.0,0.0,0.33050155639647727,0.0,0.33050155639647727,94.95540272591707,40.85100173950195,45.84249877929688,95.71277142907336,-4.287228570926636,0.8340170986549751,0.4354134595741735,0.09052131461319601,1518013540.0,1.0
1090,2017-05-02,GOOG,45.48099899291992,46.03850173950195,45.47264862060547,45.821998596191406,31744000.0,0.0,0.0,0.1934967041015696,0.0,0.1934967041015696,95.29778215636442,41.05099868774414,46.03850173950195,95.65908750202685,-4.340912497973144,0.9635243284997159,0.5410356333592821,0.0933298114628145,1549757540.0,1.0
1091,2017-05-03,GOOG,45.74300003051758,46.40499877929688,45.62715148925781,46.35200119018555,29990000.0,0.0,0.0,0.5300025939941406,0.0,0.5300025939941406,96.12827831054273,41.071998596191406,46.40499877929688,99.00623312785125,-0.9937668721487656,1.0962891818476947,0.6520863430569647,0.1014554906666485,1579747540.0,1.0
1092,2017-05-04,GOOG,46.30350112915039,46.79650115966797,46.22949981689453,46.58300018310547,28442000.0,0.0,0.0,0.23099899291992188,0.0,0.23099899291992188,96.44411500459707,41.2234992980957,46.79650115966797,96.16901300473877,-3.8309869952612345,1.2062411754233722,0.7629173095302463,0.1049229722417766,1608189540.0,1.0
1093,2017-05-05,GOOG,46.67699813842773,46.744998931884766,46.2599983215332,46.35649871826172,38226000.0,0.0,0.0,-0.22650146484375,0.22650146484375,0.0,88.29512105529943,41.635501861572266,46.79650115966797,91.47447197738234,-8.525528022617662,1.2605710686313145,0.8624480613504601,0.07460935123441326,1569963540.0,-1.0
1094,2017-05-08,GOOG,46.305999755859375,46.84624862670898,46.26300048828125,46.71500015258789,26596000.0,0.0,0.0,0.3585014343261719,0.0,0.3585014343261719,89.85985410594327,41.81449890136719,46.84624862670898,97.39159375395661,-2.6084062460433954,1.3173701470324417,0.9534324784868566,0.07107642679861681,1596559540.0,1.0
1095,2017-05-09,GOOG,46.84749984741211,46.875,46.47650146484375,46.60850143432617,31636000.0,0.0,0.0,-0.10649871826171875,0.10649871826171875,0.0,85.92269808224464,41.96599960327149,46.875,94.57122541991583,-5.428774580084165,1.3383624600263246,1.0304184747947502,0.0693334700981687,1564923540.0,-1.0
1096,2017-05-10,GOOG,46.5989990234375,46.59999847412109,46.257999420166016,46.43899917602539,23478000.0,0.0,0.0,-0.16950225830078125,0.16950225830078125,0.0,79.52396551632924,42.02999877929688,46.875,91.00101725234786,-8.998982747652144,1.3260358873789926,1.0895419573115988,0.06237340703396543,1541445540.0,-1.0
1097,2017-05-11,GOOG,46.26599884033203,46.62649917602539,46.1515007019043,46.52999877929688,16700000.0,0.0,0.0,0.09099960327149148,0.0,0.09099960327149148,80.4269026747723,42.49300003051758,46.875,92.12685478991759,-7.8731452100824075,1.308526023743866,1.1333387705980522,0.027197634210637478,1558145540.0,1.0
1098,2017-05-12,GOOG,46.57649993896485,46.672000885009766,46.39250183105469,46.61100006103516,21012000.0,0.0,0.0,0.08100128173828125,0.0,0.08100128173828125,81.27497777860488,43.14049911499024,46.875,92.93078386928413,-7.0692161307158665,1.2863571328436834,1.1639424430471785,0.021532553737330762,1579157540.0,1.0
1099,2017-05-15,GOOG,46.647499084472656,46.91249847412109,46.46699905395508,46.854000091552734,22162000.0,0.0,0.0,0.24300003051757102,0.0,0.24300003051757102,83.71710715263794,43.38740158081055,46.91249847412109,98.34051703147897,-1.6594829685210275,1.2737136209507156,1.185896678627886,0.02252196602020562,1601319540.0,1.0
1100,2017-05-16,GOOG,47.0,47.15549850463867,46.87900161743164,47.150001525878906,19390000.0,0.0,0.0,0.2960014343261719,0.0,0.2960014343261719,86.23951574664429,43.51900100708008,47.15549850463867,99.84883864863221,-0.15116135136779518,1.2729051306565964,1.203298369033628,0.017216092406002304,1620709540.0,1.0
1101,2017-05-17,GOOG,46.78350067138672,46.96664810180664,45.90700149536133,45.98099899291992,47242000.0,0.0,0.0,-1.1690025329589844,1.1690025329589844,0.0,50.55318296517866,45.0724983215332,47.15549850463867,43.61500679429938,-56.38499320570062,1.1645118934020076,1.195541073907304,-0.012923194895546386,1573467540.0,-1.0
1102,2017-05-18,GOOG,46.04999923706055,46.65850067138672,45.9375,46.512001037597656,31938000.0,0.0,0.0,0.5310020446777344,0.0,0.5310020446777344,59.365984697548114,45.0724983215332,47.15549850463867,69.10718144625179,-30.89281855374822,1.108676763579659,1.1781682118417751,0.0033544880143132616,1605405540.0,1.0
1103,2017-05-19,GOOG,46.57350158691406,46.88774871826172,46.54999923706055,46.70050048828125,27860000.0,0.0,0.0,0.18849945068359375,0.0,0.18849945068359375,62.13054766233363,45.47264862060547,47.15549850463867,72.96264980766136,-27.037350192338643,1.0673337916813068,1.1560013278096815,-0.0003103856204490496,1633265540.0,1.0
1104,2017-05-22,GOOG,46.75,47.09415054321289,46.75,47.09299850463867,22408000.0,0.0,0.0,0.3924980163574219,0.0,0.3924980163574219,67.45101182754331,45.62715148925781,47.15549850463867,95.91061458091536,-4.08938541908463,1.0540896093999308,1.1356189841277313,0.010395036429033944,1655673540.0,1.0
1105,2017-05-23,GOOG,47.39599990844727,47.57334899902344,47.12874984741211,47.44100189208984,25416000.0,0.0,0.0,0.34800338745116477,0.0,0.34800338745116477,71.54142814212855,45.90700149536133,47.57334899902344,92.05765264191632,-7.942347358083677,1.059461650094093,1.1203875173210036,0.021576750874117367,1681089540.0,1.0
1106,2017-05-24,GOOG,47.64899826049805,47.75450134277344,47.47499847412109,47.74800109863281,20496000.0,0.0,0.0,0.30699920654297586,0.0,0.30699920654297586,74.76893576741162,45.90700149536133,47.75450134277344,99.64815996332935,-0.3518400366706517,1.0760868420420309,1.1115273822652092,0.026176710751986354,1701585540.0,1.0
1107,2017-05-25,GOOG,47.86650085449219,48.63145065307617,47.77349853515625,48.47700119018555,33210000.0,0.0,0.0,0.7290000915527344,0.0,0.7290000915527344,80.75046946595245,45.90700149536133,48.63145065307617,94.33098384481615,-5.669016155183856,1.1350030328710545,1.1162225123863783,0.040033492667115755,1734795540.0,1.0
1108,2017-05-26,GOOG,48.48500061035156,48.749000549316406,48.25149917602539,48.57350158691406,25040000.0,0.0,0.0,0.09650039672851562,0.0,0.09650039672851562,81.4231344863922,45.90700149536133,48.749000549316406,93.82480574164478,-6.175194258355223,1.1759259714889936,1.1281632042069014,0.036699139710620665,1759835540.0,1.0
1109,2017-05-30,GOOG,48.51549911499024,48.810001373291016,48.4744987487793,48.79399871826172,29334000.0,0.0,0.0,0.22049713134765625,0.0,0.22049713134765625,82.99024132526552,45.90700149536133,48.810001373291016,99.44875454005498,-0.55124545994502,1.2121767518642415,1.1449659137383694,0.03486738365173725,1789169540.0,1.0
1110,2017-05-31,GOOG,48.7509994506836,48.9635009765625,48.00899887084961,48.24300003051758,48962000.0,0.0,0.0,-0.5509986877441406,0.5509986877441406,0.0,66.75359424364437,45.90700149536133,48.9635009765625,76.42725115851246,-23.572748841487538,1.1828100690690846,1.1525347448045125,0.04919425604358785,1740207540.0,-1.0
1111,2017-06-01,GOOG,48.4474983215332,48.57500076293945,48.0004997253418,48.34749984741211,28210000.0,0.0,0.0,0.10449981689453125,0.0,0.10449981689453125,68.1185550818491,45.90700149536133,48.9635009765625,79.84618898386631,-20.153811016133684,1.1546588349611113,1.1529595628358322,0.03946290782739581,1768417540.0,1.0
1112,2017-06-02,GOOG,48.47299957275391,48.79399871826172,48.29999923706055,48.77999877929688,35020000.0,0.0,0.0,0.43249893188477273,0.0,0.43249893188477273,73.34465003086298,45.90700149536133,48.9635009765625,93.99632820505164,-6.0036717949483664,1.1539458588164848,1.1531568220319628,0.044528394112980596,1803437540.0,1.0
1113,2017-06-05,GOOG,48.82749938964844,49.34550094604492,48.755001068115234,49.18399810791016,25042000.0,0.0,0.0,0.40399932861328125,0.0,0.40399932861328125,77.34694889292683,45.90700149536133,49.34550094604492,95.30310123787716,-4.696898762122845,1.1724647457855326,1.1570184067826768,0.04440149639368429,1828479540.0,1.0
1114,2017-06-06,GOOG,49.15800094604492,49.41249847412109,48.75699996948242,48.82849884033203,36292000.0,0.0,0.0,-0.3554992675781321,0.3554992675781321,0.0,67.11515674902495,45.90700149536133,49.41249847412109,83.34046107220797,-16.659538927792028,1.145253507726153,1.154665426971372,0.029246788493173526,1792187540.0,-1.0
1115,2017-06-07,GOOG,49.0,49.19900131225586,48.797000885009766,49.047000885009766,29078000.0,0.0,0.0,0.21850204467773438,0.0,0.21850204467773438,69.93564986851743,45.9375,49.41249847412109,89.48207914814223,-10.517920851857768,1.1283132021812605,1.1493949820133498,0.027205322871916904,1821265540.0,1.0
1116,2017-06-08,GOOG,49.11750030517578,49.22850036621094,48.86000061035156,49.170501708984375,29638000.0,0.0,0.0,0.12350082397460938,0.0,0.12350082397460938,71.52824631696106,46.54999923706055,49.41249847412109,91.54596228346196,-8.45403771653804,1.112034530493844,1.1419228917094486,0.014305763594535836,1850903540.0,1.0
1117,2017-06-09,GOOG,49.22499847412109,49.22499847412109,46.78150177001953,47.49150085449219,66188000.0,0.0,0.0,-1.6790008544921875,1.6790008544921875,0.0,39.06586658599744,46.75,49.41249847412109,27.849813312548967,-72.15018668745104,0.9526704371553976,1.1040724007986384,-0.022275534953678733,1784715540.0,-1.0
1118,2017-06-12,GOOG,46.97800064086914,47.467750549316406,45.76165008544922,47.14500045776367,75270000.0,0.0,0.0,-0.3465003967285156,0.3465003967285156,0.0,35.255788043111025,45.76165008544922,49.41249847412109,37.89120294906846,-62.10879705093154,0.7893148288218015,1.041120886403271,-0.033795103984394115,1709445540.0,-1.0
1119,2017-06-13,GOOG,47.59550094604492,47.999000549316406,47.204498291015625,47.66999816894531,40266000.0,0.0,0.0,0.5249977111816406,0.0,0.5249977111816406,44.68695835093197,45.76165008544922,49.41249847412109,52.27135943024811,-47.72864056975188,0.6942147841097182,0.9717396659445605,-0.011877409390166349,1749711540.0,1.0
1120,2017-06-14,GOOG,47.99599838256836,48.057498931884766,47.11249923706055,47.53799819946289,29794000.0,0.0,0.0,-0.13199996948242188,0.13199996948242188,0.0,42.87506049298327,45.76165008544922,49.41249847412109,48.65576230241334,-51.34423769758665,0.6012650103838766,0.8976447348324239,-0.016743402461431467,1719917540.0,-1.0
1121,2017-06-15,GOOG,46.69850158691406,47.16695022583008,46.22200012207031,47.115501403808594,42662000.0,0.0,0.0,-0.4224967956542969,0.4224967956542969,0.0,37.29095160942691,45.76165008544922,49.41249847412109,37.08319749897609,-62.9168025010239,0.4878856425933904,0.8156929163846172,-0.03412253827678924,1677255540.0,-1.0
1122,2017-06-16,GOOG,47.0,47.10200119018555,46.57975006103516,46.98899841308594,61894000.0,0.0,0.0,-0.12650299072265625,0.12650299072265625,0.0,35.68525596736666,45.76165008544922,49.41249847412109,33.6181675318271,-66.3818324681729,0.38340429657346675,0.7292351924223872,-0.044628329929754296,1615361540.0,-1.0
1123,2017-06-19,GOOG,47.49800109863281,47.9995002746582,47.45249938964844,47.868499755859375,30666000.0,0.0,0.0,0.8795013427734375,0.0,0.8795013427734375,52.19715792290352,45.76165008544922,49.41249847412109,57.708495289682546,-42.29150471031745,0.36733606368424176,0.6568553666747582,-0.019660630723296046,1646027540.0,1.0
1124,2017-06-20,GOOG,47.8759994506836,48.08100128173828,47.5004997253418,47.53150177001953,22520000.0,0.0,0.0,-0.33699798583984375,0.33699798583984375,0.0,46.8763338534452,45.76165008544922,49.41249847412109,48.47781929433016,-51.52218070566984,0.3236777961549393,0.5902198525707945,-0.03089891507420217,1623507540.0,-1.0
1125,2017-06-21,GOOG,47.68199920654297,48.005001068115234,47.53799819946289,47.97249984741211,24044000.0,0.0,0.0,0.4409980773925781,0.0,0.4409980773925781,53.96235494248477,45.76165008544922,49.41249847412109,60.557150738521074,-39.442849261478926,0.3209632987527016,0.5363685418071759,-0.024364239125779896,1647551540.0,1.0
1126,2017-06-22,GOOG,47.935001373291016,48.0359992980957,47.727500915527344,47.85449981689453,18828000.0,0.0,0.0,-0.11800003051757812,0.11800003051757812,0.0,51.827973859383064,45.76165008544922,49.41249847412109,57.32502445018442,-42.67497554981557,0.3057657465158954,0.4902479827489198,0.007643451056948525,1628723540.0,-1.0
1127,2017-06-23,GOOG,47.84149932861328,48.29999923706055,47.709999084472656,48.27949905395508,30558000.0,0.0,0.0,0.4249992370605469,0.0,0.4249992370605469,58.62841607595441,45.76165008544922,49.41249847412109,68.96613336008238,-31.033866639917612,0.32427739548030843,0.4570538652951976,0.02406402768428828,1659281540.0,1.0
1128,2017-06-26,GOOG,48.494998931884766,48.66550064086914,47.53950119018555,47.61349868774414,31968000.0,0.0,0.0,-0.6660003662109375,0.6660003662109375,0.0,46.70633095952676,45.76165008544922,49.22850036621094,53.415880477193355,-46.58411952280665,0.2819571209201541,0.4220345164201889,-0.0011852209643670175,1627313540.0,-1.0
1129,2017-06-27,GOOG,47.12300109863281,47.41450119018555,46.34249877929688,46.36650085449219,51598000.0,0.0,0.0,-1.2469978332519531,1.2469978332519531,0.0,32.45022517749352,45.76165008544922,49.22850036621094,17.446694263072533,-82.55330573692747,0.14611141345924494,0.3668498958280001,-0.024643388222938212,1575715540.0,-1.0
1130,2017-06-28,GOOG,46.45000076293945,47.13750076293945,45.79999923706055,47.02450180053711,54428000.0,0.0,0.0,0.6580009460449219,0.0,0.6580009460449219,43.03624067797287,45.76165008544922,49.22499847412109,36.46331738437009,-63.536682615629914,0.09050460799961968,0.311580838262324,-0.0019314153635247022,1630143540.0,1.0
1131,2017-06-29,GOOG,46.49599838256836,46.5629997253418,45.53099822998047,45.88949966430664,65984000.0,0.0,0.0,-1.1350021362304688,1.1350021362304688,0.0,32.80430989588427,45.53099822998047,48.66550064086914,11.437267780710753,-88.56273221928924,-0.04463484997145173,0.24033770061556886,-0.0233990675671244,1564159540.0,-1.0
1132,2017-06-30,GOOG,46.3025016784668,46.3025016784668,45.41550064086914,45.436500549316406,41804000.0,0.0,0.0,-0.4529991149902344,0.4529991149902344,0.0,29.56703470960076,45.41550064086914,48.66550064086914,0.6461510291466346,-99.35384897085336,-0.18614136496258737,0.1550418874999376,-0.05080583721960663,1522355540.0,-1.0
1133,2017-07-03,GOOG,45.60900115966797,45.696998596191406,44.73949813842773,44.935001373291016,34196000.0,0.0,0.0,-0.5014991760253906,0.5014991760253906,0.0,26.257121519497957,44.73949813842773,48.66550064086914,4.979702247813476,-95.02029775218652,-0.3348926558213421,0.05705497883568165,-0.05462693792617035,1488159540.0,-1.0
1134,2017-07-05,GOOG,45.0880012512207,45.72549819946289,44.92499923706055,45.58549880981445,36278000.0,0.0,0.0,0.6504974365234375,0.0,0.6504974365234375,36.839382587760596,44.73949813842773,48.66550064086914,21.54865339134741,-78.45134660865259,-0.3957277160498833,-0.03350156014143137,-0.04975769545448072,1524437540.0,1.0
1135,2017-07-06,GOOG,45.20600128173828,45.74720001220703,44.98500061035156,45.33449935913086,28490000.0,0.0,0.0,-0.25099945068359375,0.25099945068359375,0.0,34.62705693564561,44.73949813842773,48.66550064086914,15.1553958596085,-84.8446041403915,-0.4589035431660804,-0.1185819567463612,-0.052659634253956034,1495947540.0,-1.0
1136,2017-07-07,GOOG,45.442501068115234,46.07699966430664,45.442501068115234,45.929500579833984,32756000.0,0.0,0.0,0.595001220703125,0.0,0.595001220703125,43.85018126604328,44.73949813842773,48.66550064086914,30.310791719216823,-69.68920828078318,-0.45570611896266655,-0.1860067891896223,-0.04867487277560267,1528703540.0,1.0
1137,2017-07-10,GOOG,46.0885009765625,46.51900100708008,45.97949981689453,46.43999862670898,23856000.0,0.0,0.0,0.5104980468749929,0.0,0.5104980468749929,50.73152539676293,44.73949813842773,48.66550064086914,43.313790228706715,-56.686209771293285,-0.40728429148605727,-0.2302622896489093,-0.024646373263412902,1552559540.0,1.0
1138,2017-07-11,GOOG,46.47700119018555,46.57149887084961,46.09999847412109,46.50450134277344,22264000.0,0.0,0.0,0.06450271606446023,0.0,0.06450271606446023,51.596363339254985,44.73949813842773,48.66550064086914,44.9567518932586,-55.043248106741395,-0.35956003002789316,-0.2561218377247061,0.0029762972348144068,1574823540.0,1.0
1139,2017-07-12,GOOG,46.93399810791016,47.31499862670898,46.7234992980957,47.19150161743164,30642000.0,0.0,0.0,0.6870002746582031,0.0,0.6870002746582031,60.18524276262933,44.73949813842773,48.66550064086914,62.455474174535475,-37.544525825464525,-0.26326823597793236,-0.25755111737535136,0.0035513362289916195,1605465540.0,1.0
1140,2017-07-13,GOOG,47.31449890136719,47.72249984741211,47.1505012512207,47.358001708984375,25894000.0,0.0,0.0,0.16650009155273438,0.0,0.16650009155273438,62.067485453378175,44.73949813842773,48.66550064086914,66.69643152107805,-33.30356847892195,-0.17154368078954718,-0.24034963005819052,0.032000829283827414,1631359540.0,1.0
1141,2017-07-14,GOOG,47.59999847412109,47.84550094604492,47.40024948120117,47.79949951171875,21076000.0,0.0,0.0,0.441497802734375,0.0,0.441497802734375,66.8607962857977,44.73949813842773,48.66550064086914,77.94191092308623,-22.05808907691377,-0.06250560136923866,-0.20478082432040015,0.052006623173753486,1652435540.0,1.0
1142,2017-07-17,GOOG,47.84999847412109,48.0369987487793,47.46205139160156,47.67100143432617,23310000.0,0.0,0.0,-0.12849807739257812,0.12849807739257812,0.0,64.13896081926734,44.73949813842773,48.0369987487793,88.90076583142456,-11.099234168575437,0.01338484899849135,-0.16114768965662185,0.060887948757500476,1629125540.0,-1.0
1143,2017-07-18,GOOG,47.650001525878906,48.402000427246094,47.52999877929688,48.27000045776367,23080000.0,0.0,0.0,0.5989990234375,0.0,0.5989990234375,70.58066244684633,44.73949813842773,48.402000427246094,96.39590752242208,-3.604092477577919,0.12047404304799869,-0.10482334311569773,0.05888937750026879,1652205540.0,1.0
1144,2017-07-19,GOOG,48.391998291015625,48.652000427246094,48.20149993896485,48.54449844360352,24490000.0,0.0,0.0,0.27449798583985086,0.0,0.27449798583985086,73.1325693439609,44.73949813842773,48.652000427246094,97.25234707338566,-2.7476529266143435,0.2249001849139276,-0.03887863750977264,0.07080698209643144,1676695540.0,1.0
1145,2017-07-20,GOOG,48.75,48.79499816894531,48.07550048828125,48.407501220703125,32490000.0,0.0,0.0,-0.13699722290039773,0.13699722290039773,0.0,69.65325352341198,44.73949813842773,48.79499816894531,90.44514991181659,-9.554850088183404,0.2932240197636773,0.027541893944917364,0.05395226618155613,1644205540.0,-1.0
1146,2017-07-21,GOOG,48.11249923706055,48.6614990234375,48.00749969482422,48.64599990844727,34220000.0,0.0,0.0,0.23849868774414773,0.0,0.23849868774414773,72.30040379276411,44.73949813842773,48.79499816894531,96.3260199882424,-3.6739800117576076,0.3624380418761035,0.09452112353115462,0.04750218232068515,1678425540.0,1.0
1147,2017-07-24,GOOG,48.61100006103516,49.310001373291016,48.53850173950195,49.016998291015625,64966000.0,0.0,0.0,0.37099838256835227,0.0,0.37099838256835227,76.05015978876615,44.92499923706055,49.310001373291016,93.31806295247856,-6.681937047521449,0.44213051659214386,0.16404300214335252,0.05402696245946559,1743391540.0,1.0
1148,2017-07-25,GOOG,47.69049835205078,47.98500061035156,47.27000045776367,47.53499984741211,93220000.0,0.0,0.0,-1.4819984436035156,1.4819984436035156,0.0,46.83021629201906,44.98500061035156,49.310001373291016,58.95950953144941,-41.04049046855059,0.3813070181865612,0.20749580535199427,0.007278815426665419,1650171540.0,-1.0
1149,2017-07-26,GOOG,47.73400115966797,47.75,47.11394882202149,47.38999938964844,41766000.0,0.0,0.0,-0.14500045776367188,0.14500045776367188,0.0,44.88335897150463,45.442501068115234,49.310001373291016,50.35547945340596,-49.644520546594045,0.31774091291116946,0.22954482686382932,0.0006756552115667613,1608405540.0,-1.0
1150,2017-07-27,GOOG,47.5890007019043,47.5890007019043,46.0,46.704498291015625,64260000.0,0.0,0.0,-0.6855010986328125,0.6855010986328125,0.0,36.586471865558224,45.97949981689453,49.310001373291016,21.76844723968612,-78.23155276031389,0.20963358138953225,0.22556257776896993,-0.022908215188208625,1544145540.0,-1.0
1151,2017-07-28,GOOG,46.470001220703125,47.19150161743164,46.375,47.07649993896485,36928000.0,0.0,0.0,0.37200164794922586,0.0,0.37200164794922586,43.165021355417664,46.0,49.310001373291016,32.52264327293996,-67.47735672706003,0.15222046357919083,0.2108941549310141,-0.012470925247507814,1581073540.0,1.0
1152,2017-07-31,GOOG,47.09450149536133,47.179500579833984,46.30199813842773,46.525001525878906,39402000.0,0.0,0.0,-0.5514984130859446,0.5514984130859446,0.0,36.65950038088473,46.0,49.310001373291016,15.861066708770458,-84.13893329122955,0.061509794580423716,0.18101728286089602,-0.03615079584288883,1541671540.0,-1.0
1153,2017-08-01,GOOG,46.61899948120117,46.87234878540039,46.4630012512207,46.541500091552734,25554000.0,0.0,0.0,0.016498565673828125,0.0,0.016498565673828125,36.98731471388157,46.0,49.310001373291016,16.35951259483437,-83.64048740516563,-0.008944659305946345,0.14302489442752755,-0.041261078315141475,1567225540.0,1.0
1154,2017-08-02,GOOG,46.43050003051758,46.630001068115234,45.83399963378906,46.51950073242188,36488000.0,0.0,0.0,-0.02199935913085227,0.02199935913085227,0.0,36.6951238998487,45.83399963378906,49.310001373291016,19.72096535058234,-80.27903464941765,-0.0657970189560686,0.10126051175080832,-0.03900222983362289,1530737540.0,-1.0
1155,2017-08-03,GOOG,46.516998291015625,46.61199951171875,46.11199951171875,46.182498931884766,24050000.0,0.0,0.0,-0.3370018005371165,0.3370018005371165,0.0,32.19910930241845,45.83399963378906,49.310001373291016,10.025866619549985,-89.97413338045001,-0.13647297691332483,0.053713814017981684,-0.05064138842245747,1506687540.0,-1.0
1156,2017-08-04,GOOG,46.337501525878906,46.51535034179688,46.1515007019043,46.39799880981445,21646000.0,0.0,0.0,0.2154998779296875,0.0,0.2154998779296875,37.82032815227987,45.83399963378906,49.310001373291016,16.22551478084707,-83.77448521915292,-0.1730997573935582,0.008351099735673693,-0.05343043377834111,1528333540.0,1.0
1157,2017-08-07,GOOG,46.45299911499024,46.584999084472656,46.32500076293945,46.46799850463867,20644000.0,0.0,0.0,0.06999969482421875,0.0,0.06999969482421875,39.694247355218884,45.83399963378906,49.310001373291016,18.239313969401227,-81.76068603059878,-0.1942392848790675,-0.032166977187274556,-0.022446646601420484,1548977540.0,1.0
1158,2017-08-08,GOOG,46.35449981689453,46.79069900512695,46.28049850463867,46.339500427246094,21232000.0,0.0,0.0,-0.12849807739257812,0.12849807739257812,0.0,37.31245111563527,45.83399963378906,49.310001373291016,14.542593224635732,-85.45740677536426,-0.21883859851435972,-0.06950130145269161,-0.02216710225642682,1527745540.0,-1.0
1159,2017-08-09,GOOG,46.03049850463867,46.29899978637695,45.86249923706055,46.14500045776367,23842000.0,0.0,0.0,-0.19449996948242188,0.19449996948242188,0.0,33.773135955022866,45.83399963378906,49.310001373291016,8.947084819904896,-91.05291518009511,-0.2511333449564077,-0.10582771015343484,-0.01197952774839206,1503903540.0,-1.0
1160,2017-08-10,GOOG,45.87749862670898,45.9630012512207,45.30649948120117,45.36199951171875,36480000.0,0.0,0.0,-0.7830009460449219,0.7830009460449219,0.0,23.443606538220294,45.30649948120117,49.310001373291016,1.386287105976785,-98.61371289402322,-0.336035192195709,-0.15186920656188968,-0.036419454068781,1467423540.0,-1.0
1161,2017-08-11,GOOG,45.39849853515625,45.88899993896485,45.27899932861328,45.71950149536133,24136000.0,0.0,0.0,0.3575019836425781,0.0,0.3575019836425781,34.067269540620615,45.27899932861328,47.98500061035156,16.278712420456692,-83.72128757954331,-0.37020559584252055,-0.19553648441801588,-0.017313272522291645,1491559540.0,1.0
1162,2017-08-14,GOOG,46.12649917602539,46.2333984375,45.90950012207031,46.13349914550781,21290000.0,0.0,0.0,0.4139976501464844,0.0,0.4139976501464844,44.380349851035014,45.27899932861328,47.75,34.581124432272546,-65.41887556772745,-0.3597329588493636,-0.2283757793042855,-0.00876639010866287,1512849540.0,1.0
1163,2017-08-15,GOOG,46.21149826049805,46.32749938964844,45.99100112915039,46.11100006103516,17668000.0,0.0,0.0,-0.022499084472649145,0.022499084472649145,0.0,43.949273777589376,45.27899932861328,47.5890007019043,36.01732631165263,-63.98267368834737,-0.34922317923887647,-0.25254525929120375,-0.008781278065222553,1495181540.0,-1.0
1164,2017-08-16,GOOG,46.26449966430664,46.6349983215332,46.17224884033203,46.34799957275391,20134000.0,0.0,0.0,0.23699951171875,0.0,0.23699951171875,49.86776216676037,45.27899932861328,47.19150161743164,55.89537070834643,-44.10462929165358,-0.3181033261392656,-0.2656568726608161,0.003583622469482295,1515315540.0,1.0
1165,2017-08-17,GOOG,46.28900146484375,46.34299850463867,45.54899978637695,45.54899978637695,25544000.0,0.0,0.0,-0.7989997863769602,0.7989997863769602,0.0,35.348426133322874,45.27899932861328,47.179500579833984,14.206802420690279,-85.79319757930972,-0.35383444041733725,-0.28329238621212033,-0.018298181930594626,1489771540.0,-1.0
1166,2017-08-18,GOOG,45.51549911499024,45.76374816894531,45.35770034790039,45.53350067138672,26854000.0,0.0,0.0,-0.015499114990234375,0.015499114990234375,0.0,35.11955866235054,45.27899932861328,46.87234878540039,15.972725988599118,-84.02727401140088,-0.37903299849291017,-0.3024405086682783,-0.02011056777404918,1462917540.0,-1.0
1167,2017-08-21,GOOG,45.5,45.650001525878906,45.16999816894531,45.33300018310547,18868000.0,0.0,0.0,-0.20050048828125,0.20050048828125,0.0,32.02460460809215,45.16999816894531,46.79069900512695,10.057501700572193,-89.94249829942781,-0.41045033509885087,-0.32404247395439284,-0.021720135842224875,1444049540.0,-1.0
1168,2017-08-22,GOOG,45.63600158691406,46.292999267578125,45.57374954223633,46.234500885009766,23334000.0,0.0,0.0,0.9015007019042969,0.0,0.9015007019042969,53.35196312554213,45.16999816894531,46.79069900512695,65.68162934822776,-34.31837065177225,-0.358472974907734,-0.3309285741450611,0.001939547651061746,1467383540.0,1.0
1169,2017-08-23,GOOG,46.09650039672852,46.49649810791016,45.96799850463867,46.34999847412109,21804000.0,0.0,0.0,0.11549758911132102,0.0,0.11549758911132102,55.41964447869612,45.16999816894531,46.79069900512695,72.80802717149491,-27.19197282850509,-0.304451326909728,-0.3256331246979945,0.021780322142702202,1489187540.0,1.0
1170,2017-08-24,GOOG,46.43299865722656,46.54199981689453,45.775001525878906,46.06399917602539,25406000.0,0.0,0.0,-0.285999298095696,0.285999298095696,0.0,49.189952195723436,45.16999816894531,46.79069900512695,55.161383712637424,-44.83861628736257,-0.281471901951285,-0.3168008801486526,0.0075350270540244235,1463781540.0,-1.0
1171,2017-08-25,GOOG,46.17449951171875,46.27774810791016,45.775001525878906,45.79449844360352,21068000.0,0.0,0.0,-0.2695007324218679,0.2695007324218679,0.0,43.8326793289409,45.16999816894531,46.79069900512695,38.532729836157074,-61.467270163842926,-0.2817590559012402,-0.3097925152991701,-0.007348254699585222,1442713540.0,-1.0
1172,2017-08-28,GOOG,45.79999923706055,45.962249755859375,45.59349822998047,45.69049835205078,21730000.0,0.0,0.0,-0.10400009155274148,0.10400009155274148,0.0,41.80536511160956,45.16999816894531,46.6349983215332,35.529019037029904,-64.4709809629701,-0.28706940825483684,-0.3052478938903035,-0.009119336132978773,1420983540.0,-1.0
1173,2017-08-29,GOOG,45.255001068115234,46.166500091552734,45.25,46.06449890136719,23712000.0,0.0,0.0,0.37400054931640625,0.0,0.37400054931640625,51.17552596875462,45.16999816894531,46.6349983215332,61.058064112946276,-38.941935887053724,-0.25812369282281367,-0.29582305367680556,-0.006116783334773834,1444695540.0,1.0
1174,2017-08-30,GOOG,46.00249862670898,46.54095077514648,45.98249816894531,46.47850036621094,26024000.0,0.0,0.0,0.41400146484375,0.0,0.41400146484375,59.503814460808734,45.16999816894531,46.6349983215332,89.3175468244276,-10.6824531755724,-0.19947808732216998,-0.27655406040587843,0.020406607920992803,1470719540.0,1.0
1175,2017-08-31,GOOG,46.5880012512207,47.0989990234375,46.5880012512207,46.96649932861328,31652000.0,0.0,0.0,0.48799896240234375,0.0,0.48799896240234375,67.12965011858758,45.16999816894531,47.0989990234375,93.13117490250674,-6.868825097493257,-0.11232872889131329,-0.2437089941029654,0.031471304338501316,1502371540.0,1.0
1176,2017-09-01,GOOG,47.05649948120117,47.124000549316406,46.75749969482422,46.867000579833984,18948000.0,0.0,0.0,-0.09949874877929688,0.09949874877929688,0.0,64.28185744114367,45.16999816894531,47.124000549316406,86.84750990765868,-13.152490092341331,-0.05070643966558919,-0.20510848321549016,0.03383849272125161,1483423540.0,-1.0
1177,2017-09-05,GOOG,46.65399932861328,46.84999847412109,46.09799957275391,46.42250061035156,26528000.0,0.0,0.0,-0.4444999694824219,0.4444999694824219,0.0,52.74740229562425,45.16999816894531,47.124000549316406,64.09933037893134,-35.90066962106866,-0.037307704194851965,-0.17154832741136253,0.004066221582220031,1456895540.0,-1.0
1178,2017-09-06,GOOG,46.50749969482422,46.54574966430664,45.9635009765625,46.39049911499024,30554000.0,0.0,0.0,-0.03200149536132102,0.03200149536132102,0.0,51.972707826334194,45.16999816894531,47.124000549316406,62.46158952033303,-37.53841047966697,-0.028937786242956065,-0.14302621917768124,0.0008738002632679986,1426341540.0,-1.0
1179,2017-09-07,GOOG,46.58649826049805,46.820499420166016,46.180999755859375,46.79750061035156,24254000.0,0.0,0.0,0.407001495361321,0.0,0.407001495361321,60.48852390115339,45.16999816894531,47.124000549316406,83.29070925170333,-16.709290748296663,0.010416972879156106,-0.11233758076631377,0.01592352916478723,1450595540.0,1.0
1180,2017-09-08,GOOG,46.824501037597656,46.8494987487793,46.24399948120117,46.32500076293945,20230000.0,0.0,0.0,-0.4724998474121094,0.4724998474121094,0.0,48.879007597098415,45.16999816894531,47.124000549316406,59.10957968100268,-40.89042031899733,0.0034394661541554683,-0.08918217138221991,0.01158441160763557,1430365540.0,-1.0
1181,2017-09-11,GOOG,46.712501525878906,46.91899871826172,46.34600067138672,46.45399856567383,25340000.0,0.0,0.0,0.128997802734375,0.0,0.128997802734375,51.79357821593511,45.25,47.124000549316406,64.24750334854598,-35.752496651454024,0.008223985420741542,-0.06970094002162762,0.01671026233376116,1455705540.0,1.0
1182,2017-09-12,GOOG,46.62950134277344,46.67399978637695,46.19305038452149,46.60350036621094,22688000.0,0.0,0.0,0.14950180053710938,0.0,0.14950180053710938,55.20851584741798,45.25,47.124000549316406,72.22518513693416,-27.774814863065846,0.023804889328623347,-0.05099977415157742,0.01170101656804845,1478393540.0,1.0
1183,2017-09-13,GOOG,46.53300094604492,46.86249923706055,46.49300003051758,46.75450134277344,22052000.0,0.0,0.0,0.1510009765625,0.0,0.1510009765625,58.62440211319729,45.25,47.124000549316406,80.28286562254458,-19.71713437745543,0.04778653138304634,-0.03124251304465267,0.005938250468234818,1500445540.0,1.0
1184,2017-09-14,GOOG,46.5625,46.63850021362305,46.20000076293945,46.25550079345703,27952000.0,0.0,0.0,-0.49900054931640625,0.49900054931640625,0.0,45.417514380558764,45.25,47.124000549316406,53.655309430075434,-46.344690569924566,0.026224679698067632,-0.019749074496108607,-0.015138418773380624,1472493540.0,-1.0
1185,2017-09-15,GOOG,46.233001708984375,46.324501037597656,45.81800079345703,46.01449966430664,50108000.0,0.0,0.0,-0.24100112915039062,0.24100112915039062,0.0,40.35169395308357,45.25,47.124000549316406,40.795060843792875,-59.204939156207125,-0.010192526992447881,-0.017837764995376464,-0.018189790363801528,1422385540.0,-1.0
1186,2017-09-18,GOOG,46.0004997253418,46.104000091552734,45.52999877929688,45.75,26138000.0,0.0,0.0,-0.2644996643066406,0.2644996643066406,0.0,35.35753497792581,45.25,47.124000549316406,26.68088865728395,-73.31911134271604,-0.0597080607033007,-0.026211824136961312,-0.014486522731642859,1396247540.0,-1.0
1187,2017-09-19,GOOG,45.87099838256836,46.12099838256836,45.62749862670898,46.09049987792969,18734000.0,0.0,0.0,0.3404998779296875,0.0,0.3404998779296875,45.39595083269136,45.52999877929688,47.124000549316406,35.16314154569227,-64.83685845430773,-0.07065946510682153,-0.03510135233093336,-0.006466824948723526,1414981540.0,1.0
1188,2017-09-20,GOOG,46.14899826049805,46.69400024414063,46.09999847412109,46.57899856567383,33396000.0,0.0,0.0,0.4884986877441406,0.0,0.4884986877441406,56.56224352907804,45.52999877929688,47.124000549316406,65.80919834010581,-34.190801659894184,-0.0394658328951607,-0.035974248443778827,-0.004669096465151901,1448377540.0,1.0
1189,2017-09-21,GOOG,46.650001525878906,46.82649993896485,46.19150161743164,46.622501373291016,25812000.0,0.0,0.0,0.0435028076171875,0.0,0.0435028076171875,57.45621180721083,45.52999877929688,47.124000549316406,68.53835513499787,-31.461644865002125,-0.011106314937698869,-0.031000661742562836,0.00642203141828257,1474189540.0,1.0
1190,2017-09-22,GOOG,46.38750076293945,46.73649978637695,46.32400131225586,46.42649841308594,21054000.0,0.0,0.0,-0.19600296020507812,0.19600296020507812,0.0,51.90304394769833,45.52999877929688,46.91899871826172,64.54281304412288,-35.45718695587713,-0.004396315472426693,-0.02567979248853561,-0.0005919867705039827,1453135540.0,-1.0
1191,2017-09-25,GOOG,46.272499084472656,46.31999969482422,45.48500061035156,46.04850006103516,37136000.0,0.0,0.0,-0.37799835205077414,0.37799835205077414,0.0,42.71610829987889,45.48500061035156,46.91899871826172,39.29568997164294,-60.70431002835706,-0.029242807616540745,-0.026392395514136646,-0.01190898324835199,1415999540.0,-1.0
1192,2017-09-26,GOOG,46.18600082397461,46.54100036621094,46.05699920654297,46.24300003051758,33338000.0,0.0,0.0,0.19449996948241477,0.0,0.19449996948241477,48.16352779709335,45.48500061035156,46.91899871826172,52.85916459615764,-47.14083540384237,-0.03286051406569612,-0.027686019224448542,-0.010940151163325806,1449337540.0,1.0
1193,2017-09-27,GOOG,46.387001037597656,47.494998931884766,46.387001037597656,47.2244987487793,44788000.0,0.0,0.0,0.9814987182617188,0.0,0.9814987182617188,66.63680769950106,45.48500061035156,47.494998931884766,86.54226820950107,-13.457731790498928,0.04297577338179792,-0.013553660703199246,0.0209488155722084,1494125540.0,1.0
1194,2017-09-28,GOOG,47.06800079345703,47.53450012207031,47.02750015258789,47.47499847412109,20406000.0,0.0,0.0,0.25049972534178977,0.0,0.25049972534178977,69.8056437616668,45.48500061035156,47.53450012207031,97.0967717918934,-2.9032282081066034,0.12188479977526612,0.013534031392493836,0.03173996936768497,1514531540.0,1.0
1195,2017-09-29,GOOG,47.59999847412109,47.98929977416992,47.57550048828125,47.95550155639648,31620000.0,0.0,0.0,0.4805030822753906,0.0,0.4805030822753906,75.05047267395335,45.48500061035156,47.98929977416992,98.6503921631347,-1.349607836865294,0.22064984069496063,0.05495719325298721,0.048207684292819186,1546151540.0,1.0
1196,2017-10-02,GOOG,47.999000549316406,48.12699890136719,47.391998291015625,47.66350173950195,25668000.0,0.0,0.0,-0.29199981689452414,0.29199981689452414,0.0,66.90195405819544,45.48500061035156,48.12699890136719,82.45656844512723,-17.543431554872765,0.2722218977237034,0.09841013414713047,0.0341285485238465,1520483540.0,-1.0
1197,2017-10-03,GOOG,47.70000076293945,47.900001525878906,47.45700073242188,47.88949966430664,17766000.0,0.0,0.0,0.2259979248046875,0.0,0.2259979248046875,69.8274962088744,45.48500061035156,48.12699890136719,91.01062109433657,-8.989378905663429,0.3275534361468928,0.14423879454708297,0.02813502091044473,1538249540.0,1.0
1198,2017-10-04,GOOG,47.84999847412109,48.01950073242188,47.53450012207031,47.58399963378906,19048000.0,0.0,0.0,-0.3055000305175781,0.3055000305175781,0.0,61.367038071606295,45.48500061035156,48.12699890136719,79.44740276991672,-20.552597230083283,0.3428011810679692,0.18395127185126023,0.020623051792087344,1519201540.0,-1.0
1199,2017-10-05,GOOG,47.77450180053711,48.545501708984375,47.75899887084961,48.49800109863281,24276000.0,0.0,0.0,0.91400146484375,0.0,0.91400146484375,72.76039600041828,45.48500061035156,48.545501708984375,98.44794663289676,-1.552053367103249,0.4237526515655432,0.23191154779411685,0.04461897313718133,1543477540.0,1.0
1200,2017-10-06,GOOG,48.334999084472656,48.97299957275391,48.167999267578125,48.94449996948242,23478000.0,0.0,0.0,0.4464988708496094,0.0,0.4464988708496094,76.64306959165731,45.48500061035156,48.97299957275391,99.18292397507302,-0.8170760249269813,0.5179652218343804,0.2891222826021696,0.0628902115076222,1566955540.0,1.0
1201,2017-10-09,GOOG,49.0,49.2712516784668,48.80550003051758,48.84999847412109,17828000.0,0.0,0.0,-0.09450149536133523,0.09450149536133523,0.0,74.06491564031663,45.48500061035156,49.2712516784668,88.87413442037253,-11.125865579627469,0.5783371707417189,0.3469652602300795,0.0563760664723969,1549127540.0,-1.0
1202,2017-10-10,GOOG,49.0,49.07849884033203,48.30400085449219,48.630001068115234,19368000.0,0.0,0.0,-0.21999740600585227,0.21999740600585227,0.0,67.92720398566202,45.48500061035156,49.2712516784668,83.06370605606004,-16.93629394393996,0.6014967431017837,0.3978715568044204,0.029762143729948454,1529759540.0,-1.0
1203,2017-10-11,GOOG,48.68600082397461,49.53549957275391,48.61249923706055,49.462501525878906,33866000.0,0.0,0.0,0.8325004577636719,0.0,0.8325004577636719,76.44881261868635,45.48500061035156,49.53549957275391,98.19780112147684,-1.8021988785231529,0.679197336389521,0.4541367127214405,0.04186420464744667,1563625540.0,1.0
1204,2017-10-12,GOOG,49.372501373291016,49.70600128173828,49.25,49.39149856567383,25248000.0,0.0,0.0,-0.07100296020507812,0.07100296020507812,0.0,74.5008270387183,45.48500061035156,49.70600128173828,92.54909580573153,-7.450904194268465,0.726669675201002,0.5086433052173529,0.029944364310080074,1538377540.0,-1.0
1205,2017-10-13,GOOG,49.59999847412109,49.86050033569336,49.45000076293945,49.48400115966797,23396000.0,0.0,0.0,0.09250259399414062,0.0,0.09250259399414062,75.44150736899833,46.05699920654297,49.86050033569336,90.10124716041582,-9.89875283958418,0.7629610914522402,0.5595068624643303,0.03819483155299186,1561773540.0,1.0
1206,2017-10-16,GOOG,49.60499954223633,49.695350646972656,49.20000076293945,49.59999847412109,18210000.0,0.0,0.0,0.1159973144531179,0.0,0.1159973144531179,76.68595201623437,46.387001037597656,49.86050033569336,92.50030475851574,-7.499695241484264,0.7919531709621239,0.6059961241638891,0.03571761705185095,1579983540.0,1.0
1207,2017-10-17,GOOG,49.51449966430664,49.821998596191406,49.429500579833984,49.60900115966797,25804000.0,0.0,0.0,0.009002685546882105,0.0,0.009002685546882105,76.79126873748693,47.02750015258789,49.86050033569336,91.12251465689272,-8.877485343107288,0.8063608187589395,0.6460690630828992,0.04255635384716516,1605787540.0,1.0
1208,2017-10-18,GOOG,49.5885009765625,49.83599853515625,49.348751068115234,49.64049911499024,21152000.0,0.0,0.0,0.03149795532227273,0.0,0.03149795532227273,77.2069310380472,47.391998291015625,49.86050033569336,91.08766301500717,-8.912336984992827,0.8109722222293456,0.6790496949121886,0.023557631046151162,1626939540.0,1.0
1209,2017-10-19,GOOG,49.29999923706055,49.44400024414063,48.91949844360352,49.22249984741211,26272000.0,0.0,0.0,-0.4179992675781321,0.4179992675781321,0.0,60.59058740756663,47.391998291015625,49.86050033569336,74.15434637144318,-25.845653628556814,0.7719986255719675,0.6976394810441444,0.00567990025647469,1600667540.0,-1.0
1210,2017-10-20,GOOG,49.47200012207031,49.54999923706055,49.229000091552734,49.40999984741211,23664000.0,0.0,0.0,0.1875,0.0,0.1875,64.54048326942487,47.45700073242188,49.86050033569336,81.25647752685043,-18.743522473149564,0.7476233162184869,0.7076362480790129,0.011463692748889143,1624331540.0,1.0
1211,2017-10-23,GOOG,49.47600173950195,49.47600173950195,48.305999755859375,48.42250061035156,29568000.0,0.0,0.0,-0.9874992370605469,0.9874992370605469,0.0,40.110360382440874,47.53450012207031,49.86050033569336,38.1771456030124,-61.8228543969876,0.6412310598800985,0.6943552104392301,-0.004266922747400925,1594763540.0,-1.0
1212,2017-10-24,GOOG,48.5,48.61149978637695,48.04999923706055,48.527000427246094,24244000.0,0.0,0.0,0.10449981689453125,0.0,0.10449981689453125,42.756112925873595,47.75899887084961,49.86050033569336,36.54537335540646,-63.45462664459354,0.5589039947532299,0.6672649673020301,-0.01891333979829868,1619007540.0,1.0
1213,2017-10-25,GOOG,48.41849899291992,48.804500579833984,48.0260009765625,48.666500091552734,24226000.0,0.0,0.0,0.13949966430664062,0.0,0.13949966430664062,46.403166906238354,48.0260009765625,49.86050033569336,34.91410949817323,-65.08589050182677,0.4991616349574599,0.6336443008331161,-0.014678608569794527,1643233540.0,1.0
1214,2017-10-26,GOOG,49.0,49.380001068115234,48.61000061035156,48.62799835205078,40842000.0,0.0,0.0,-0.038501739501953125,0.038501739501953125,0.0,45.48039909305584,48.0260009765625,49.86050033569336,32.81534945716704,-67.18465054283296,0.4435951272944365,0.5956344661253802,-0.017298577066457432,1602391540.0,-1.0
1215,2017-10-27,GOOG,50.45949935913086,52.41949844360352,50.40999984741211,50.9635009765625,103354000.0,0.0,0.0,2.3355026245117188,0.0,2.3355026245117188,77.20610441601559,48.0260009765625,52.41949844360352,66.8601728357972,-33.1398271642028,0.5813128007127233,0.5927701330428489,0.027489970652979423,1705745540.0,1.0
1216,2017-10-30,GOOG,50.70000076293945,51.24850082397461,50.375,50.855499267578125,41702000.0,0.0,0.0,-0.108001708984375,0.108001708984375,0.0,74.88107286378757,48.0260009765625,52.41949844360352,64.40195566839064,-35.598044331609366,0.6739710945463884,0.6090103253435568,0.025126450417702673,1664043540.0,-1.0
1217,2017-10-31,GOOG,50.76100158691406,51.20000076293945,50.52099990844727,50.83200073242188,26614000.0,0.0,0.0,-0.023498535156242895,0.023498535156242895,0.0,74.31920224892878,48.0260009765625,52.41949844360352,63.86710762688104,-36.13289237311896,0.7370115146081986,0.6346105631964852,0.02400261155053207,1637429540.0,-1.0
1218,2017-11-01,GOOG,50.86050033569336,51.48350143432617,50.84749984741211,51.275001525878906,27468000.0,0.0,0.0,0.44300079345702414,0.0,0.44300079345702414,77.92268277991136,48.0260009765625,52.41949844360352,73.95020877307063,-26.04979122692937,0.8133422601220488,0.670356902581598,0.04169844450869986,1664897540.0,1.0
1219,2017-11-02,GOOG,51.0880012512207,51.40449905395508,50.6505012512207,51.27899932861328,20980000.0,0.0,0.0,0.003997802734375,0.0,0.003997802734375,77.95489277423647,48.0260009765625,52.41949844360352,74.0412024009119,-25.9587975990881,0.8641956061402354,0.7091246432933255,0.037826340558045235,1685877540.0,1.0
1220,2017-11-03,GOOG,51.105499267578125,51.63249969482422,51.01549911499024,51.624000549316406,21528000.0,0.0,0.0,0.345001220703125,0.0,0.345001220703125,80.7512579261266,48.0260009765625,52.41949844360352,81.8937441012598,-18.1062558987402,0.9217110531776456,0.7516419252701896,0.06611595639652768,1707405540.0,1.0
1221,2017-11-06,GOOG,51.449501037597656,51.743499755859375,51.25,51.29499816894531,22504000.0,0.0,0.0,-0.32900238037109375,0.32900238037109375,0.0,70.8608473177158,48.0260009765625,52.41949844360352,74.40535056423852,-25.594649435761486,0.930023979309226,0.787318336077997,0.05704036345393182,1684901540.0,-1.0
1222,2017-11-07,GOOG,51.36349868774414,51.69850158691406,51.25650024414063,51.666500091552734,22246000.0,0.0,0.0,0.3715019226074219,0.0,0.3715019226074219,74.87091444703427,48.0260009765625,52.41949844360352,82.8610723529579,-17.138927647042106,0.9555738727620877,0.8209694434148153,0.06164404661022105,1707147540.0,1.0
1223,2017-11-08,GOOG,51.5260009765625,52.17610168457031,51.42250061035156,51.99250030517578,21774000.0,0.0,0.0,0.3260002136230469,0.0,0.3260002136230469,77.94419596334721,48.0260009765625,52.41949844360352,90.28113384311747,-9.718866156882537,0.9907075798559148,0.8549170707030352,0.06918857586461002,1728921540.0,1.0
1224,2017-11-09,GOOG,51.699501037597656,51.699501037597656,50.98329925537109,51.5629997253418,24904000.0,0.0,0.0,-0.4295005798339844,0.4295005798339844,0.0,65.72482441953497,48.0260009765625,52.41949844360352,80.50530984285352,-19.494690157146472,0.9726817191608461,0.8784700003945974,0.011763296031310766,1704017540.0,-1.0
1225,2017-11-10,GOOG,51.323001861572266,51.53799819946289,51.26399993896485,51.40349960327149,14400000.0,0.0,0.0,-0.1595001220703054,0.1595001220703054,0.0,61.58764943645148,48.0260009765625,52.41949844360352,76.87494193512539,-23.125058064874597,0.9347505454122498,0.8897261093981279,0.01077563574413154,1689617540.0,-1.0
1226,2017-11-13,GOOG,51.17100143432617,51.57899856567383,51.12850189208984,51.28749847412109,17716000.0,0.0,0.0,-0.11600112915040484,0.11600112915040484,0.0,58.49762581676043,48.0260009765625,52.41949844360352,74.2346506860552,-25.765349313944796,0.8851263101452318,0.8888061495475487,0.008960846221594432,1671901540.0,-1.0
1227,2017-11-14,GOOG,51.12950134277344,51.34049987792969,50.70750045776367,51.29999923706055,19184000.0,0.0,0.0,0.01250076293946023,0.0,0.01250076293946023,58.75493917212111,48.61000061035156,52.41949844360352,70.61294544464091,-29.38705455535909,0.8371572258811071,0.8784763648142604,0.0004875223878642032,1691085540.0,1.0
1228,2017-11-15,GOOG,50.96049880981445,51.204498291015625,50.77099990844727,51.045501708984375,17080000.0,0.0,0.0,-0.2544975280761719,0.2544975280761719,0.0,51.285635995249066,50.375,52.41949844360352,32.79541303062011,-67.20458696937989,0.7697325596067799,0.8567276037727645,-0.004553474574115146,1674005540.0,-1.0
1229,2017-11-16,GOOG,51.1259994506836,51.79600143432617,51.1259994506836,51.625,22594000.0,0.0,0.0,0.579498291015625,0.0,0.579498291015625,63.48260654922876,50.375,52.17610168457031,69.4019671797826,-30.59803282021739,0.7543628692494195,0.8362546568680954,1.936019434678471e-05,1696599540.0,1.0
1230,2017-11-17,GOOG,51.70050048828125,51.72100067138672,50.88750076293945,50.954498291015625,27942000.0,0.0,0.0,-0.670501708984375,0.670501708984375,0.0,47.5787183574341,50.52099990844727,52.17610168457031,26.19164505906047,-73.80835494093952,0.680237045383798,0.805051134571236,-0.0066380717435298164,1668657540.0,-1.0
1231,2017-11-20,GOOG,51.01300048828125,51.13050079345703,50.875,50.91899871826172,19070000.0,0.0,0.0,-0.03549957275390625,0.03549957275390625,0.0,46.861525217048005,50.6505012512207,52.17610168457031,17.599461901797078,-82.40053809820293,0.6115773935841062,0.7663563863738101,-0.014467815160044695,1649587540.0,-1.0
1232,2017-11-21,GOOG,51.16550064086914,51.75550079345703,51.13275146484375,51.7244987487793,21940000.0,0.0,0.0,0.8055000305175781,0.0,0.8055000305175781,61.898384106877856,50.6505012512207,52.17610168457031,70.39834769845497,-29.601652301545034,0.6150710888411979,0.7360993268672877,-0.005154619509033398,1671527540.0,1.0
1233,2017-11-22,GOOG,51.75,51.98529815673828,51.57149887084961,51.79800033569336,14926000.0,0.0,0.0,0.0735015869140625,0.0,0.0735015869140625,63.00073583576761,50.70750045776367,52.17610168457031,74.25432159694535,-25.74567840305467,0.6166623317868698,0.7122119278512042,0.004557543424613231,1686453540.0,1.0
1234,2017-11-24,GOOG,51.79349899291992,52.15890121459961,51.75,52.03049850463867,10740000.0,0.0,0.0,0.2324981689453125,0.0,0.2324981689453125,66.53455355530642,50.70750045776367,52.17610168457031,90.08558775017208,-9.914412249827915,0.6294284036198547,0.6956552230049344,0.012197591724421697,1697193540.0,1.0
1235,2017-11-27,GOOG,52.0,52.77299880981445,51.922000885009766,52.71049880981445,26158000.0,0.0,0.0,0.6800003051757812,0.0,0.6800003051757812,74.69188819700064,50.70750045776367,52.77299880981445,96.9740958670848,-3.025904132915203,0.6865023770800249,0.6938246538199526,0.02774555940589285,1723351540.0,1.0
1236,2017-11-28,GOOG,52.75450134277344,53.118751525878906,52.0,52.37049865722656,28488000.0,0.0,0.0,-0.3400001525878906,0.3400001525878906,0.0,65.48316852937562,50.70750045776367,53.118751525878906,68.9682721742776,-31.0317278257224,0.6962725449454439,0.6943142320450509,0.020867435401298318,1694863540.0,-1.0
1237,2017-11-29,GOOG,52.13399887084961,52.20399856567383,50.782501220703125,51.08300018310547,49188000.0,0.0,0.0,-1.2874984741210938,1.2874984741210938,0.0,42.557656761031936,50.70750045776367,53.118751525878906,15.572817377134765,-84.42718262286523,0.5932860740275459,0.67410860044155,0.0007346087875652607,1645675540.0,-1.0
1238,2017-11-30,GOOG,51.118499755859375,51.42449951171875,50.75,51.070499420166016,34480000.0,0.0,0.0,-0.012500762939453125,0.012500762939453125,0.0,42.39139027548612,50.70750045776367,53.118751525878906,15.054382648177885,-84.94561735182211,0.5048403613186139,0.6402549526169627,-0.01074093132850329,1611195540.0,-1.0
1239,2017-12-01,GOOG,50.790000915527344,51.1245002746582,50.10100173950195,50.50849914550781,38192000.0,0.0,0.0,-0.5620002746582031,0.5620002746582031,0.0,35.247931259180675,50.10100173950195,53.118751525878906,13.503352989880987,-86.496647010119,0.38496019000618276,0.5891960000948068,-0.008752890529126311,1573003540.0,-1.0
1240,2017-12-04,GOOG,50.632999420166016,50.80500030517578,49.77849960327149,49.93399810791016,38128000.0,0.0,0.0,-0.5745010375976491,0.5745010375976491,0.0,29.40361374179993,49.77849960327149,53.118751525878906,4.655292721672595,-95.3447072783274,0.2408208255512605,0.5195209651860975,-0.01934446150054192,1534875540.0,-1.0
1241,2017-12-05,GOOG,49.797000885009766,51.03049850463867,49.41400146484375,50.25749969482422,41346000.0,0.0,0.0,0.3235015869140554,0.0,0.3235015869140554,36.269277306188464,49.41400146484375,53.118751525878906,22.768019868654356,-77.23198013134565,0.15095312158057084,0.4458073964649921,-0.028361783863390277,1576221540.0,1.0
1242,2017-12-06,GOOG,50.07500076293945,51.24850082397461,50.05699920654297,50.91899871826172,25440000.0,0.0,0.0,0.6614990234375,0.0,0.6614990234375,48.16350781787211,49.41400146484375,53.118751525878906,40.62344904847515,-59.376550951524855,0.1315928411759728,0.38296448540718825,-0.01696979828825418,1601661540.0,1.0
1243,2017-12-07,GOOG,51.02149963378906,51.71200180053711,50.90354919433594,51.54650115966797,29164000.0,0.0,0.0,0.62750244140625,0.0,0.62750244140625,56.95637420721404,49.41400146484375,53.118751525878906,57.56122976426566,-42.43877023573434,0.16498207161302503,0.33936800264835565,-0.00930218542740957,1630825540.0,1.0
1244,2017-12-08,GOOG,51.8745002746582,52.102500915527344,51.6260986328125,51.852500915527344,25816000.0,0.0,0.0,0.305999755859375,0.0,0.305999755859375,60.70668378707973,49.41400146484375,53.118751525878906,65.82088968242691,-34.17911031757309,0.2136718244557656,0.31422876700983765,-0.016277552170068876,1656641540.0,1.0
1245,2017-12-11,GOOG,51.775001525878906,52.18999862670898,51.602500915527344,52.05500030517578,23856000.0,0.0,0.0,0.2024993896484375,0.0,0.2024993896484375,63.157749572772715,49.41400146484375,53.118751525878906,71.28682898500584,-28.71317101499416,0.2655378576298091,0.304490585133832,-0.006024352643952624,1680497540.0,1.0
1246,2017-12-12,GOOG,51.98149871826172,52.51549911499024,51.68450164794922,52.02399826049805,25590000.0,0.0,0.0,-0.031002044677734375,0.031002044677734375,0.0,62.46938573688284,49.41400146484375,53.118751525878906,70.45001019380587,-29.549989806194127,0.3006744685738596,0.3037273618218375,0.01842096341286914,1654907540.0,-1.0
1247,2017-12-13,GOOG,52.305999755859375,52.33324813842773,51.91899871826172,52.03049850463867,25654000.0,0.0,0.0,0.006500244140625,0.0,0.006500244140625,62.56808653505478,49.41400146484375,53.118751525878906,70.6254672161025,-29.374532783897493,0.3252952006857015,0.3080409295946103,0.01879752685742453,1680561540.0,1.0
1248,2017-12-14,GOOG,52.25,52.92499923706055,52.15549850463867,52.45750045776367,31174000.0,0.0,0.0,0.427001953125,0.0,0.427001953125,68.78943733255187,49.41400146484375,53.118751525878906,82.15126372302502,-17.84873627697497,0.3749407141202141,0.3214208864997311,0.0385875911030551,1711735540.0,1.0
1249,2017-12-15,GOOG,52.730499267578125,53.38100051879883,52.47499847412109,53.20949935913086,65518000.0,0.0,0.0,0.7519989013671875,0.0,0.7519989013671875,76.66912414293265,49.41400146484375,53.38100051879883,95.67680361564535,-4.323196384354641,0.4695524593518172,0.35104720107014836,0.06559661503855851,1777253540.0,1.0
1250,2017-12-18,GOOG,53.30400085449219,53.92449951171875,53.09999847412109,53.85699844360352,31092000.0,0.0,0.0,0.6474990844726634,0.0,0.6474990844726634,81.34766497983213,49.41400146484375,53.92449951171875,98.50346752368081,-1.496532476319193,0.5899797940142548,0.3988337196589697,0.07162112661068165,1808345540.0,1.0
1251,2017-12-19,GOOG,53.7599983215332,53.84199905395508,53.1775016784668,53.53400039672852,26774000.0,0.0,0.0,-0.322998046875,0.322998046875,0.0,72.92995477446156,49.41400146484375,53.92449951171875,91.34243910690138,-8.657560893098625,0.6518420519732686,0.4494353861218295,0.05135610959154535,1781571540.0,-1.0
1252,2017-12-20,GOOG,53.5890007019043,53.66899871826172,53.07600021362305,53.247501373291016,25372000.0,0.0,0.0,-0.2864990234375071,0.2864990234375071,0.0,65.94589711598428,49.41400146484375,53.92449951171875,84.99061231393775,-15.009387686062245,0.6700266105903268,0.49355363101552896,0.03299933410328104,1756199540.0,-1.0
1253,2017-12-21,GOOG,53.247501373291016,53.46649932861328,53.08969879150391,53.18149948120117,19914000.0,0.0,0.0,-0.06600189208984375,0.06600189208984375,0.0,64.30887726464547,49.41400146484375,53.92449951171875,83.52731732070366,-16.472682679296348,0.6713730328091714,0.5291175113742576,0.02563036579159217,1736285540.0,-1.0
1254,2017-12-22,GOOG,53.05550003051758,53.209999084472656,52.97200012207031,53.00600051879883,15102000.0,0.0,0.0,-0.17549896240234375,0.17549896240234375,0.0,59.7576770010822,49.41400146484375,53.92449951171875,79.63641745602165,-20.36358254397835,0.6507770300504205,0.5534494151094902,0.018269142407986605,1721183540.0,-1.0
1255,2017-12-26,GOOG,52.90349960327149,53.00600051879883,52.5099983215332,52.83700180053711,15212000.0,0.0,0.0,-0.16899871826171875,0.16899871826171875,0.0,55.40124158051132,50.05699920654297,53.92449951171875,71.88112151597586,-28.11887848402414,0.6137429189672687,0.5655081158810459,0.015627471305994955,1705971540.0,-1.0
1256,2017-12-27,GOOG,52.86949920654297,52.91849899291992,52.40250015258789,52.46849822998047,25438000.0,0.0,0.0,-0.3685035705566406,0.3685035705566406,0.0,46.81457072999581,50.90354919433594,53.92449951171875,51.80320333769403,-48.19679666230598,0.5483370722455518,0.5620739071539471,0.008418134323713078,1680533540.0,-1.0
1257,2017-12-28,GOOG,52.58000183105469,52.73749923706055,52.23849868774414,52.40700149536133,16742000.0,0.0,0.0,-0.061496734619140625,0.061496734619140625,0.0,45.457904567850164,51.602500915527344,53.92449951171875,34.646902076234845,-65.35309792376515,0.4859385972974266,0.546846845182643,-0.0009626642894089432,1663791540.0,-1.0
1258,2017-12-29,GOOG,52.33599853515625,52.48500061035156,52.244998931884766,52.31999969482422,17750000.0,0.0,0.0,-0.08700180053710938,0.08700180053710938,0.0,43.40460711516653,51.602500915527344,53.92449951171875,30.900052242655633,-69.09994775734435,0.424572826884436,0.5223920415230017,-0.016716933536680578,1646041540.0,-1.0
1259,2018-01-02,GOOG,52.41699981689453,53.34700012207031,52.26150131225586,53.25,24752000.0,0.0,0.0,0.9300003051757812,0.0,0.9300003051757812,63.65369542967068,51.68450164794922,53.92449951171875,69.88838593874,-30.11161406126001,0.4458438535904534,0.5070824039364921,-0.011270558351653137,1670793540.0,1.0
1260,2018-01-03,GOOG,53.21549987792969,54.31449890136719,53.16049957275391,54.124000549316406,28604000.0,0.0,0.0,0.8740005493164062,0.0,0.8740005493164062,73.81338232989926,51.91899871826172,54.31449890136719,92.04765863119978,-7.952341368800221,0.5271491878088312,0.5110957607109599,0.011021036130599793,1699397540.0,1.0
1261,2018-01-04,GOOG,54.400001525878906,54.67850112915039,54.20009994506836,54.31999969482422,20092000.0,0.0,0.0,0.1959991455078125,0.0,0.1959991455078125,75.57967202110123,52.15549850463867,54.67850112915039,85.79068325798697,-14.209316742013034,0.6004778095553789,0.5289721704798437,0.02014175865294532,1719489540.0,1.0
1262,2018-01-05,GOOG,54.70000076293945,55.212501525878906,54.59999847412109,55.11149978637695,25582000.0,0.0,0.0,0.7915000915527344,0.0,0.7915000915527344,81.41934210629316,52.23849868774414,55.212501525878906,96.60384522143566,-3.396154778564346,0.7142255654116596,0.5660228494662068,0.03629082150754326,1745071540.0,1.0
1263,2018-01-08,GOOG,55.11149978637695,55.5634994506836,55.08100128173828,55.34700012207031,20952000.0,0.0,0.0,0.23550033569335938,0.0,0.23550033569335938,82.82902144167676,52.23849868774414,55.5634994506836,93.4887434906363,-6.511256509363703,0.8139912064322914,0.6156165208594238,0.04416480361390862,1766023540.0,1.0
1264,2018-01-09,GOOG,55.470001220703125,55.52849960327149,55.06155014038086,55.3129997253418,18050000.0,0.0,0.0,-0.034000396728515625,0.034000396728515625,0.0,81.79524257029648,52.23849868774414,55.5634994506836,92.46617540260802,-7.533824597391978,0.8801666347700348,0.6685265436415461,0.0468610602500068,1747973540.0,-1.0
1265,2018-01-10,GOOG,54.85499954223633,55.22999954223633,54.80550003051758,55.13050079345703,20856000.0,0.0,0.0,-0.18249893188476562,0.18249893188476562,0.0,75.92627808401892,52.23849868774414,55.5634994506836,86.97748698127282,-13.022513018727192,0.907424771980935,0.7163061893094239,0.050735253595565855,1727117540.0,-1.0
1266,2018-01-11,GOOG,55.31499862670898,55.32624816894531,54.97949981689453,55.2760009765625,19566000.0,0.0,0.0,0.14550018310546875,0.0,0.14550018310546875,77.41690197028763,52.23849868774414,55.5634994506836,91.35343133374386,-8.646568666256137,0.9300466915593688,0.759054289759413,0.05474458372618618,1746683540.0,1.0
1267,2018-01-12,GOOG,55.12049865722656,56.214500427246094,55.057498931884766,56.11299896240234,34410000.0,0.0,0.0,0.8369979858398366,0.0,0.8369979858398366,83.99488142270589,52.23849868774414,56.214500427246094,97.44714737331903,-2.552852626680981,1.0039406651244462,0.8080315648324198,0.07249616379400203,1781093540.0,1.0
1268,2018-01-16,GOOG,56.6254997253418,56.99549865722656,55.8916015625,56.0880012512207,31506000.0,0.0,0.0,-0.02499771118163352,0.02499771118163352,0.0,83.16014765130137,52.23849868774414,56.99549865722656,80.92290494370977,-19.07709505629024,1.0483997652863124,0.8561052049231985,0.05329579814498975,1749587540.0,-1.0
1269,2018-01-17,GOOG,56.31100082397461,56.630001068115234,55.85049819946289,56.5989990234375,24052000.0,0.0,0.0,0.5109977722167969,0.0,0.5109977722167969,86.3578894581605,52.23849868774414,56.99549865722656,91.66492250719516,-8.33507749280484,1.1120481729941147,0.9072937985373819,0.0457282988877723,1773639540.0,1.0
1270,2018-01-18,GOOG,56.570499420166016,56.6254997253418,55.875,56.48949813842773,23964000.0,0.0,0.0,-0.10950088500977273,0.10950088500977273,0.0,82.48507221067706,52.23849868774414,56.99549865722656,89.36303296100525,-10.636967038994744,1.140507132103501,0.9539364652506058,0.03993922046745202,1749675540.0,-1.0
1271,2018-01-19,GOOG,56.59149932861328,56.89300155639648,56.415000915527344,56.8754997253418,35564000.0,0.0,0.0,0.3860015869140696,0.0,0.3860015869140696,85.18707175058134,52.244998931884766,56.99549865722656,97.47397244873787,-2.5260275512621306,1.1805989544974125,0.9992689630999673,0.03200783767094806,1785239540.0,1.0
1272,2018-01-22,GOOG,56.8745002746582,57.99399948120117,56.75550079345703,57.79050064086914,32360000.0,0.0,0.0,0.9150009155273438,0.0,0.9150009155273438,89.58263935784716,52.26150131225586,57.99399948120117,96.45008451229089,-3.5499154877091184,1.271547333343861,1.053724637148746,0.04414874362494037,1817599540.0,1.0
1273,2018-01-23,GOOG,57.99250030517578,58.58134841918945,57.9375,58.49850082397461,26662000.0,0.0,0.0,0.7080001831054688,0.0,0.7080001831054688,91.76448711754078,53.16049957275391,58.58134841918945,98.47168593772321,-1.5283140622767946,1.3847912649004073,1.1199379626990784,0.057590460008506206,1844261540.0,1.0
1274,2018-01-24,GOOG,58.86650085449219,58.99300003051758,58.0525016784668,58.21200180053711,28332000.0,0.0,0.0,-0.2864990234375,0.2864990234375,0.0,83.59003019667801,54.20009994506836,58.99300003051758,83.70510096065837,-16.294899039341626,1.434879422912367,1.182926254741736,0.05589466742964522,1815929540.0,-1.0
1275,2018-01-25,GOOG,58.62649917602539,58.797000885009766,58.13800048828125,58.51850128173828,29610000.0,0.0,0.0,0.3064994812011719,0.0,0.3064994812011719,85.21572428191271,54.59999847412109,58.99300003051758,89.19875755362763,-10.801242446372376,1.4822204805627237,1.2427850999059338,0.05866018250036986,1845539540.0,1.0
1276,2018-01-26,GOOG,58.75400161743164,58.79199981689453,57.90549850463867,58.79199981689453,40376000.0,0.0,0.0,0.27349853515625,0.0,0.27349853515625,86.58415336693696,54.80550003051758,58.99300003051758,95.19999489855411,-4.800005101445896,1.524237198272047,1.2990755195791566,0.04774296337800843,1885915540.0,1.0
1277,2018-01-29,GOOG,58.82400131225586,59.34450149536133,58.5989990234375,58.77899932861328,27578000.0,0.0,0.0,-0.01300048828125,0.01300048828125,0.0,86.14681855104266,54.80550003051758,59.34450149536133,87.54126494278376,-12.458735057216238,1.5387489786284547,1.3470102113890163,0.047978141801478635,1858337540.0,-1.0
1278,2018-01-30,GOOG,58.39149856567383,58.82600021362305,58.17599868774414,58.18450164794922,31126000.0,0.0,0.0,-0.5944976806640625,0.5944976806640625,0.0,68.0190414490021,54.80550003051758,59.34450149536133,74.44372167762583,-25.55627832237417,1.4851586898105182,1.3746399070733168,0.02801290927168454,1827211540.0,-1.0
1279,2018-01-31,GOOG,58.52849960327149,58.650001525878906,57.95650100708008,58.49700164794922,30774000.0,0.0,0.0,0.3125,0.0,0.3125,71.63878575451031,54.97949981689453,59.34450149536133,80.58420340150263,-19.415796598497366,1.451175885867002,1.389947102832054,0.03553764107803015,1857985540.0,1.0
1280,2018-02-01,GOOG,58.13050079345703,58.70000076293945,57.8759994506836,58.3849983215332,48242000.0,0.0,0.0,-0.11200332641601562,0.11200332641601562,0.0,68.43549305641439,55.057498931884766,59.34450149536133,77.61832050200567,-22.381679497994327,1.399078826700098,1.391773447605663,0.026540401464267394,1809743540.0,-1.0
1281,2018-02-02,GOOG,56.09999847412109,56.15349960327149,55.36389923095703,55.595001220703125,97158000.0,0.0,0.0,-2.789997100830078,2.789997100830078,0.0,29.94732729595745,55.36389923095703,59.34450149536133,5.8057041220288435,-94.19429587797116,1.119754252908244,1.3373696086661793,-0.037990662752856785,1712585540.0,-1.0
1282,2018-02-05,GOOG,54.52999877929688,55.5,52.60150146484375,52.790000915527344,75966000.0,0.0,0.0,-2.8050003051757812,2.8050003051757812,0.0,18.12338671087015,52.60150146484375,59.34450149536133,2.7954834618193667,-97.20451653818063,0.6643887732805638,1.2027734415890563,-0.09758369578776849,1636619540.0,-1.0
1283,2018-02-06,GOOG,51.35900115966797,54.08549880981445,51.1568489074707,54.02999877929688,68960000.0,0.0,0.0,1.2399978637695384,0.0,1.2399978637695384,31.84848899663156,51.1568489074707,59.34450149536133,35.091252846701266,-64.90874715329873,0.398966773835582,1.0420121080383615,-0.07184090723369763,1705579540.0,1.0
1284,2018-02-07,GOOG,54.07699966430664,54.0890007019043,52.41299819946289,52.42900085449219,47384000.0,0.0,0.0,-1.6009979248046946,1.6009979248046946,0.0,25.484263665715943,51.1568489074707,59.34450149536133,15.53744413756602,-84.46255586243399,0.05875350079500663,0.8453603865896905,-0.10406111390187689,1658195540.0,-1.0
1285,2018-02-08,GOOG,52.77050018310547,52.930999755859375,50.03300094604492,50.07600021362305,57182000.0,0.0,0.0,-2.3530006408691406,2.3530006408691406,0.0,19.034127616331006,50.03300094604492,59.34450149536133,0.46178666210014613,-99.53821333789985,-0.3961686702411029,0.5970545752235318,-0.14825145649777416,1601013540.0,-1.0
1286,2018-02-09,GOOG,50.86249923706055,52.19850158691406,49.62799835205078,51.88899993896485,70118000.0,0.0,0.0,1.812999725341804,0.0,1.812999725341804,33.90646881853101,49.62799835205078,59.34450149536133,23.26970468249872,-76.73029531750129,-0.6034476732165928,0.3569541255355068,-0.11721872553713952,1671131540.0,1.0
1287,2018-02-12,GOOG,52.400001525878906,53.07500076293945,52.0463981628418,52.59700012207031,41154000.0,0.0,0.0,0.7080001831054616,0.0,0.7080001831054616,38.95871545665207,49.62799835205078,59.34450149536133,30.556278593534746,-69.44372140646526,-0.7024902088246776,0.1450652586634699,-0.09603075333851974,1712285540.0,1.0
1288,2018-02-13,GOOG,52.25,52.91849899291992,52.204349517822266,52.60499954223633,25302000.0,0.0,0.0,0.007999420166015625,0.0,0.007999420166015625,39.019485523957066,49.62799835205078,59.34450149536133,30.6386067732104,-69.3613932267896,-0.771443920198692,-0.03823657710896255,-0.10072314716526076,1737587540.0,1.0
1289,2018-02-14,GOOG,52.4474983215332,53.58599853515625,52.337501525878906,53.48500061035156,31116000.0,0.0,0.0,0.8800010681152344,0.0,0.8800010681152344,45.8609528684828,49.62799835205078,59.34450149536133,39.69537395720584,-60.30462604279416,-0.7464765841298373,-0.17988457851313755,-0.0839256290493795,1768703540.0,1.0
1290,2018-02-15,GOOG,53.95349884033203,54.573951721191406,53.21699905395508,54.47600173950195,36868000.0,0.0,0.0,0.9910011291503906,0.0,0.9910011291503906,52.74916507409234,49.62799835205078,59.34450149536133,49.894528061660154,-50.10547193833984,-0.6393542041535696,-0.271778503641224,-0.02012769955267968,1805571540.0,1.0
1291,2018-02-16,GOOG,54.420501708984375,55.23350143432617,54.4156494140625,54.7400016784668,33590000.0,0.0,0.0,0.26399993896484375,0.0,0.26399993896484375,54.5275345511677,49.62799835205078,58.82600021362305,55.577324329245045,-44.42267567075495,-0.527080501586326,-0.32283890323024445,0.03693882798107495,1839161540.0,1.0
1292,2018-02-20,GOOG,54.52849960327149,55.6974983215332,54.42599868774414,55.12300109863281,28462000.0,0.0,0.0,0.3829994201660156,0.0,0.3829994201660156,57.22259868047755,49.62799835205078,58.70000076293945,60.571001832921176,-39.42899816707882,-0.40255749880289216,-0.338782622344774,0.020229545512311597,1867623540.0,1.0
1293,2018-02-21,GOOG,55.32350158691406,56.69850158691406,55.31650161743164,55.56700134277344,30258000.0,0.0,0.0,0.444000244140625,0.0,0.444000244140625,60.36480434809347,49.62799835205078,58.70000076293945,65.46518311761433,-34.53481688238567,-0.2649903688980757,-0.3240241716554344,0.059852380116688364,1897881540.0,1.0
1294,2018-02-22,GOOG,55.80950164794922,56.14099884033203,55.12950134277344,55.33150100708008,26344000.0,0.0,0.0,-0.23550033569335938,0.23550033569335938,0.0,57.76785957400823,49.62799835205078,56.69850158691406,80.66614872483801,-19.333851275161994,-0.17297637231686736,-0.293814611787721,0.1049504906749179,1871537540.0,-1.0
1295,2018-02-23,GOOG,55.63199996948242,56.36399841308594,55.23569869995117,56.339500427246094,25220000.0,0.0,0.0,1.0079994201660156,0.0,1.0079994201660156,65.16847820308087,49.62799835205078,56.69850158691406,94.92255151093343,-5.077448489066572,-0.018504183388813544,-0.2387525261079395,0.08576963313064812,1896757540.0,1.0
1296,2018-02-26,GOOG,56.38999938964844,57.198001861572266,56.33475112915039,57.1875,31182000.0,0.0,0.0,0.8479995727539062,0.0,0.8479995727539062,70.23205144195813,49.62799835205078,57.198001861572266,99.86127005675682,-0.1387299432431765,0.17037859930599097,-0.1569263010251534,0.08727683836104294,1927939540.0,1.0
1297,2018-02-27,GOOG,57.0620002746582,57.20199966430664,55.900001525878906,55.91450119018555,35482000.0,0.0,0.0,-1.2729988098144531,1.2729988098144531,0.0,56.1046113114269,49.62799835205078,57.20199966430664,83.00107933652282,-16.998920663477175,0.21487228639728784,-0.08256658354066514,0.06291230257101388,1892457540.0,-1.0
1298,2018-02-28,GOOG,56.1515007019043,56.37649917602539,55.1619987487793,55.23649978637695,37652000.0,0.0,0.0,-0.6780014038085938,0.6780014038085938,0.0,49.93214350317469,49.62799835205078,57.20199966430664,74.04938556388659,-25.9506144361134,0.19319774365619935,-0.027413718101292228,0.032747483519452336,1854805540.0,-1.0
1299,2018-03-01,GOOG,55.39350128173828,55.50600051879883,53.35005187988281,53.47600173950195,50318000.0,0.0,0.0,-1.760498046875,1.760498046875,0.0,37.553703630446094,49.62799835205078,57.20199966430664,50.805422772036366,-49.194577227963634,0.03357598997835254,-0.015215776485363272,-0.018356706954777757,1804487540.0,-1.0
1300,2018-03-02,GOOG,52.65399932861328,54.09994888305664,52.4057502746582,53.94599914550781,45432000.0,0.0,0.0,0.4699974060058594,0.0,0.4699974060058594,41.984080788325954,52.0463981628418,57.20199966430664,36.84538035234664,-63.15461964765336,-0.05437375034402692,-0.023047371257096005,-0.014504978235529098,1849919540.0,1.0
1301,2018-03-05,GOOG,53.75699996948242,54.85499954223633,53.45000076293945,54.54650115966797,24044000.0,0.0,0.0,0.6005020141601562,0.0,0.6005020141601562,47.477540942197834,52.204349517822266,57.20199966430664,46.86505804119368,-53.13494195880632,-0.07475730359415422,-0.03338935772450765,-0.010458428015073018,1873963540.0,1.0
1302,2018-03-06,GOOG,54.96099853515625,55.09249877929688,54.48875045776367,54.75299835205078,30656000.0,0.0,0.0,0.2064971923828125,0.0,0.2064971923828125,49.379380373587495,52.337501525878906,57.20199966430664,49.655622377370115,-50.34437762262988,-0.07340267835965619,-0.04139202185153736,-0.014649035777571595,1904619540.0,1.0
1303,2018-03-07,GOOG,54.45949935913086,55.61100006103516,54.27410125732422,55.48199844360352,25850000.0,0.0,0.0,0.7290000915527415,0.0,0.7290000915527415,55.8861456408761,52.4057502746582,57.20199966430664,64.1386199721947,-35.86138002780529,-0.013351011076458974,-0.03578381969652169,0.002719923258618806,1930469540.0,1.0
1304,2018-03-08,GOOG,55.76599884033203,56.380001068115234,55.63999938964844,56.29999923706055,27102000.0,0.0,0.0,0.8180007934570241,0.0,0.8180007934570241,62.180205841702204,52.4057502746582,57.20199966430664,81.19362956411635,-18.80637043588365,0.0991037888209263,-0.008806297993032083,-0.0007011278035125024,1957571540.0,1.0
1305,2018-03-09,GOOG,56.79999923706055,58.040000915527344,56.62305068969727,58.00199890136719,42560000.0,0.0,0.0,1.7019996643066406,0.0,1.7019996643066406,71.82964147765293,52.4057502746582,58.040000915527344,99.32551786240212,-0.6744821375978768,0.32185206636247443,0.05732537487806925,0.014242603739754056,2000131540.0,1.0
1306,2018-03-12,GOOG,58.192501068115234,58.852500915527344,57.87099838256836,58.22499847412109,43446000.0,0.0,0.0,0.22299957275389914,0.0,0.22299957275389914,72.87588039642962,52.4057502746582,58.852500915527344,90.26637640630601,-9.73362359369399,0.5104912575179839,0.14795855140605219,0.04132196898397966,2043577540.0,1.0
1307,2018-03-13,GOOG,58.5,58.8380012512207,56.666500091552734,56.90850067138672,38144000.0,0.0,0.0,-1.316497802734368,1.316497802734368,0.0,58.161604628246515,52.4057502746582,58.852500915527344,69.84527008355735,-30.15472991644265,0.5474481636750568,0.22785647385985314,0.03026985582859343,2005433540.0,-1.0
1308,2018-03-14,GOOG,57.260501861572266,57.929500579833984,57.071998596191406,57.4744987487793,25828000.0,0.0,0.0,0.5659980773925781,0.0,0.5659980773925781,61.97065444444928,52.4057502746582,58.852500915527344,78.6248570246814,-21.3751429753186,0.6153151229499443,0.3053482036778714,0.07477180191509558,2031261540.0,1.0
1309,2018-03-15,GOOG,57.49800109863281,58.05400085449219,56.72700119018555,57.479000091552734,27908000.0,0.0,0.0,0.0045013427734375,0.0,0.0045013427734375,62.00239926263724,52.4057502746582,58.852500915527344,78.69468046014828,-21.305319539851723,0.6618341853614922,0.3766454000145956,0.06549143591752582,2059169540.0,1.0
1310,2018-03-16,GOOG,57.70700073242188,57.79399871826172,56.59799957275391,56.7864990234375,61840000.0,0.0,0.0,-0.6925010681152344,0.6925010681152344,0.0,54.000741302394815,52.4057502746582,58.852500915527344,67.95281829279334,-32.04718170720667,0.6354962238643367,0.42841556478454396,0.041065839534100146,1997329540.0,-1.0
1311,2018-03-19,GOOG,56.0004997253418,56.0994987487793,54.45050048828125,54.99100112915039,56118000.0,0.0,0.0,-1.7954978942871094,1.7954978942871094,0.0,38.95916160161287,52.4057502746582,58.852500915527344,40.10161085032518,-59.89838914967481,0.4643883453822397,0.43561012090408313,0.004346844634321112,1941211540.0,-1.0
1312,2018-03-20,GOOG,54.95000076293945,55.2599983215332,54.17300033569336,54.885501861572266,36638000.0,0.0,0.0,-0.105499267578125,0.105499267578125,0.0,38.237072462565735,52.4057502746582,58.852500915527344,38.46513887467108,-61.53486112532892,0.3166213953643151,0.41181237579612956,-0.010751173331248753,1904573540.0,-1.0
1313,2018-03-21,GOOG,54.637001037597656,55.31499862670898,54.25749969482422,54.54399871826172,37578000.0,0.0,0.0,-0.3415031433105469,0.3415031433105469,0.0,35.7614229006974,52.4057502746582,58.852500915527344,33.16784784644998,-66.83215215355001,0.16999893140682332,0.36344968691826834,-0.03119006292353388,1866995540.0,-1.0
1314,2018-03-22,GOOG,54.09400177001953,54.14500045776367,52.295501708984375,52.45399856567383,53340000.0,0.0,0.0,-2.0900001525878906,2.0900001525878906,0.0,24.541229010682272,52.295501708984375,58.852500915527344,2.417216346942599,-97.5827836530574,-0.11353718707294291,0.2680523121200261,-0.095651881672695,1813655540.0,-1.0
1315,2018-03-23,GOOG,52.35150146484375,53.167999267578125,51.06100082397461,51.07849884033203,43134000.0,0.0,0.0,-1.3754997253417969,1.3754997253417969,0.0,19.819154887830706,51.06100082397461,58.852500915527344,0.2245782731414275,-99.77542172685857,-0.44411347238124677,0.1256191552197715,-0.12273937004850966,1770521540.0,-1.0
1316,2018-03-26,GOOG,52.29999923706055,52.78150177001953,50.41999816894531,52.66049957275391,53302000.0,0.0,0.0,1.582000732421882,0.0,1.582000732421882,36.128534810329406,50.41999816894531,58.852500915527344,26.56982714552627,-73.43017285447372,-0.5718513756930577,-0.01387495096279439,-0.07464616091649512,1823823540.0,1.0
1317,2018-03-27,GOOG,53.150001525878906,53.24195098876953,49.84600067138672,50.255001068115234,61906000.0,0.0,0.0,-2.405498504638679,2.405498504638679,0.0,26.626329012441403,49.84600067138672,58.852500915527344,4.541168996188056,-95.45883100381194,-0.8573057233792625,-0.18256110544608808,-0.1256121904119677,1761917540.0,-1.0
1318,2018-03-28,GOOG,49.900001525878906,51.21149826049805,49.03200149536133,50.22800064086914,67386000.0,0.0,0.0,-0.02700042724609375,0.02700042724609375,0.0,26.5359386787448,49.03200149536133,58.852500915527344,12.17859799524935,-87.82140200475065,-1.073336306521938,-0.36071614566125815,-0.1261504103956954,1694531540.0,-1.0
1319,2018-03-29,GOOG,50.58150100708008,52.150001525878906,50.14500045776367,51.589500427246094,54536000.0,0.0,0.0,1.3614997863769531,0.0,1.3614997863769531,38.65303651838271,49.03200149536133,58.852500915527344,26.042452857672803,-73.9575471423272,-1.1217496145549717,-0.5129228394400009,-0.09151820741839445,1749067540.0,1.0
1320,2018-04-02,GOOG,51.14099884033203,51.7400016784668,49.51850128173828,50.32350158691406,53608000.0,0.0,0.0,-1.2659988403320312,1.2659988403320312,0.0,32.84128020413357,49.03200149536133,58.8380012512207,13.170509113882293,-86.82949088611771,-1.2478881580882017,-0.6599159031696412,-0.08487751534609023,1695459540.0,-1.0
1321,2018-04-03,GOOG,50.695499420166016,51.04949951171875,49.70349884033203,50.670501708984375,45502000.0,0.0,0.0,0.3470001220703125,0.0,0.3470001220703125,35.88984099440161,49.03200149536133,58.05400085449219,18.161165262828092,-81.83883473717191,-1.3048127832201502,-0.7888952791797431,-0.07679623961931914,1740961540.0,1.0
1322,2018-04-04,GOOG,49.670501708984375,51.4359016418457,49.650001525878906,51.25699996948242,49694000.0,0.0,0.0,0.5864982604980469,0.0,0.5864982604980469,41.103768245882186,49.03200149536133,58.05400085449219,24.66192232511354,-75.33807767488646,-1.287756001124606,-0.888667423568716,-0.06026325216377626,1790655540.0,1.0
1323,2018-04-05,GOOG,52.06650161743164,52.13949966430664,51.00654983520508,51.39049911499024,27260000.0,0.0,0.0,0.1334991455078196,0.0,0.1334991455078196,42.33547270526918,49.03200149536133,57.79399871826172,26.91735182778573,-73.08264817221428,-1.249067638859664,-0.9607474666269056,-0.020274897620093824,1817915540.0,1.0
1324,2018-04-06,GOOG,51.0,51.57099914550781,50.1515007019043,50.35200119018555,34928000.0,0.0,0.0,-1.0384979248046946,1.0384979248046946,0.0,35.64453466716655,49.03200149536133,56.0994987487793,18.677045741840836,-81.32295425815916,-1.2873649941765777,-1.02607097213684,-0.014223159776434846,1782987540.0,-1.0
1325,2018-04-09,GOOG,50.84000015258789,51.97999954223633,50.70399856567383,50.772499084472656,35032000.0,0.0,0.0,0.4204978942871094,0.0,0.4204978942871094,40.06975355510858,49.03200149536133,55.31499862670898,27.70170911629887,-72.29829088370113,-1.2691552269270119,-1.0746878230948744,-0.0358523087247371,1818019540.0,1.0
1326,2018-04-10,GOOG,51.321998596191406,51.81399917602539,50.56700134277344,51.58200073242188,39490000.0,0.0,0.0,0.8095016479492259,0.0,0.8095016479492259,48.01058649355842,49.03200149536133,55.31499862670898,40.58571385203865,-59.41428614796135,-1.1758493777990466,-1.0949201340357089,0.02640532556168962,1857509540.0,1.0
1327,2018-04-11,GOOG,51.39950180053711,51.56819915771485,50.79349899291992,50.99850082397461,29678000.0,0.0,0.0,-0.5834999084472727,0.5834999084472727,0.0,43.2448961908236,49.03200149536133,54.14500045776367,38.460780905171966,-61.539219094828034,-1.1358935128849055,-1.1031148098055483,0.015340052824609929,1827831540.0,-1.0
1328,2018-04-12,GOOG,51.25199890136719,52.03450012207031,51.07175064086914,51.6254997253418,27140000.0,0.0,0.0,0.6269989013671875,0.0,0.6269989013671875,49.46445595012364,49.03200149536133,53.24195098876953,61.604022424527436,-38.395977575472564,-1.0416273985224862,-1.090817327548936,0.000697802804787262,1854971540.0,1.0
1329,2018-04-13,GOOG,52.04399871826172,52.32099914550781,51.14899826049805,51.4635009765625,24460000.0,0.0,0.0,-0.16199874877929688,0.16199874877929688,0.0,47.89958244594353,49.03200149536133,53.24195098876953,57.75602498339545,-42.24397501660455,-0.9688247601238089,-1.0664188140639106,0.022653419450145762,1830511540.0,-1.0
1330,2018-04-16,GOOG,51.84999847412109,52.1619987487793,51.33700180053711,51.89899826049805,24224000.0,0.0,0.0,0.4354972839355469,0.0,0.4354972839355469,52.55538568815738,49.03200149536133,53.24195098876953,68.10050262184298,-31.899497378157015,-0.8660043938835713,-1.0263359300278427,0.024244807335228158,1854735540.0,1.0
1331,2018-04-17,GOOG,52.56850051879883,53.89400100708008,52.41299819946289,53.70800018310547,46406000.0,0.0,0.0,1.8090019226074219,0.0,1.8090019226074219,66.78261517347622,49.03200149536133,53.89400100708008,96.17439649003879,-3.82560350996121,-0.6312702852664387,-0.9473228010755619,0.04781786322028858,1901141540.0,1.0
1332,2018-04-18,GOOG,53.87149810791016,53.87149810791016,53.31124877929688,53.604000091552734,26882000.0,0.0,0.0,-0.10400009155273438,0.10400009155273438,0.0,65.48009247513234,49.51850128173828,53.89400100708008,93.3721646958922,-6.627835304107807,-0.44846413584394185,-0.847551068029238,0.04307218288753356,1874259540.0,-1.0
1333,2018-04-19,GOOG,53.470001220703125,54.70824813842773,53.40900039672852,54.3849983215332,34954000.0,0.0,0.0,0.7809982299804688,0.0,0.7809982299804688,70.47056088888107,49.51850128173828,54.70824813842773,93.77137602621477,-6.228623973785228,-0.23782738919432234,-0.7256063322622548,0.08009606442680495,1909213540.0,1.0
1334,2018-04-20,GOOG,54.09999847412109,54.61750030517578,53.47850036621094,53.64799880981445,37794000.0,0.0,0.0,-0.73699951171875,0.73699951171875,0.0,60.88634383412062,49.650001525878906,54.70824813842773,79.03919263281985,-20.96080736718016,-0.1288802992874878,-0.6062611256673014,0.05663498502521391,1871419540.0,-1.0
1335,2018-04-23,GOOG,53.89300155639648,54.13600158691406,53.03499984741211,53.372501373291016,46826000.0,0.0,0.0,-0.2754974365234375,0.2754974365234375,0.0,57.512614097214104,49.650001525878906,54.70824813842773,73.59269194540839,-26.4073080545916,-0.06403117478927811,-0.49781513549169676,0.03471173307443487,1824593540.0,-1.0
1336,2018-04-24,GOOG,52.59999847412109,52.84999847412109,50.52949905395508,50.999000549316406,95206000.0,0.0,0.0,-2.3735008239746094,2.3735008239746094,0.0,37.08528015058238,50.1515007019043,54.70824813842773,18.59878914111398,-81.40121085888602,-0.20183285323692246,-0.438618679040742,9.79882415608202e-06,1729387540.0,-1.0
1337,2018-04-25,GOOG,51.2760009765625,51.6245002746582,50.76549911499024,51.05899810791016,47822000.0,0.0,0.0,0.059997558593757105,0.0,0.059997558593757105,37.730365231392526,50.1515007019043,54.70824813842773,19.91546423512648,-80.08453576487352,-0.30271091169712605,-0.4114371255720188,-0.010973290727364193,1777209540.0,1.0
1338,2018-04-26,GOOG,51.47549819946289,52.39899826049805,50.90950012207031,52.00199890136719,41590000.0,0.0,0.0,0.9430007934570241,0.0,0.9430007934570241,47.493782496624505,50.52949905395508,54.70824813842773,35.23781441876011,-64.76218558123989,-0.30307159606455514,-0.3897640196705261,0.010463686196746202,1818799540.0,1.0
1339,2018-04-27,GOOG,52.29999923706055,52.47499847412109,51.27949905395508,51.50249862670898,32396000.0,0.0,0.0,-0.49950027465821023,0.49950027465821023,0.0,43.3405038627278,50.52949905395508,54.70824813842773,23.284469899601305,-76.7155301003987,-0.3397465519255718,-0.37976052612153527,-0.007639832117739664,1786403540.0,-1.0
1340,2018-04-30,GOOG,51.5004997253418,51.84999847412109,50.84249877929688,50.86650085449219,33426000.0,0.0,0.0,-0.6359977722167898,0.6359977722167898,0.0,38.40622489560213,50.52949905395508,54.70824813842773,8.064657478223257,-91.93534252177675,-0.4153436011453593,-0.3868771411263001,-0.05290644445754489,1752977540.0,-1.0
1341,2018-05-01,GOOG,50.68299865722656,51.92350006103516,50.41049957275391,51.865501403808594,28558000.0,0.0,0.0,0.9990005493164062,0.0,0.9990005493164062,48.94170016745658,50.41049957275391,54.70824813842773,33.85497799186773,-66.14502200813229,-0.39014644658695374,-0.3875310022184309,-0.0324322566370957,1781535540.0,1.0
1342,2018-05-02,GOOG,51.40499877929688,52.01945114135742,51.14350128173828,51.21900177001953,32062000.0,0.0,0.0,-0.6464996337890625,0.6464996337890625,0.0,43.39870451761442,50.41049957275391,54.70824813842773,18.81222656260391,-81.18777343739609,-0.41753159318577104,-0.39353112041189897,-0.05821451961432034,1749473540.0,-1.0
1343,2018-05-03,GOOG,50.95000076293945,51.48374938964844,50.31449890136719,51.18600082397461,36302000.0,0.0,0.0,-0.033000946044921875,0.033000946044921875,0.0,43.11112308946771,50.31449890136719,54.70824813842773,19.83504008959931,-80.1649599104007,-0.4368615516791934,-0.4021972066653579,-0.04589170221554362,1713171540.0,-1.0
1344,2018-05-04,GOOG,50.845001220703125,52.42549896240234,50.845001220703125,52.41049957275391,38774000.0,0.0,0.0,1.224498748779304,0.0,1.224498748779304,55.683770483434984,50.31449890136719,54.70824813842773,47.70414874174681,-52.29585125825318,-0.3493468149645267,-0.3916271283251917,-0.018024296703068043,1751945540.0,1.0
1345,2018-05-07,GOOG,52.46149826049805,53.08399963378906,52.35499954223633,52.73949813842773,29322000.0,0.0,0.0,0.3289985656738139,0.0,0.3289985656738139,58.52538586825476,50.31449890136719,54.70824813842773,55.19202635885719,-44.80797364114281,-0.2505550779410086,-0.36341271824835514,0.03412807251836725,1781267540.0,1.0
1346,2018-05-08,GOOG,52.92699813842773,53.02750015258789,52.35725021362305,52.695499420166016,24354000.0,0.0,0.0,-0.043998718261711645,0.043998718261711645,0.0,57.951976646148005,50.31449890136719,54.70824813842773,54.190632881719495,-45.809367118280505,-0.17380868511507686,-0.3254919116216995,0.03205118339371249,1756913540.0,-1.0
1347,2018-05-09,GOOG,52.90499877929688,54.27199935913086,52.8182487487793,54.13800048828125,40656000.0,0.0,0.0,1.4425010681152344,0.0,1.4425010681152344,69.32219290423023,50.31449890136719,54.61750030517578,88.85661955698816,-11.143380443011829,0.003372291166463981,-0.2597190710640668,0.04107537464022193,1797569540.0,1.0
1348,2018-05-10,GOOG,54.30149841308594,55.02199935913086,54.28200149536133,54.87850189208984,28860000.0,0.0,0.0,0.7405014038085866,0.0,0.7405014038085866,73.55748652429247,50.31449890136719,55.02199935913086,96.95172696575388,-3.048273034246121,0.20122220176304495,-0.1675308164986444,0.06555028115917616,1826429540.0,1.0
1349,2018-05-11,GOOG,54.68000030517578,55.06650161743164,54.545501708984375,54.91299819946289,25074000.0,0.0,0.0,0.03449630737305398,0.0,0.03449630737305398,73.75226709736793,50.31449890136719,55.06650161743164,96.76971106414098,-3.2302889358590168,0.3566915271574942,-0.06268634776741666,0.07955132114446095,1851503540.0,1.0
1350,2018-05-14,GOOG,55.0,55.53749847412109,54.95550155639648,55.0099983215332,30362000.0,0.0,0.0,0.0970001220703125,0.0,0.0970001220703125,74.36493469425777,50.31449890136719,55.53749847412109,89.90043661233248,-10.099563387667516,0.4821710194447064,0.04628512567500799,0.060627909354284304,1881865540.0,1.0
1351,2018-05-15,GOOG,54.5,54.50249862670898,53.67350006103516,53.96149826049805,29898000.0,0.0,0.0,-1.0485000610351562,1.0485000610351562,0.0,57.59707508242684,50.31449890136719,55.53749847412109,69.82576407158173,-30.17423592841827,0.4913453060322297,0.13529716174645237,0.053544512694579716,1851967540.0,-1.0
1352,2018-05-16,GOOG,53.865501403808594,54.4635009765625,53.8129997253418,54.0885009765625,21946000.0,0.0,0.0,0.12700271606445312,0.0,0.12700271606445312,58.89253094963113,50.31449890136719,55.53749847412109,72.25736901995221,-27.74263098004778,0.5030650314944651,0.20885073569605497,0.05670496045528939,1873913540.0,1.0
1353,2018-05-17,GOOG,53.99449920654297,54.34349822998047,53.67499923706055,53.929500579833984,20876000.0,0.0,0.0,-0.15900039672851562,0.15900039672851562,0.0,56.40330419796293,50.31449890136719,55.53749847412109,69.21313371964794,-30.78686628035206,0.4938304254196453,0.2658466736407731,0.028982761459303896,1853037540.0,-1.0
1354,2018-05-18,GOOG,53.09299850463867,53.49700164794922,53.03400039672852,53.31800079345703,31304000.0,0.0,0.0,-0.6114997863769531,0.6114997863769531,0.0,47.49494641127407,50.31449890136719,55.53749847412109,57.505306103370124,-42.49469389662987,0.4321870282948339,0.29911474457158527,0.010969058778505625,1821733540.0,-1.0
1355,2018-05-21,GOOG,53.70299911499024,54.400001525878906,53.682498931884766,53.979000091552734,20464000.0,0.0,0.0,0.6609992980957031,0.0,0.6609992980957031,56.13578781403966,50.31449890136719,55.53749847412109,70.16085563747016,-29.83914436252983,0.43169499987368454,0.32563079563200514,0.024356931531339443,1842197540.0,1.0
1356,2018-05-22,GOOG,54.178001403808594,54.329498291015625,53.33449935913086,53.48649978637695,21800000.0,0.0,0.0,-0.49250030517578125,0.49250030517578125,0.0,49.17788740013305,50.31449890136719,55.53749847412109,60.73140234505675,-39.26859765494325,0.3871021327505204,0.33792506305570824,-0.012034073959663938,1820397540.0,-1.0
1357,2018-05-23,GOOG,53.25650024414063,54.03900146484375,53.08549880981445,53.984500885009766,21214000.0,0.0,0.0,0.4980010986328125,0.0,0.4980010986328125,55.59890384482401,50.845001220703125,55.53749847412109,66.90466706229535,-33.095332937704654,0.3874798642942494,0.3478360233034165,-0.016290550511710133,1841611540.0,1.0
1358,2018-05-24,GOOG,53.95000076293945,54.02349853515625,53.307498931884766,53.96200180053711,15336000.0,0.0,0.0,-0.02249908447265625,0.02249908447265625,0.0,55.235115495107415,52.35499954223633,55.53749847412109,50.49498185845652,-49.50501814154348,0.3815652841008301,0.35458187546289927,-0.017318238488298054,1826275540.0,-1.0
1359,2018-05-25,GOOG,53.95100021362305,54.12799835205078,53.688751220703125,53.78300094604492,17988000.0,0.0,0.0,-0.1790008544921875,0.1790008544921875,0.0,52.10540954354766,52.35725021362305,55.53749847412109,44.831428732503944,-55.168571267496056,0.35830376098009964,0.3553262525663394,-0.022304988418950455,1808287540.0,-1.0
1360,2018-05-29,GOOG,53.24449920654297,53.66849899291992,52.76100158691406,53.01599884033203,37302000.0,0.0,0.0,-0.7670021057128906,0.7670021057128906,0.0,40.70284797342711,52.76100158691406,55.53749847412109,9.184136117454086,-90.81586388254591,0.2748103340225967,0.33922306885759085,-0.0175217414387131,1770985540.0,-1.0
1361,2018-05-30,GOOG,53.1515007019043,53.46049880981445,52.84149932861328,53.38999938964844,22770000.0,0.0,0.0,0.37400054931640625,0.0,0.37400054931640625,47.20338560670371,52.76100158691406,55.53749847412109,22.65436729400068,-77.34563270599932,0.23609831587859986,0.3185981182617927,-0.012914049646462478,1793755540.0,1.0
1362,2018-05-31,GOOG,53.37799835205078,54.859500885009766,53.37799835205078,54.2495002746582,61766000.0,0.0,0.0,0.8595008850097656,0.0,0.8595008850097656,59.09442755617718,52.76100158691406,55.53749847412109,53.610673745126135,-46.38932625487386,0.2716419811981581,0.3092068908490658,0.005933666942650628,1855521540.0,1.0
1363,2018-06-01,GOOG,54.96749877929688,56.0,54.92499923706055,55.97499847412109,48432000.0,0.0,0.0,1.7254981994628835,0.0,1.7254981994628835,73.11869689726038,52.76100158691406,56.0,99.22810935078252,-0.7718906492174935,0.4340405271327583,0.3341736181058043,0.04983303276798989,1903953540.0,1.0
1364,2018-06-04,GOOG,56.11650085449219,57.09450149536133,56.10025024414063,56.964500427246094,37792000.0,0.0,0.0,0.9895019531250071,0.0,0.9895019531250071,78.08925323741974,52.76100158691406,57.09450149536133,97.00009066893426,-2.9999093310657297,0.6352641530899774,0.394391725102639,0.0553085520411587,1941745540.0,1.0
1365,2018-06-05,GOOG,57.04949951171875,57.28689956665039,56.65950012207031,56.983001708984375,33560000.0,0.0,0.0,0.01850128173828125,0.0,0.01850128173828125,78.17631267981722,52.76100158691406,57.28689956665039,93.28535775603761,-6.714642243962385,0.7871543992852779,0.47294425993916683,0.06537167204009076,1975305540.0,1.0
1366,2018-06-06,GOOG,57.10850143432617,57.150001525878906,56.28715133666992,56.84400177001953,33964000.0,0.0,0.0,-0.13899993896484375,0.13899993896484375,0.0,75.57323334153945,52.76100158691406,57.28689956665039,90.2141453781364,-9.785854621863614,0.8860979942013643,0.5555750067916064,0.05296892326745173,1941341540.0,-1.0
1367,2018-06-07,GOOG,56.56600189208984,56.79100036621094,55.82600021362305,56.19300079345703,30400000.0,0.0,0.0,-0.6510009765625,0.6510009765625,0.0,64.04838220755224,52.76100158691406,57.28689956665039,75.83023793088044,-24.169762069119557,0.9015882200742027,0.6247776494481257,0.041343888634200354,1910941540.0,-1.0
1368,2018-06-08,GOOG,55.90900039672852,56.33349990844727,55.60749816894531,56.04349899291992,25816000.0,0.0,0.0,-0.14950180053710938,0.14950180053710938,0.0,61.56076243229023,52.76100158691406,57.28689956665039,72.52698626222885,-27.473013737771158,0.8915238577371554,0.6781268911059317,0.042029972428327955,1885125540.0,-1.0
1369,2018-06-11,GOOG,55.93000030517578,56.86299896240234,55.93000030517578,56.4995002746582,21586000.0,0.0,0.0,0.45600128173828125,0.0,0.45600128173828125,66.18324530146373,52.76100158691406,57.28689956665039,82.6023632101831,-17.397636789816907,0.9098550281503606,0.7244725185148175,0.06570660763777014,1906711540.0,1.0
1370,2018-06-12,GOOG,56.55350112915039,56.98949813842773,56.53675079345703,56.96599960327149,18240000.0,0.0,0.0,0.46649932861328836,0.0,0.46649932861328836,70.38681736304187,52.76100158691406,57.28689956665039,92.90969516291231,-7.090304837087695,0.9510619596381176,0.7697904067394776,0.06697883975470487,1924951540.0,1.0
1371,2018-06-13,GOOG,57.055999755859375,57.32500076293945,56.66899871826172,56.73949813842773,30128000.0,0.0,0.0,-0.2265014648437642,0.2265014648437642,0.0,65.80425439624578,52.76100158691406,57.32500076293945,87.17128110830166,-12.82871889169834,0.9544397867177636,0.806720282735135,0.045899000933888656,1894823540.0,-1.0
1372,2018-06-14,GOOG,57.192501068115234,57.77349853515625,57.03200149536133,57.60599899291992,26868000.0,0.0,0.0,0.8665008544921946,0.0,0.8665008544921946,73.43781007103865,52.76100158691406,57.77349853515625,96.65836121266732,-3.3416387873326863,1.0153320010363203,0.8484426263953722,0.029138018102008445,1921691540.0,1.0
1373,2018-06-15,GOOG,57.44300079345703,57.67100143432617,57.17425155639648,57.61299896240234,42450000.0,0.0,0.0,0.00699996948241477,0.0,0.00699996948241477,73.49296584658993,52.76100158691406,57.77349853515625,96.79801156167889,-3.2019884383211106,1.0520272434265365,0.8891595498016052,0.011384257393505903,1964141540.0,1.0
1374,2018-06-18,GOOG,57.182498931884766,58.71549987792969,57.179500579833984,58.67300033569336,28274000.0,0.0,0.0,1.0600013732910227,0.0,1.0600013732910227,80.54979363739757,52.84149932861328,58.71549987792969,99.27648045178896,-0.7235195482110409,1.153346676861723,0.9419969752136289,0.029657943176456536,1992415540.0,1.0
1375,2018-06-19,GOOG,57.92499923706055,58.5634994506836,57.70050048828125,58.40299987792969,32420000.0,0.0,0.0,-0.2700004577636719,0.2700004577636719,0.0,74.70456501374454,53.37799835205078,58.71549987792969,94.14520073699573,-5.8547992630042724,1.198045949425392,0.9932067700559817,0.02742590351428076,1959995540.0,-1.0
1376,2018-06-20,GOOG,58.76549911499024,59.314300537109375,58.45800018310547,58.492000579833984,32970000.0,0.0,0.0,0.08900070190429688,0.0,0.08900070190429688,75.38397485764423,54.92499923706055,59.314300537109375,81.26581200369537,-18.73418799630463,1.2265135728174883,1.039868130608283,0.04091256480192529,1992965540.0,1.0
1377,2018-06-21,GOOG,58.74250030517578,58.86474990844727,57.61159896850586,57.882999420166016,24762000.0,0.0,0.0,-0.6090011596679688,0.6090011596679688,0.0,62.19483189079964,55.60749816894531,59.314300537109375,61.38717485355804,-38.61282514644196,1.1862586146147933,1.069146227409585,0.03282272628050009,1968203540.0,-1.0
1378,2018-06-22,GOOG,57.95700073242188,58.12485122680664,57.36299896240234,57.77399826049805,26220000.0,0.0,0.0,-0.10900115966796875,0.10900115966796875,0.0,60.02594234715942,55.60749816894531,59.314300537109375,58.44660374018746,-41.55339625981254,1.132505963803105,1.0818181746882891,0.02255768599092356,1941983540.0,-1.0
1379,2018-06-25,GOOG,57.18000030517578,57.195499420166016,55.63899993896485,56.240501403808594,43146000.0,0.0,0.0,-1.5334968566894531,1.5334968566894531,0.0,38.32862456180215,55.60749816894531,59.314300537109375,17.076800217347454,-82.92319978265255,0.9551557791428991,1.056485695579211,-0.012735635370492715,1898837540.0,-1.0
1380,2018-06-26,GOOG,56.400001525878906,56.66049957275391,55.832950592041016,55.92300033569336,31264000.0,0.0,0.0,-0.3175010681152344,0.3175010681152344,0.0,35.28192556385159,55.60749816894531,59.314300537109375,8.511437498199061,-91.48856250180094,0.7799935175891903,1.0011872599812068,-0.014390289472465123,1867573540.0,-1.0
1381,2018-06-27,GOOG,56.06700134277344,56.59180068969727,55.180999755859375,55.19900131225586,25878000.0,0.0,0.0,-0.7239990234375,0.7239990234375,0.0,29.179240072192115,55.180999755859375,59.314300537109375,0.43552495569994093,-99.56447504430005,0.5761144046151827,0.916172688908002,-0.041783802429325,1841695540.0,-1.0
1382,2018-06-28,GOOG,55.10449981689453,56.115501403808594,54.80049896240234,55.71099853515625,21448000.0,0.0,0.0,0.5119972229003906,0.0,0.5119972229003906,37.93851935437492,54.80049896240234,59.314300537109375,20.171457643505477,-79.82854235649452,0.45065773383141305,0.8230696978926842,-0.03301339040669127,1863143540.0,1.0
1383,2018-06-29,GOOG,56.0,56.41135025024414,55.75,55.782501220703125,26302000.0,0.0,0.0,0.071502685546875,0.0,0.071502685546875,39.1512438533107,54.80049896240234,59.314300537109375,21.755547780465378,-78.24445221953462,0.3529336876617606,0.7290424958464996,-0.049264552663958794,1889445540.0,1.0
1384,2018-07-02,GOOG,54.95000076293945,56.400001525878906,54.68999862670898,56.37300109863281,24346000.0,0.0,0.0,0.5904998779296875,0.0,0.5904998779296875,48.702891056263184,54.68999862670898,59.314300537109375,36.394735995472914,-63.605264004527086,0.3194526310655448,0.6471245228903086,-0.034758467605086274,1913791540.0,1.0
1385,2018-07-03,GOOG,56.79100036621094,56.79100036621094,55.0009994506836,55.14450073242188,13580000.0,0.0,0.0,-1.2285003662109304,1.2285003662109304,0.0,35.37355179722641,54.68999862670898,59.314300537109375,9.828556061417528,-90.17144393858247,0.19158051897970552,0.5560157221081881,-0.057230045377627325,1900211540.0,-1.0
1386,2018-07-05,GOOG,55.5265007019043,56.375,55.42399978637695,56.2135009765625,21334000.0,0.0,0.0,1.069000244140618,0.0,1.069000244140618,49.30432471306896,54.68999862670898,59.314300537109375,32.94556409535141,-67.05443590464859,0.174488934752965,0.47971036463714345,-0.028842638776971796,1921545540.0,1.0
1387,2018-07-06,GOOG,56.17900085449219,57.04650115966797,56.03684997558594,57.00849914550781,19922000.0,0.0,0.0,0.7949981689453125,0.0,0.7949981689453125,57.21775415471553,54.68999862670898,59.314300537109375,50.13730858671567,-49.86269141328433,0.22252827187292468,0.4282739460842997,-0.01324988988192688,1941467540.0,1.0
1388,2018-07-09,GOOG,57.42399978637695,57.73350143432617,57.17100143432617,57.70249938964844,18180000.0,0.0,0.0,0.694000244140625,0.0,0.694000244140625,63.03047069372016,54.68999862670898,59.314300537109375,65.1449845038042,-34.85501549619581,0.31299183727585955,0.40521752432261166,0.025995465000261175,1959647540.0,1.0
1389,2018-07-10,GOOG,57.8489990234375,57.97949981689453,57.47949981689453,57.641998291015625,15968000.0,0.0,0.0,-0.0605010986328125,0.0605010986328125,0.0,62.180659525203836,54.68999862670898,59.314300537109375,63.836655164477506,-36.16334483552249,0.37547469304505654,0.39926895806710067,0.030738657529165048,1943679540.0,-1.0
1390,2018-07-11,GOOG,57.22949981689453,58.214500427246094,57.04999923706055,57.69499969482422,22400000.0,0.0,0.0,0.05300140380859375,0.0,0.05300140380859375,62.6891456377749,54.68999862670898,58.86474990844727,71.98036159088285,-28.01963840911715,0.42437761575442323,0.4042906896045652,0.0452181800980187,1966079540.0,1.0
1391,2018-07-12,GOOG,57.99449920654297,59.22050094604492,57.79674911499024,59.17399978637695,25038000.0,0.0,0.0,1.4790000915527344,0.0,1.4790000915527344,73.96141322685801,54.68999862670898,59.22050094604492,98.97359814894025,-1.0264018510597435,0.5758385725793076,0.4386002661995137,0.06216010020059848,1991117540.0,1.0
1392,2018-07-13,GOOG,59.25,59.77085113525391,59.0,59.44100189208984,24438000.0,0.0,0.0,0.2670021057128835,0.0,0.2670021057128835,75.5030514791618,54.68999862670898,59.77085113525391,93.5079941287542,-6.492005871245798,0.7092416147345446,0.49272853590651994,0.06558509552864744,2015555540.0,1.0
1393,2018-07-16,GOOG,59.46950149536133,59.54999923706055,58.9640007019043,59.19300079345703,21114000.0,0.0,0.0,-0.2480010986328054,0.2480010986328054,0.0,70.9980170675731,54.68999862670898,59.77085113525391,88.62690186686076,-11.373098133139235,0.7858935787574381,0.5513615444767036,0.05002394124609788,1994441540.0,-1.0
1394,2018-07-17,GOOG,58.61100006103516,60.152000427246094,58.52999877929688,59.93999862670898,32208000.0,0.0,0.0,0.746997833251946,0.0,0.746997833251946,75.97922117055921,54.68999862670898,60.152000427246094,96.11860617628743,-3.8813938237125605,0.8965820548894001,0.6204056465592429,0.08696239571659792,2026649540.0,1.0
1395,2018-07-18,GOOG,59.82799911499024,60.22499847412109,59.516998291015625,59.79399871826172,27872000.0,0.0,0.0,-0.14599990844725852,0.14599990844725852,0.0,73.14601321422727,54.68999862670898,60.22499847412109,92.21319299474088,-7.786807005259123,0.9614396197902764,0.6886124412054496,0.06369462281297977,1998777540.0,-1.0
1396,2018-07-19,GOOG,59.54999923706055,60.0,59.16600036621094,59.34799957275391,25534000.0,0.0,0.0,-0.4459991455078054,0.4459991455078054,0.0,64.648853306749,54.68999862670898,60.22499847412109,84.1553942991125,-15.844605700887495,0.9657190949878895,0.7440337719619377,0.041037748095679394,1973243540.0,-1.0
1397,2018-07-20,GOOG,59.34799957275391,59.84299850463867,59.21099853515625,59.24549865722656,24948000.0,0.0,0.0,-0.10250091552735086,0.10250091552735086,0.0,62.71684513269094,54.68999862670898,60.22499847412109,82.30352585551579,-17.696474144484206,0.949889903149213,0.7852049981993928,0.026740596748828782,1948295540.0,-1.0
1398,2018-07-23,GOOG,59.05049896240234,60.324501037597656,59.04999923706055,60.275001525878906,52384000.0,0.0,0.0,1.0295028686523438,0.0,1.0295028686523438,72.30766006718746,55.0009994506836,60.324501037597656,99.07017005798538,-0.9298299420146137,1.0087887434740992,0.8299217472543343,0.045678555791388575,2000679540.0,1.0
1399,2018-07-24,GOOG,63.12950134277344,63.29999923706055,61.77799987792969,62.40399932861328,66364000.0,0.0,0.0,2.128997802734375,0.0,2.128997802734375,82.84046332650966,55.42399978637695,63.29999923706055,88.62366720493489,-11.37633279506511,1.2132729730809615,0.9065919924196599,0.08161885187099682,2067043540.0,1.0
1400,2018-07-25,GOOG,61.95650100708008,63.292999267578125,61.95650100708008,63.185001373291016,42556000.0,0.0,0.0,0.7810020446777344,0.0,0.7810020446777344,85.21995853644248,56.03684997558594,63.29999923706055,98.41669419655871,-1.5833058034412977,1.4219570998631355,1.009665013908355,0.06778317506665288,2109599540.0,1.0
1401,2018-07-26,GOOG,62.54999923706055,63.488548278808594,62.45100021362305,63.416500091552734,48112000.0,0.0,0.0,0.23149871826171875,0.0,0.23149871826171875,85.88918881954272,57.04999923706055,63.488548278808594,98.88098721018208,-1.1190127898179139,1.5877185544983803,1.12527572202636,0.0668814130468407,2157711540.0,1.0
1402,2018-07-27,GOOG,63.54999923706055,63.69449996948242,61.54999923706055,61.92499923706055,42612000.0,0.0,0.0,-1.4915008544921875,1.4915008544921875,0.0,64.25913388237848,57.04999923706055,63.69449996948242,73.3689436771737,-26.63105632282629,1.580514856153414,1.216323548851771,0.04615407914757208,2115099540.0,-1.0
1403,2018-07-30,GOOG,61.4005012512207,61.74580001831055,60.57350158691406,60.98699951171875,36998000.0,0.0,0.0,-0.9379997253417969,0.9379997253417969,0.0,54.33049152817393,57.04999923706055,63.69449996948242,59.252010545315926,-40.747989454684074,1.4820331787202292,1.2694654748254628,0.017467482632594455,2078101540.0,-1.0
1404,2018-07-31,GOOG,61.0004997253418,61.37939834594727,60.27999877929688,60.86299896240234,32894000.0,0.0,0.0,-0.12400054931641336,0.12400054931641336,0.0,53.07951052899174,57.79674911499024,63.69449996948242,51.99015562138579,-48.009844378614204,1.3780941206294415,1.2911912039862585,0.01787805243093965,2045207540.0,-1.0
1405,2018-08-01,GOOG,61.400001525878906,61.67350006103516,60.510501861572266,61.0004997253418,31344000.0,0.0,0.0,0.13750076293946023,0.0,0.13750076293946023,54.422242825651274,58.52999877929688,63.69449996948242,47.836196663867156,-52.163803336132844,1.2919243311844895,1.2913378294259048,0.02784424352099868,2076551540.0,1.0
1406,2018-08-02,GOOG,60.29499816894531,61.49399948120117,60.23949813842773,61.307498931884766,30626000.0,0.0,0.0,0.30699920654296875,0.0,0.30699920654296875,57.551688203389496,58.52999877929688,63.69449996948242,53.78060823891686,-46.219391761083145,1.23417956868051,1.2799061772768259,0.03480433655539317,2107177540.0,1.0
1407,2018-08-03,GOOG,61.48099899291992,61.5,60.75299835205078,61.18550109863281,21792000.0,0.0,0.0,-0.12199783325195312,0.12199783325195312,0.0,55.795087079548004,58.52999877929688,63.69449996948242,51.41836978142954,-48.58163021857046,1.1651412003204697,1.2569531818855548,0.015105757771951112,2085385540.0,-1.0
1408,2018-08-06,GOOG,61.25,61.30440139770508,60.78984832763672,61.23849868774414,21634000.0,0.0,0.0,0.052997589111328125,0.0,0.052997589111328125,56.46119333659629,59.04999923706055,63.69449996948242,47.12023049983245,-52.87976950016755,1.1020010760892092,1.2259627607262857,-0.01867669786245152,2107019540.0,1.0
1409,2018-08-07,GOOG,61.84999847412109,62.55849838256836,61.80849838256836,62.11100006103516,29880000.0,0.0,0.0,0.8725013732910227,0.0,0.8725013732910227,66.15033422402469,59.04999923706055,63.69449996948242,65.90591756411366,-34.09408243588633,1.1095751501182463,1.202685238604678,-0.016997725550574216,2136899540.0,1.0
1410,2018-08-08,GOOG,62.02349853515625,62.82500076293945,61.90039825439453,62.28049850463867,27406000.0,0.0,0.0,0.16949844360350852,0.0,0.16949844360350852,67.75864346705512,59.04999923706055,63.69449996948242,69.55536135513927,-30.44463864486073,1.1163857660111631,1.185425344085975,-0.017913344086697425,2164305540.0,1.0
1411,2018-08-09,GOOG,62.494998931884766,62.777099609375,62.30049896240234,62.45500183105469,16972000.0,0.0,0.0,0.17450332641601562,0.0,0.17450332641601562,69.48118139354985,59.04999923706055,63.69449996948242,73.31256447490324,-26.687435525096753,1.122919866997357,1.1729242486682514,0.008558782406523635,2181277540.0,1.0
1412,2018-08-10,GOOG,62.150001525878906,62.28475189208984,61.59999847412109,61.88050079345703,22174000.0,0.0,0.0,-0.5745010375976562,0.5745010375976562,0.0,57.75896120730634,60.23949813842773,63.69449996948242,47.496433729193186,-52.50356627080682,1.0694132266853345,1.152222044271668,0.014650684389983626,2159103540.0,-1.0
1413,2018-08-13,GOOG,61.8489990234375,62.46364974975586,61.68204879760742,61.7504997253418,19946000.0,0.0,0.0,-0.13000106811523438,0.13000106811523438,0.0,55.322021783521755,60.23949813842773,63.69449996948242,43.733742000733244,-56.266257999266756,1.004934568851219,1.1227645491875782,0.014581942692106109,2139157540.0,-1.0
1414,2018-08-14,GOOG,61.759498596191406,62.29349899291992,61.25550079345703,62.10499954223633,26962000.0,0.0,0.0,0.35449981689453125,0.0,0.35449981689453125,60.55803681604464,60.23949813842773,63.69449996948242,53.99422330375804,-46.00577669624196,0.971244043760791,1.0924604481022209,0.018106406043681744,2166119540.0,1.0
1415,2018-08-15,GOOG,61.4630012512207,61.762001037597656,60.47549819946289,60.71900177001953,36576000.0,0.0,0.0,-1.3859977722167969,1.3859977722167969,0.0,39.614312276587476,60.23949813842773,63.69449996948242,13.878534803711748,-86.12146519628826,0.8232161001796499,1.0386115785177066,-0.00959910569046507,2129543540.0,-1.0
1416,2018-08-16,GOOG,61.23649978637695,61.29999923706055,60.12749862670898,60.324501037597656,26864000.0,0.0,0.0,-0.394500732421875,0.394500732421875,0.0,35.57372358427634,60.12749862670898,62.82500076293945,7.30314197874826,-92.69685802125174,0.6663882671501824,0.9641669162442017,-0.014071962239014746,2102679540.0,-1.0
1417,2018-08-17,GOOG,60.10150146484375,60.45100021362305,59.4119987487793,60.04800033569336,27792000.0,0.0,0.0,-0.2765007019042969,0.2765007019042969,0.0,32.86293757102523,59.4119987487793,62.82500076293945,18.634667787342767,-81.36533221265722,0.5138662534606482,0.8741067836874912,-0.01944035823152923,2074887540.0,-1.0
1418,2018-08-20,GOOG,60.2509994506836,60.54999923706055,59.73130035400391,60.38850021362305,17416000.0,0.0,0.0,0.3404998779296875,0.0,0.3404998779296875,39.42210500632432,59.4119987487793,62.82500076293945,28.611218534075185,-71.38878146592481,0.41567530703206046,0.7824204883564051,-0.02773260526669108,2092303540.0,1.0
1419,2018-08-21,GOOG,60.400001525878906,60.86299896240234,60.0177001953125,60.08100128173828,24112000.0,0.0,0.0,-0.3074989318847656,0.3074989318847656,0.0,35.77962844027341,59.4119987487793,62.82500076293945,19.60158623356708,-80.39841376643292,0.309478208488585,0.6878320323828412,-0.035315986154744294,2068191540.0,-1.0
1420,2018-08-22,GOOG,60.0,60.59199905395508,59.95000076293945,60.36650085449219,17748000.0,0.0,0.0,0.28549957275390625,0.0,0.28549957275390625,41.563891073591954,59.4119987487793,62.82500076293945,27.966643493111643,-72.03335650688835,0.24552343100624796,0.5993703121075226,-0.03344009151119787,2085939540.0,1.0
1421,2018-08-23,GOOG,60.35699844360352,61.06399917602539,60.21200180053711,60.26900100708008,19852000.0,0.0,0.0,-0.09749984741210938,0.09749984741210938,0.0,40.13929637078823,59.4119987487793,62.82500076293945,25.10992536028917,-74.89007463971083,0.18484065818798712,0.5164643813236155,-0.02604212580237142,2066087540.0,-1.0
1422,2018-08-24,GOOG,60.44100189208984,61.08250045776367,60.31795120239258,61.032501220703125,18932000.0,0.0,0.0,0.7635002136230469,0.0,0.7635002136230469,54.29401730827611,59.4119987487793,62.82500076293945,47.48026708453579,-52.51973291546421,0.19609672891069607,0.4523908508410316,-0.011627412050626895,2085019540.0,1.0
1423,2018-08-27,GOOG,61.380001068115234,62.15449905395508,61.28580093383789,62.09099960327149,23126000.0,0.0,0.0,1.0584983825683665,0.0,1.0584983825683665,66.83786809233482,59.4119987487793,62.82500076293945,78.49397226773748,-21.506027732262524,0.28711948459450554,0.41933657759172643,-0.00022542370289069247,2108145540.0,1.0
1424,2018-08-28,GOOG,62.06449890136719,62.12725067138672,61.43450164794922,61.557498931884766,26080000.0,0.0,0.0,-0.5335006713867259,0.5335006713867259,0.0,57.63840537297509,59.4119987487793,62.777099609375,63.75738118962842,-36.24261881037158,0.31260313438321674,0.3979898889500245,0.01380946882231604,2082065540.0,-1.0
1425,2018-08-29,GOOG,61.872501373291016,62.53300094604492,61.81795120239258,62.46500015258789,25978000.0,0.0,0.0,0.907501220703125,0.0,0.907501220703125,66.64827211938169,59.4119987487793,62.53300094604492,97.82118726104684,-2.178812738953153,0.40139978775658847,0.39867186871133736,0.03548308031020686,2108043540.0,1.0
1426,2018-08-30,GOOG,62.21149826049805,62.6817512512207,61.62950134277344,61.95600128173828,26628000.0,0.0,0.0,-0.5089988708496094,0.5089988708496094,0.0,58.58436849693875,59.4119987487793,62.6817512512207,77.80413138485159,-22.195868615148413,0.4257915602433755,0.4040958070177451,0.03177459591290965,2081415540.0,-1.0
1427,2018-08-31,GOOG,61.749000549316406,61.93299865722656,60.56425094604492,60.90950012207031,36328000.0,0.0,0.0,-1.0465011596679688,1.0465011596679688,0.0,45.51904008532951,59.4119987487793,62.6817512512207,45.798615405076845,-54.201384594923155,0.35656802383935826,0.3945902503820678,0.008627468915509473,2045087540.0,-1.0
1428,2018-09-04,GOOG,60.2135009765625,60.64950180053711,59.625,59.84999847412109,36620000.0,0.0,0.0,-1.0595016479492259,1.0595016479492259,0.0,36.111193106919245,59.4119987487793,62.6817512512207,13.39550088316321,-86.60449911683679,0.21375095617827355,0.358422391541309,-0.0038448561556747585,2008467540.0,-1.0
1429,2018-09-05,GOOG,59.68999862670898,59.95050048828125,58.09999847412109,59.32400131225586,41226000.0,0.0,0.0,-0.5259971618652273,0.5259971618652273,0.0,32.28845862341552,58.09999847412109,62.6817512512207,26.714729006168735,-73.28527099383126,0.05746144631007155,0.29823020249506155,-0.017269504236284594,1967241540.0,-1.0
1430,2018-09-06,GOOG,59.31499862670898,59.31499862670898,57.59999847412109,58.571998596191406,37770000.0,0.0,0.0,-0.7520027160644531,0.7520027160644531,0.0,27.48821997556017,57.59999847412109,62.6817512512207,19.127261098779456,-80.87273890122054,-0.12563125183465473,0.21345791162911829,-0.028157135219303187,1929471540.0,-1.0
1431,2018-09-07,GOOG,57.93349838256836,58.76300048828125,57.860748291015625,58.24150085449219,28026000.0,0.0,0.0,-0.33049774169921875,0.33049774169921875,0.0,25.5611689237693,57.59999847412109,62.6817512512207,12.623644016331603,-87.37635598366839,-0.294012744000014,0.11196378050329181,-0.045729739243657086,1901445540.0,-1.0
1432,2018-09-10,GOOG,58.609500885009766,58.72700119018555,58.00550079345703,58.23199844360352,22308000.0,0.0,0.0,-0.00950241088866477,0.00950241088866477,0.0,25.5018584150785,57.59999847412109,62.6817512512207,12.436653202227337,-87.56334679777267,-0.423343019995329,0.004902420403567621,-0.06215073334822985,1879137540.0,-1.0
1433,2018-09-11,GOOG,58.08150100708008,58.93399810791016,57.8120002746582,58.86800003051758,24186000.0,0.0,0.0,0.6360015869140554,0.0,0.6360015869140554,36.822823511595736,57.59999847412109,62.6817512512207,24.952051231429575,-75.04794876857042,-0.4691105681011294,-0.08990017729737182,-0.04369084105160281,1903323540.0,1.0
1434,2018-09-12,GOOG,58.63600158691406,58.93050003051758,57.917999267578125,58.14099884033203,25910000.0,0.0,0.0,-0.7270011901855469,0.7270011901855469,0.0,30.67469313539881,57.59999847412109,62.6817512512207,10.64594028755011,-89.35405971244988,-0.5576167412689017,-0.18344349009167785,-0.06922278558702155,1877413540.0,-1.0
1435,2018-09-13,GOOG,58.5369987487793,58.93050003051758,58.14250183105469,58.76649856567383,28624000.0,0.0,0.0,0.6254997253417969,0.0,0.6254997253417969,40.531823728506346,57.59999847412109,62.6817512512207,22.95468006254557,-77.04531993745442,-0.5707071639084802,-0.2608962248550384,-0.05148012541288016,1906037540.0,1.0
1436,2018-09-14,GOOG,58.95500183105469,59.0212516784668,58.416500091552734,58.62649917602539,18880000.0,0.0,0.0,-0.1399993896484375,0.1399993896484375,0.0,39.09620141805177,57.59999847412109,62.6817512512207,20.199737116888514,-79.80026288311149,-0.5856274501774337,-0.3258424699195175,-0.0374818532654102,1887157540.0,-1.0
1437,2018-09-17,GOOG,58.50699996948242,58.86199951171875,57.70149993896485,57.8025016784668,26130000.0,0.0,0.0,-0.8239974975585938,0.8239974975585938,0.0,31.515408241938815,57.59999847412109,62.6817512512207,3.9849086177168944,-96.0150913822831,-0.6563753101628933,-0.3919490379681927,-0.03421047364837648,1861027540.0,-1.0
1438,2018-09-18,GOOG,57.85449981689453,58.80400085449219,57.85449981689453,58.06100082397461,24072000.0,0.0,0.0,0.2584991455078125,0.0,0.2584991455078125,36.00693626323197,57.59999847412109,62.6817512512207,9.071719347131195,-90.9282806528688,-0.6837034702231009,-0.4502999244191744,-0.021289873581408658,1885099540.0,1.0
1439,2018-09-19,GOOG,58.249000549316406,58.66049957275391,57.729000091552734,58.554500579833984,23828000.0,0.0,0.0,0.493499755859375,0.0,0.493499755859375,44.084968032254224,57.59999847412109,62.6817512512207,18.782930763854964,-81.21706923614504,-0.6579554274071455,-0.4918310250167687,-0.00029874371332383465,1908927540.0,1.0
1440,2018-09-20,GOOG,58.9995002746582,59.49449920654297,58.667999267578125,59.34349822998047,24508000.0,0.0,0.0,0.7889976501464844,0.0,0.7889976501464844,54.64636622637978,57.59999847412109,61.93299865722656,40.237703258295504,-59.7622967417045,-0.5673444083526817,-0.5069337016839514,0.01892117063125598,1933435540.0,1.0
1441,2018-09-21,GOOG,59.59999847412109,59.61050033569336,58.30199813842773,58.304500579833984,88112000.0,0.0,0.0,-1.0389976501464844,1.0389976501464844,0.0,42.46031905213399,57.59999847412109,60.64950180053711,23.10219174415117,-76.89780825584883,-0.5727704092948827,-0.5201010432061376,0.001245056638416342,1845323540.0,-1.0
1442,2018-09-24,GOOG,57.85850143432617,58.900001525878906,57.34550094604492,58.66849899291992,25420000.0,0.0,0.0,0.3639984130859375,0.0,0.3639984130859375,47.218250491421294,57.34550094604492,59.95050048828125,50.7868821251016,-49.21311787489841,-0.5414573410769918,-0.5243723027803084,-0.0033889555869781596,1870743540.0,1.0
1443,2018-09-25,GOOG,58.807498931884766,59.34400177001953,58.400001525878906,59.23249816894531,19554000.0,0.0,0.0,0.5639991760253906,0.0,0.5639991760253906,54.01626190070038,57.34550094604492,59.61050033569336,83.31115811882323,-16.68884188117678,-0.46576246913129893,-0.5126503360505066,0.018773315739049723,1890297540.0,1.0
1444,2018-09-26,GOOG,59.25749969482422,59.71149826049805,58.73825073242188,59.02450180053711,29246000.0,0.0,0.0,-0.20799636840820312,0.20799636840820312,0.0,51.20969446344712,57.34550094604492,59.71149826049805,70.963768396342,-29.036231603657985,-0.4177418385154539,-0.493668636543496,0.004390311506732969,1861051540.0,-1.0
1445,2018-09-27,GOOG,59.33649826049805,60.10499954223633,59.18149948120117,59.73199844360352,25216000.0,0.0,0.0,0.7074966430664134,0.0,0.7074966430664134,59.473918898282434,57.34550094604492,60.10499954223633,86.48301183600482,-13.516988163995174,-0.31891976791921905,-0.4587188628186407,0.01885664815596244,1886267540.0,1.0
1446,2018-09-28,GOOG,59.59349822998047,59.77050018310547,59.22499847412109,59.67350006103516,27612000.0,0.0,0.0,-0.058498382568359375,0.058498382568359375,0.0,58.528116319776096,57.34550094604492,60.10499954223633,84.36312010461937,-15.636879895380632,-0.24252719306529258,-0.41548052886797104,0.032368813256146156,1858655540.0,-1.0
1447,2018-10-01,GOOG,59.99449920654297,60.494998931884766,59.51499938964844,59.76549911499024,27152000.0,0.0,0.0,0.09199905395507812,0.0,0.09199905395507812,59.69133081931771,57.34550094604492,60.494998931884766,76.83758426979924,-23.16241573020076,-0.17257266210279454,-0.3668989555149358,0.029357025659671576,1885807540.0,1.0
1448,2018-10-02,GOOG,59.54800033569336,60.49800109863281,59.33150100708008,60.00550079345703,33758000.0,0.0,0.0,0.24000167846678977,0.0,0.24000167846678977,62.82954610860829,57.34550094604492,60.49800109863281,84.37746926763866,-15.622530732361337,-0.09665290808523253,-0.3128497460289952,0.024780336255190827,1919565540.0,1.0
1449,2018-10-03,GOOG,60.25,60.320499420166016,59.69150161743164,60.147499084472656,25124000.0,0.0,0.0,0.141998291015625,0.0,0.141998291015625,64.7054421424939,57.34550094604492,60.49800109863281,88.88177645693597,-11.118223543064028,-0.02474266268463765,-0.2552283293601237,0.013548255132792342,1944689540.0,1.0
1450,2018-10-04,GOOG,59.76649856567383,59.8754997253418,57.77880096435547,58.40950012207031,44190000.0,0.0,0.0,-1.7379989624023438,1.7379989624023438,0.0,37.77911988753139,57.34550094604492,60.49800109863281,33.75096350596375,-66.24903649403625,-0.10676455103609328,-0.2255355736953176,0.0018008822851085515,1900499540.0,-1.0
1451,2018-10-05,GOOG,58.375,58.67499923706055,57.25600051879883,57.86750030517578,23686000.0,0.0,0.0,-0.5419998168945312,0.5419998168945312,0.0,32.85887760898174,57.25600051879883,60.49800109863281,18.86180373256647,-81.13819626743353,-0.21304647686388734,-0.22303775432903156,-0.01365296030227059,1876813540.0,-1.0
1452,2018-10-08,GOOG,57.50550079345703,58.400001525878906,56.36819839477539,57.44850158691406,38648000.0,0.0,0.0,-0.41899871826171875,0.41899871826171875,0.0,29.438939302667578,56.36819839477539,60.49800109863281,26.15871191932777,-73.84128808067223,-0.32731231107049297,-0.24389266567732387,-0.03011854365728195,1838165540.0,-1.0
1453,2018-10-09,GOOG,57.307498931884766,57.71749877929688,56.87860107421875,56.94100189208984,26174000.0,0.0,0.0,-0.5074996948242259,0.5074996948242259,0.0,25.700591805883803,56.36819839477539,60.49800109863281,13.869996665444132,-86.13000333455587,-0.4535910763628266,-0.28583234781442446,-0.035298898675809154,1811991540.0,-1.0
1454,2018-10-10,GOOG,56.55400085449219,56.60850143432617,54.05649948120117,54.06100082397461,53514000.0,0.0,0.0,-2.8800010681152273,2.8800010681152273,0.0,14.032536761506279,54.05649948120117,60.49800109863281,0.0698803328909553,-99.93011966710904,-0.7771019768106058,-0.38408627361366077,-0.09494069790722359,1758477540.0,-1.0
1455,2018-10-11,GOOG,53.64699935913086,55.31999969482422,53.41350173950195,53.96599960327149,58980000.0,0.0,0.0,-0.0950012207031179,0.0950012207031179,0.0,13.794175575066276,53.41350173950195,60.49800109863281,7.798686057575138,-92.20131394242486,-1.029287514974655,-0.5131265218858597,-0.09564547834341763,1699497540.0,-1.0
1456,2018-10-12,GOOG,55.400001525878906,55.75,54.320098876953125,55.50400161743164,42026000.0,0.0,0.0,1.5380020141601491,0.0,1.5380020141601491,34.558878005610126,53.41350173950195,60.49800109863281,29.508081968210586,-70.49191803178941,-1.0924493854553816,-0.6289910945997641,-0.0713036377285059,1741523540.0,1.0
1457,2018-10-15,GOOG,55.445499420166016,55.67229843139648,54.45000076293945,54.61249923706055,27448000.0,0.0,0.0,-0.8915023803710938,0.8915023803710938,0.0,29.763844570049912,53.41350173950195,60.49800109863281,16.924237504704767,-83.07576249529524,-1.2006026147737998,-0.7433133986345714,-0.08987511953211691,1714075540.0,-1.0
1458,2018-10-16,GOOG,55.22949981689453,56.21099853515625,55.125,56.06399917602539,38570000.0,0.0,0.0,1.4514999389648438,0.0,1.4514999389648438,44.28620388042161,53.41350173950195,60.49800109863281,37.41262864407409,-62.5873713559259,-1.155866800849168,-0.8258240790774909,-0.06789143307043066,1752645540.0,1.0
1459,2018-10-17,GOOG,56.323001861572266,56.449501037597656,55.109500885009766,55.78450012207031,29344000.0,0.0,0.0,-0.2794990539550781,0.2794990539550781,0.0,42.341069982724015,53.41350173950195,60.49800109863281,33.46740909098252,-66.53259090901749,-1.12994132357872,-0.8866475279777368,-0.04494131938321677,1723301540.0,-1.0
1460,2018-10-18,GOOG,56.09199905395508,56.09199905395508,53.85449981689453,54.39849853515625,41890000.0,0.0,0.0,-1.3860015869140625,1.3860015869140625,0.0,33.83735419501396,53.41350173950195,60.49800109863281,13.903548376848724,-86.09645162315127,-1.2073167449174775,-0.9507813713656851,-0.05994732365706246,1681411540.0,-1.0
1461,2018-10-19,GOOG,54.66849899291992,55.51800155639648,54.38750076293945,54.823001861572266,25352000.0,0.0,0.0,0.4245033264160156,0.0,0.4245033264160156,38.222108532289944,53.41350173950195,60.49800109863281,19.895550138679564,-80.10444986132043,-1.2203164051705855,-1.0046883781266653,-0.045701796440585474,1706763540.0,1.0
1462,2018-10-22,GOOG,55.15299987792969,55.61149978637695,54.54999923706055,55.05799865722656,30284000.0,0.0,0.0,0.23499679565429688,0.0,0.23499679565429688,40.731038114524374,53.41350173950195,60.320499420166016,23.809142463277936,-76.19085753672206,-1.1978484013831263,-1.0433203827779576,-0.033069373075517605,1737047540.0,1.0
1463,2018-10-23,GOOG,54.04449844360352,55.39450073242188,53.5,55.18450164794922,36974000.0,0.0,0.0,0.12650299072265625,0.0,0.12650299072265625,42.18934864812587,53.41350173950195,59.8754997253418,27.406382860657835,-72.59361713934216,-1.156503163812431,-1.0659569389848522,0.020782094427603814,1774021540.0,1.0
1464,2018-10-24,GOOG,55.212501525878906,55.305999755859375,52.4370002746582,52.53549957275391,39648000.0,0.0,0.0,-2.6490020751953054,2.6490020751953054,0.0,26.459291159176587,52.4370002746582,58.67499923706055,1.5790207515163923,-98.4209792484836,-1.3222470530382822,-1.1172149617955383,-0.026507431364819145,1734373540.0,-1.0
1465,2018-10-25,GOOG,53.589500427246094,55.54899978637695,53.477500915527344,54.77849960327149,50916000.0,0.0,0.0,2.243000030517578,0.0,2.243000030517578,46.09516052645965,52.4370002746582,58.400001525878906,39.267127910361474,-60.73287208963853,-1.2581062566578396,-1.1453932207679987,-0.013071165916302085,1785289540.0,1.0
1466,2018-10-26,GOOG,51.85150146484375,55.32649993896485,51.704498291015625,53.57350158691406,83752000.0,0.0,0.0,-1.204998016357429,1.204998016357429,0.0,39.54930859395327,51.704498291015625,57.71749877929688,31.082706537957876,-68.91729346204212,-1.2896413006087002,-1.174242836736139,-0.01902490573882054,1701537540.0,-1.0
1467,2018-10-29,GOOG,54.12350082397461,54.85200119018555,49.791500091552734,51.00400161743164,77614000.0,0.0,0.0,-2.569499969482422,2.569499969482422,0.0,29.308842843660855,49.791500091552734,56.60850143432617,17.786435192128195,-82.2135648078718,-1.5046258334564584,-1.240319436080203,-0.09025395321348306,1623923540.0,-1.0
1468,2018-10-30,GOOG,50.42300033569336,51.8745002746582,50.03749847412109,51.81050109863281,64254000.0,0.0,0.0,0.8064994812011719,0.0,0.8064994812011719,35.36952544949375,49.791500091552734,56.449501037597656,30.32443256529474,-69.67556743470527,-1.5915781346692057,-1.3105711757980036,-0.07123840878275156,1688177540.0,1.0
1469,2018-10-31,GOOG,52.990501403808594,54.59700012207031,52.84999847412109,53.8385009765625,50596000.0,0.0,0.0,2.0279998779296875,0.0,2.0279998779296875,48.24398528453915,49.791500091552734,56.449501037597656,60.7840238805286,-39.2159761194714,-1.4797877463865703,-1.344414489915717,-0.010294356897219137,1738773540.0,1.0
1470,2018-11-01,GOOG,53.790000915527344,54.19874954223633,53.12300109863281,53.5,29640000.0,0.0,0.0,-0.3385009765625,0.3385009765625,0.0,46.461504530802294,49.791500091552734,56.449501037597656,55.699900593289044,-44.300099406710956,-1.40234193322555,-1.3559999785776837,-0.02413224042187323,1709133540.0,-1.0
1471,2018-11-02,GOOG,53.686500549316406,54.14875030517578,52.730499267578125,52.88949966430664,36780000.0,0.0,0.0,-0.6105003356933594,0.6105003356933594,0.0,43.144252207891036,49.791500091552734,56.449501037597656,46.53047660791071,-53.46952339208929,-1.3743847909099713,-1.3596769410441414,-0.03938572134487306,1672353540.0,-1.0
1472,2018-11-05,GOOG,52.75,52.92350006103516,51.0620002746582,52.00450134277344,48828000.0,0.0,0.0,-0.8849983215332031,0.8849983215332031,0.0,38.541493349893045,49.791500091552734,56.449501037597656,33.23822374244781,-66.76177625755219,-1.4074166988943162,-1.3692248926141766,-0.057624880359755104,1623525540.0,-1.0
1473,2018-11-06,GOOG,51.9739990234375,53.21725082397461,51.90349960327149,52.79050064086914,24666000.0,0.0,0.0,0.7859992980957031,0.0,0.7859992980957031,44.59832860874643,49.791500091552734,56.09199905395508,47.599413430788104,-52.400586569211896,-1.3545566634340176,-1.366291246778145,0.00485388109352769,1648191540.0,1.0
1474,2018-11-07,GOOG,53.45000076293945,54.77299880981445,53.29499816894531,54.66949844360352,41168000.0,0.0,0.0,1.878997802734382,0.0,1.878997802734382,56.43979943853394,49.791500091552734,55.61149978637695,83.81440906927948,-16.185590930720515,-1.1478139999528807,-1.3225957974130922,-0.0019898529616072524,1689359540.0,1.0
1475,2018-11-08,GOOG,54.56900024414063,54.66350173950195,53.61024856567383,54.119998931884766,29764000.0,0.0,0.0,-0.5494995117187571,0.5494995117187571,0.0,52.6430432020607,49.791500091552734,55.61149978637695,74.37283620790232,-25.62716379209768,-1.0165903471637137,-1.2613947073632166,0.010200889036235727,1659595540.0,-1.0
1476,2018-11-09,GOOG,53.699501037597656,53.77799987792969,52.65549850463867,53.307498931884766,26864000.0,0.0,0.0,-0.8125,0.8125,0.0,47.223201015687586,49.791500091552734,55.54899978637695,61.06815504467652,-38.93184495532348,-0.9670095326176309,-1.2025176724140996,0.04516307037496947,1632731540.0,-1.0
1477,2018-11-12,GOOG,53.06949996948242,53.10599899291992,51.54999923706055,51.93149948120117,29436000.0,0.0,0.0,-1.3759994506835938,1.3759994506835938,0.0,39.31395343309843,49.791500091552734,55.54899978637695,37.168901486390325,-62.831098513609675,-1.0269104513882752,-1.1673962282089347,0.0023354026693933605,1603295540.0,-1.0
1478,2018-11-13,GOOG,52.16450119018555,52.83024978637695,51.557498931884766,51.8025016784668,30274000.0,0.0,0.0,-0.128997802734375,0.128997802734375,0.0,38.614368189168225,49.791500091552734,55.54899978637695,34.92838373438177,-65.07161626561823,-1.0724291104564685,-1.1484028046584416,-0.03781679023682394,1573021540.0,-1.0
1479,2018-11-14,GOOG,52.5,52.72819900512695,51.54999923706055,52.18299865722656,31318000.0,0.0,0.0,0.3804969787597656,0.0,0.3804969787597656,42.1197941235088,49.791500091552734,55.32649993896485,43.20684067935378,-56.79315932064621,-1.0655174278258528,-1.1318257292919238,-0.024616847528475483,1604339540.0,1.0
1480,2018-11-15,GOOG,52.23550033569336,53.59249877929688,51.5890007019043,53.23550033569336,36722000.0,0.0,0.0,1.0525016784667969,0.0,1.0525016784667969,51.042781729535584,49.791500091552734,54.85200119018555,68.05650620392288,-31.94349379607713,-0.9639993952566428,-1.0982604624848677,0.006541953952728052,1641061540.0,1.0
1481,2018-11-16,GOOG,52.97050094604492,53.34999847412109,52.44900131225586,53.074501037597656,33162000.0,0.0,0.0,-0.16099929809570312,0.16099929809570312,0.0,49.690695498229516,50.03749847412109,54.77299880981445,64.13266493902371,-35.86733506097629,-0.8863199759094158,-1.0558723651697774,0.020575136136228078,1607899540.0,-1.0
1482,2018-11-19,GOOG,52.86000061035156,53.03950119018555,50.8129997253418,51.0,37172000.0,0.0,0.0,-2.0745010375976562,2.0745010375976562,0.0,35.650497532004266,50.8129997253418,54.77299880981445,4.722230249785664,-95.27776975021433,-0.9808467816889248,-1.040867248473607,-0.03391709908284102,1570727540.0,-1.0
1483,2018-11-20,GOOG,50.0,51.58700180053711,49.80099868774414,51.28799819946289,48982000.0,0.0,0.0,0.2879981994628906,0.0,0.2879981994628906,38.43689271619077,49.80099868774414,54.77299880981445,29.90747134373705,-70.09252865626294,-1.0207542884628467,-1.0368446564714549,-0.06185350772202436,1619709540.0,1.0
1484,2018-11-21,GOOG,51.8380012512207,52.428001403808594,51.67350006103516,51.88050079345703,30686000.0,0.0,0.0,0.5925025939941406,0.0,0.5925025939941406,44.1750715927387,49.80099868774414,54.77299880981445,41.82425693197686,-58.175743068023145,-0.9931231619020053,-1.028100357557565,-0.041380232494948044,1650395540.0,1.0
1485,2018-11-23,GOOG,51.5,51.87950134277344,51.11994934082031,51.19400024414063,13830000.0,0.0,0.0,-0.6865005493163991,0.6865005493163991,0.0,39.28035556673708,49.80099868774414,54.77299880981445,28.016925225183897,-71.9830747748161,-1.0149207770843915,-1.0254644414629301,-0.039647305352755735,1636565540.0,-1.0
1486,2018-11-26,GOOG,51.91749954223633,52.46549987792969,51.695499420166016,52.430999755859375,38856000.0,0.0,0.0,1.236999511718743,0.0,1.236999511718743,50.649299102693746,49.80099868774414,54.77299880981445,52.89623900934494,-47.10376099065506,-0.9217546082487615,-1.0047224748200965,0.009618445060286085,1675421540.0,1.0
1487,2018-11-27,GOOG,52.04999923706055,52.87900161743164,51.92449951171875,52.22050094604492,36064000.0,0.0,0.0,-0.21049880981445312,0.21049880981445312,0.0,48.85327326312253,49.80099868774414,54.77299880981445,48.66255428194387,-51.33744571805613,-0.8550487729553495,-0.9747877344471471,0.008069094233568164,1639357540.0,-1.0
1488,2018-11-28,GOOG,52.4379997253418,54.34199905395508,51.78799819946289,54.311500549316406,49508000.0,0.0,0.0,2.0909996032714844,0.0,2.0909996032714844,63.63378462805466,49.80099868774414,54.66350173950195,92.7609055163822,-7.239094483617797,-0.6262388336701292,-0.9050779542917435,0.04078918319875191,1688865540.0,1.0
1489,2018-11-29,GOOG,53.80400085449219,54.712249755859375,53.79999923706055,54.415000915527344,29378000.0,0.0,0.0,0.1035003662109375,0.0,0.1035003662109375,64.22425236877163,49.80099868774414,54.712249755859375,93.94759428484879,-6.05240571515121,-0.43157872286664656,-0.8103781080067243,0.022156278656089823,1718243540.0,1.0
1490,2018-11-30,GOOG,54.45349884033203,54.77849960327149,53.89400100708008,54.72150039672852,51604000.0,0.0,0.0,0.306499481201179,0.0,0.306499481201179,66.10474952407512,49.80099868774414,54.77849960327149,98.85486296215116,-1.145137037848839,-0.24969886293487065,-0.6982422589923536,0.03103183877252369,1769847540.0,1.0
1491,2018-12-03,GOOG,56.15700149536133,56.23249816894531,55.183250427246094,55.32149887084961,39824000.0,0.0,0.0,0.5999984741210866,0.0,0.5999984741210866,69.70196708196663,49.80099868774414,56.23249816894531,85.83535144862421,-14.16464855137579,-0.05649169994806158,-0.5698921471834952,0.08473527197744324,1809671540.0,1.0
1492,2018-12-04,GOOG,55.15599822998047,55.22100067138672,52.499000549316406,52.54100036621094,46904000.0,0.0,0.0,-2.780498504638672,2.780498504638672,0.0,44.46761639840853,49.80099868774414,56.23249816894531,42.602843807663085,-57.397156192336915,-0.12628093501562887,-0.48116990474992194,0.02443070914709966,1762767540.0,-1.0
1493,2018-12-06,GOOG,51.7130012512207,53.560001373291016,51.53850173950195,53.436500549316406,55384000.0,0.0,0.0,0.8955001831054688,0.0,0.8955001831054688,51.05277306515687,49.80099868774414,56.23249816894531,56.52650477852927,-43.473495221470735,-0.10808409962123022,-0.40655274372418365,0.029991995683580797,1818151540.0,1.0
1494,2018-12-07,GOOG,53.0004997253418,53.76300048828125,51.42499923706055,51.82899856567383,42024000.0,0.0,0.0,-1.6075019836425781,1.6075019836425781,0.0,40.9860223447139,49.80099868774414,56.23249816894531,31.53230259688881,-68.46769740311119,-0.220829368595723,-0.3694080686984916,0.012403764474448797,1776127540.0,-1.0
1495,2018-12-10,GOOG,51.75249862670898,52.42250061035156,51.16450119018555,51.977500915527344,36154000.0,0.0,0.0,0.14850234985351562,0.0,0.14850234985351562,42.20086773763648,49.80099868774414,56.23249816894531,33.841287465620866,-66.15871253437913,-0.294799641238761,-0.3544863832065455,-0.00864944102618126,1812281540.0,1.0
1496,2018-12-11,GOOG,52.824501037597656,53.02999877929688,51.992000579833984,52.587501525878906,27894000.0,0.0,0.0,0.6100006103515625,0.0,0.6100006103515625,47.33894390543828,49.80099868774414,56.23249816894531,43.32586586191168,-56.67413413808832,-0.3007330011305953,-0.3437357067913555,0.007027902321603108,1840175540.0,1.0
1497,2018-12-12,GOOG,53.400001525878906,54.08250045776367,53.13949966430664,53.18399810791016,30476000.0,0.0,0.0,0.5964965820312571,0.0,0.5964965820312571,52.13940455232371,51.11994934082031,56.23249816894531,40.37220643713304,-59.62779356286696,-0.25437071528688904,-0.3258627084904622,-0.02075992064300336,1870651540.0,1.0
1498,2018-12-13,GOOG,53.40349960327149,53.98799896240234,52.69649887084961,53.095001220703125,26596000.0,0.0,0.0,-0.08899688720703836,0.08899688720703836,0.0,51.33381896415871,51.11994934082031,56.23249816894531,38.631452652690896,-61.36854734730911,-0.22224764227728855,-0.3051396952478275,-0.02425801107443437,1844055540.0,-1.0
1499,2018-12-14,GOOG,52.499000549316406,53.130001068115234,52.03950119018555,52.10499954223633,33732000.0,0.0,0.0,-0.9900016784667969,0.9900016784667969,0.0,42.83834968948038,51.16450119018555,56.23249816894531,18.557594962910553,-81.44240503708944,-0.27352174868845935,-0.2988161059359539,-0.04781485952546394,1810323540.0,-1.0
1500,2018-12-17,GOOG,51.8754997253418,52.657501220703125,50.39500045776367,50.82649993896485,47708000.0,0.0,0.0,-1.2784996032714773,1.2784996032714773,0.0,34.364098585944774,50.39500045776367,56.23249816894531,7.391856965950463,-92.60814303404953,-0.41256528475659593,-0.32156594170008235,-0.08125229835833847,1762615540.0,-1.0
1501,2018-12-18,GOOG,51.304500579833984,52.4739990234375,51.071998596191406,51.43550109863281,43850000.0,0.0,0.0,0.6090011596679616,0.0,0.6090011596679616,40.80061953983884,50.39500045776367,56.23249816894531,17.824429102148976,-82.17557089785103,-0.4682196403378214,-0.3508966814276302,-0.021040696977080553,1806465540.0,1.0
1502,2018-12-19,GOOG,51.699501037597656,53.09999847412109,50.40250015258789,51.1505012512207,49586000.0,0.0,0.0,-0.2849998474121094,0.2849998474121094,0.0,38.74878544371325,50.39500045776367,56.23249816894531,12.94220282108001,-87.05779717892,-0.5292226743863253,-0.38656188001936925,-0.04277973435004334,1756879540.0,-1.0
1503,2018-12-20,GOOG,50.90650177001953,51.71099853515625,49.81800079345703,50.47050094604492,53470000.0,0.0,0.0,-0.6800003051757812,0.6800003051757812,0.0,34.03648878483594,49.81800079345703,56.23249816894531,10.172272500746347,-89.82772749925365,-0.6252310852430654,-0.4342957210641085,-0.02621114930298185,1703409540.0,-1.0
1504,2018-12-21,GOOG,50.76499938964844,51.20100021362305,48.68450164794922,48.97700119018555,91920000.0,0.0,0.0,-1.493499755859375,1.493499755859375,0.0,26.01800187341786,48.68450164794922,56.23249816894531,3.8751944495825965,-96.1248055504174,-0.8124657912507374,-0.5099297351014342,-0.057726894761988334,1611489540.0,-1.0
1505,2018-12-24,GOOG,48.69499969482422,50.17699813842773,48.50550079345703,48.81100082397461,31806000.0,0.0,0.0,-0.1660003662109375,0.1660003662109375,0.0,25.25496378021444,48.50550079345703,55.22100067138672,4.549177813577153,-95.45082218642284,-0.9631429742735591,-0.6005723829358592,-0.07181365519040372,1579683540.0,-1.0
1506,2018-12-26,GOOG,49.45050048828125,52.0,49.150001525878906,51.97299957275391,47466000.0,0.0,0.0,3.161998748779304,0.0,3.161998748779304,54.55052016817466,48.50550079345703,54.08250045776367,62.174986336994486,-37.825013663005514,-0.8179796935566443,-0.6440538450600163,-0.02276997928397817,1627149540.0,1.0
1507,2018-12-27,GOOG,50.85749816894531,52.19449996948242,49.84999847412109,52.19400024414063,42196000.0,0.0,0.0,0.22100067138671875,0.0,0.22100067138671875,55.94307834857886,48.50550079345703,54.08250045776367,66.13770257671645,-33.86229742328355,-0.6772963893680313,-0.6507023539216193,-0.016969600825833875,1669345540.0,1.0
1508,2018-12-28,GOOG,52.48099899291992,52.77799987792969,51.65499877929688,51.854000091552734,28296000.0,0.0,0.0,-0.34000015258789773,0.34000015258789773,0.0,53.05729979586318,48.50550079345703,54.08250045776367,60.04123183880458,-39.95876816119542,-0.5864784693199283,-0.6378575770012812,-0.004817185546276304,1641049540.0,-1.0
1509,2018-12-31,GOOG,52.54800033569336,52.6349983215332,51.179500579833984,51.78049850463867,29866000.0,0.0,0.0,-0.0735015869140625,0.0735015869140625,0.0,52.38327664726067,48.50550079345703,54.08250045776367,58.72329044848175,-41.27670955151825,-0.5145046873914012,-0.6131869990793053,0.01876970806212186,1611183540.0,-1.0
1510,2019-01-02,GOOG,50.82849884033203,52.61600112915039,50.78549957275391,52.29249954223633,30652000.0,0.0,0.0,0.5120010375976562,0.0,0.5120010375976562,56.79479205185801,48.50550079345703,54.08250045776367,67.9038726327432,-32.096127367256805,-0.41140828330979673,-0.5728312559254036,0.01666161358008611,1641835540.0,1.0
1511,2019-01-03,GOOG,52.04999923706055,52.8489990234375,50.70349884033203,50.803001403808594,36822000.0,0.0,0.0,-1.4894981384277344,1.4894981384277344,0.0,43.322089568029575,48.50550079345703,53.98799896240234,41.90608988007275,-58.09391011992725,-0.444766698182427,-0.5472183443768083,-0.006793674331858401,1605013540.0,-1.0
1512,2019-01-04,GOOG,51.62950134277344,53.54199981689453,51.37089920043945,53.53549957275391,41878000.0,0.0,0.0,2.7324981689453196,0.0,2.7324981689453196,62.26824317498742,48.50550079345703,53.54199981689453,99.87093725005467,-0.12906274994532535,-0.24785658013905731,-0.48734599152925806,0.06072851604911955,1646891540.0,1.0
1513,2019-01-07,GOOG,53.57500076293945,53.70000076293945,52.73799896240234,53.41949844360352,39638000.0,0.0,0.0,-0.11600112915039062,0.11600112915039062,0.0,61.265082520515314,48.50550079345703,53.70000076293945,94.60001307182836,-5.399986928171636,-0.10001134604711126,-0.40987906243282873,0.09070578323419687,1607253540.0,-1.0
1514,2019-01-08,GOOG,53.80550003051758,54.22800064086914,53.0265007019043,53.81399917602539,35298000.0,0.0,0.0,0.3945007324218679,0.0,0.3945007324218679,63.56820957154381,48.50550079345703,54.22800064086914,92.76537394700021,-7.234626052999796,0.04843168890241856,-0.3182169121657793,0.10249735239178803,1642551540.0,1.0
1515,2019-01-09,GOOG,54.08250045776367,54.13150024414063,53.31999969482422,53.733001708984375,23986000.0,0.0,0.0,-0.08099746704101562,0.08099746704101562,0.0,62.685227274022154,48.50550079345703,54.22800064086914,91.34995290373631,-8.650047096263696,0.1577199475302251,-0.2230295402265784,0.03386377832140974,1618565540.0,-1.0
1516,2019-01-10,GOOG,53.382999420166016,53.557498931884766,52.885501861572266,53.51649856567383,29128000.0,0.0,0.0,-0.21650314331054688,0.21650314331054688,0.0,60.11009178929733,48.50550079345703,54.22800064086914,87.56658638414686,-12.433413615853143,0.22427636724484756,-0.1335683587322932,0.025338129197745474,1589437540.0,-1.0
1517,2019-01-11,GOOG,53.15900039672852,53.188751220703125,52.42399978637695,52.859500885009766,30416000.0,0.0,0.0,-0.6569976806640625,0.6569976806640625,0.0,52.55109462579299,48.50550079345703,54.22800064086914,76.08563053997716,-23.91436946002284,0.22145578289712375,-0.06256353040640979,0.019390997641102636,1559021540.0,-1.0
1518,2019-01-14,GOOG,52.34600067138672,52.57649993896485,52.06275177001953,52.234500885009766,22886000.0,0.0,0.0,-0.625,0.625,0.0,46.17715363702004,48.50550079345703,54.22800064086914,65.16383033612667,-34.836169663873335,0.16686466088226837,-0.01667789214867414,0.008767825600026313,1536135540.0,-1.0
1519,2019-01-15,GOOG,52.50849914550781,54.00249862670898,52.367000579833984,53.85749816894531,29272000.0,0.0,0.0,1.6229972839355469,0.0,1.6229972839355469,60.52372492405629,49.150001525878906,54.22800064086914,92.70377045104033,-7.296229548959672,0.25166211601783317,0.036990109484627345,0.029927783915644435,1565407540.0,1.0
1520,2019-01-16,GOOG,54.0,54.618751525878906,53.96699905395508,54.04850006103516,26636000.0,0.0,0.0,0.19100189208985086,0.0,0.19100189208985086,61.90266023745167,49.84999847412109,54.618751525878906,88.04191664666844,-11.958083353331567,0.33046754244724497,0.0956855960771509,0.06388399440083603,1592043540.0,1.0
1521,2019-01-17,GOOG,53.9734992980957,54.59000015258789,53.67499923706055,54.494998931884766,24854000.0,0.0,0.0,0.44649887084960227,0.0,0.44649887084960227,65.18307488746437,50.70349884033203,54.618751525878906,96.83921820803617,-3.1607817919638332,0.42406181732499704,0.16136084032672016,0.017922674987405518,1616897540.0,1.0
1522,2019-01-18,GOOG,55.0,55.417598724365234,54.54499816894531,54.91299819946289,39112000.0,0.0,0.0,0.417999267578125,0.0,0.417999267578125,68.14587800689063,50.70349884033203,55.417598724365234,89.29593056329924,-10.704069436700753,0.5259027227787456,0.2342692168171253,0.0279579516725732,1656009540.0,1.0
1523,2019-01-22,GOOG,54.400001525878906,54.57550048828125,53.17350006103516,53.5260009765625,32270000.0,0.0,0.0,-1.3869972229003906,1.3869972229003906,0.0,51.39954765246275,50.70349884033203,55.417598724365234,59.87361756568561,-40.126382434314394,0.48905575943815904,0.2852265253413321,-0.005351733821544302,1623739540.0,-1.0
1524,2019-01-23,GOOG,53.86750030517578,54.24649810791016,52.98749923706055,53.77849960327149,19340000.0,0.0,0.0,0.2524986267089915,0.0,0.2524986267089915,53.78512332297907,50.70349884033203,55.417598724365234,65.22986017658599,-34.77013982341402,0.4747561115505192,0.32313244258316953,0.0008467402311438388,1643079540.0,1.0
1525,2019-01-24,GOOG,53.82400131225586,53.973751068115234,53.03499984741211,53.69499969482422,27226000.0,0.0,0.0,-0.08349990844727273,0.08349990844727273,0.0,52.796271933329514,51.37089920043945,55.417598724365234,57.43200058822532,-42.567999411774686,0.4514813963031514,0.3488022333271659,0.0033354411057244793,1615853540.0,-1.0
1526,2019-01-25,GOOG,54.25,54.70000076293945,54.09099960327149,54.54949951171875,22382000.0,0.0,0.0,0.8544998168945312,0.0,0.8544998168945312,61.215956574101284,52.06275177001953,55.417598724365234,74.12402936825504,-25.87597063174496,0.49626636096073184,0.37829505885387915,0.03197152069947462,1638235540.0,1.0
1527,2019-01-28,GOOG,54.00550079345703,54.150001525878906,53.18999862670898,53.50400161743164,25686000.0,0.0,0.0,-1.0454978942871094,1.0454978942871094,0.0,48.90182730495423,52.06275177001953,55.417598724365234,42.96022641346383,-57.03977358653618,0.44229729770417947,0.39109550662393927,0.024303874085378707,1612549540.0,-1.0
1528,2019-01-29,GOOG,53.63399887084961,53.75749969482422,52.793251037597656,53.03099822998047,20436000.0,0.0,0.0,-0.4730033874511719,0.4730033874511719,0.0,44.25467197045046,52.06275177001953,55.417598724365234,28.861121629012583,-71.13887837098743,0.3572409545845119,0.38432459621605386,-0.01534605147034862,1592113540.0,-1.0
1529,2019-01-30,GOOG,53.42150115966797,54.54999923706055,53.34249877929688,54.45299911499024,25596000.0,0.0,0.0,1.4220008850097727,0.0,1.4220008850097727,58.07500823691988,52.06275177001953,55.417598724365234,71.24758230400053,-28.752417695999462,0.3999662155646462,0.38745292008577237,0.007484001470869472,1617709540.0,1.0
1530,2019-01-31,GOOG,55.150001525878906,55.86650085449219,54.77050018310547,55.81850051879883,30766000.0,0.0,0.0,1.3655014038085866,0.0,1.3655014038085866,67.1097786672024,52.06275177001953,55.86650085449219,98.73807828467702,-1.261921715322977,0.537811290248186,0.41752459411825515,0.024286661397467935,1648475540.0,1.0
1531,2019-02-01,GOOG,55.619998931884766,56.25,55.24449920654297,55.53749847412109,29244000.0,0.0,0.0,-0.2810020446777415,0.2810020446777415,0.0,63.84297891013263,52.06275177001953,56.25,82.98401511576407,-17.015984884235934,0.6172645470174203,0.45747258469808827,0.0113725401113558,1619231540.0,-1.0
1532,2019-02-04,GOOG,55.632999420166016,56.63999938964844,55.45100021362305,56.63999938964844,51530000.0,0.0,0.0,1.1025009155273509,0.0,1.1025009155273509,70.37210296464517,52.367000579833984,56.63999938964844,100.0,-0.0,0.7604286867844792,0.5180638051153664,0.05817730367059304,1670761540.0,1.0
1533,2019-02-05,GOOG,56.242000579833984,57.34249877929688,55.86240005493164,57.29949951171875,71044000.0,0.0,0.0,0.6595001220703125,0.0,0.6595001220703125,73.65558513889869,52.793251037597656,57.34249877929688,99.05480488160728,-0.9451951183927193,0.9165381657211498,0.5977586772365231,0.06547226000022266,1741805540.0,1.0
1534,2019-02-06,GOOG,56.97850036621094,57.34999847412109,55.63850021362305,55.76150131225586,42112000.0,0.0,0.0,-1.5379981994628906,1.5379981994628906,0.0,56.73624927218639,52.793251037597656,57.34999847412109,65.13967069728203,-34.86032930271797,0.9057119676007517,0.6593493353093689,0.03848592288251451,1699693540.0,-1.0
1535,2019-02-07,GOOG,55.20800018310547,55.242000579833984,54.29999923706055,54.93550109863281,40896000.0,0.0,0.0,-0.8260002136230469,0.8260002136230469,0.0,49.66636588246634,52.793251037597656,57.34999847412109,47.012701293569734,-52.98729870643027,0.8210166447091254,0.6916827971893202,0.007076171007419418,1658797540.0,-1.0
1536,2019-02-08,GOOG,54.34999847412109,54.945499420166016,54.32749938964844,54.75299835205078,21516000.0,0.0,0.0,-0.18250274658203125,0.18250274658203125,0.0,48.13714879028006,52.793251037597656,57.34999847412109,43.00759130833711,-56.99240869166289,0.7307449715514949,0.6994952320617552,0.02334398730677778,1637281540.0,-1.0
1537,2019-02-11,GOOG,54.84749984741211,55.29724884033203,54.64300155639648,54.7504997253418,21304000.0,0.0,0.0,-0.002498626708984375,0.002498626708984375,0.0,48.11374663714558,52.793251037597656,57.34999847412109,42.95275775120473,-57.04724224879527,0.6514924030261255,0.6898946662546294,0.032424460273297706,1615977540.0,-1.0
1538,2019-02-12,GOOG,55.34000015258789,56.26475143432617,55.29249954223633,56.06850051879883,32182000.0,0.0,0.0,1.3180007934570312,0.0,1.3180007934570312,59.96106736500048,52.793251037597656,57.34999847412109,71.87691498873203,-28.123085011267975,0.6871151843942584,0.6893387698825553,0.029667813161164514,1648159540.0,1.0
1539,2019-02-13,GOOG,56.2495002746582,56.73649978637695,55.92499923706055,56.007999420166016,20996000.0,0.0,0.0,-0.0605010986328125,0.0605010986328125,0.0,59.24457442741542,52.793251037597656,57.34999847412109,70.5491894679388,-29.450810532061194,0.7023680999980684,0.6919446359056579,0.0033949120740599525,1627163540.0,-1.0
1540,2019-02-14,GOOG,55.90250015258789,56.4114990234375,55.52225112915039,56.08349990844727,18952000.0,0.0,0.0,0.0755004882812571,0.0,0.0755004882812571,59.93394625958395,52.793251037597656,57.34999847412109,72.20608376223527,-27.793916237764734,0.7123370261032917,0.6960231139451848,0.009831221234795295,1646115540.0,1.0
1541,2019-02-15,GOOG,56.50400161743164,56.58349990844727,55.532501220703125,55.682498931884766,28996000.0,0.0,0.0,-0.4010009765625071,0.4010009765625071,0.0,54.30471351496272,52.793251037597656,57.34999847412109,63.40592570764599,-36.59407429235401,0.680040955535695,0.6928266822632869,-0.01690502238844771,1617119540.0,-1.0
1542,2019-02-19,GOOG,55.5,56.09450149536133,55.5,55.928001403808594,20928000.0,0.0,0.0,0.24550247192382812,0.0,0.24550247192382812,57.14790884435005,53.34249877929688,57.34999847412109,64.51660190644454,-35.483398093555465,0.6665722546400659,0.6875757967386428,-0.023935603619533508,1638047540.0,1.0
1543,2019-02-20,GOOG,55.9995002746582,56.170501708984375,55.26399993896485,55.68999862670898,21756000.0,0.0,0.0,-0.23800277709961648,0.23800277709961648,0.0,53.429233227293516,54.29999923706055,57.34999847412109,45.573761880283385,-54.42623811971662,0.6294376121225511,0.6759481598154246,-0.0012822948425739167,1616291540.0,-1.0
1544,2019-02-21,GOOG,55.54199981689453,55.59700012207031,54.6259994506836,54.8484992980957,28302000.0,0.0,0.0,-0.8414993286132741,0.8414993286132741,0.0,42.221021113590524,54.29999923706055,57.34999847412109,17.983613057024154,-82.01638694297586,0.5260422892109347,0.6459669856945266,-0.0015837081449553425,1587989540.0,-1.0
1545,2019-02-22,GOOG,55.04499816894531,55.5620002746582,54.77999877929688,55.51850128173828,20990000.0,0.0,0.0,0.6700019836425781,0.0,0.6700019836425781,51.556978205741935,54.29999923706055,57.34999847412109,39.950896704225904,-60.049103295774096,0.49248722534898093,0.6152710336254175,0.013981023007461069,1608979540.0,1.0
1546,2019-02-25,GOOG,55.79999923706055,55.92699813842773,55.36349868774414,55.470001220703125,28262000.0,0.0,0.0,-0.04850006103515625,0.04850006103515625,0.0,50.87043396149132,54.29999923706055,57.34999847412109,38.360730370876304,-61.639269629123696,0.45671630462984325,0.5835600878263026,0.013141459876544248,1580717540.0,-1.0
1547,2019-02-26,GOOG,55.28749847412109,55.97549819946289,54.99599838256836,55.75650024414063,29426000.0,0.0,0.0,0.2864990234375071,0.0,0.2864990234375071,54.95854129808296,54.29999923706055,57.34999847412109,47.754143325091434,-52.24585667490857,0.44634053323373735,0.5561161769077896,-0.005564626693620789,1610143540.0,1.0
1548,2019-02-27,GOOG,55.34749984741211,55.89899826049805,55.04999923706055,55.8025016784668,19368000.0,0.0,0.0,0.04600143432616477,0.0,0.04600143432616477,55.642364580121104,54.29999923706055,56.73649978637695,61.66641094449159,-38.33358905550841,0.4367944958954695,0.5322518407053256,-0.0036690784142743293,1629511540.0,1.0
1549,2019-02-28,GOOG,55.56499862670898,56.38249969482422,55.55049896240234,55.99599838256836,30850000.0,0.0,0.0,0.1934967041015625,0.0,0.1934967041015625,58.686562426647725,54.32749938964844,56.73649978637695,69.26105098138574,-30.738949018614264,0.43977332627506627,0.5137561378192738,-0.0015602008794343147,1660361540.0,1.0
1550,2019-03-01,GOOG,56.244998931884766,57.14849853515625,56.23749923706055,57.04949951171875,29006000.0,0.0,0.0,1.0535011291503906,0.0,1.0535011291503906,71.13240756206801,54.6259994506836,57.14849853515625,96.07535939073703,-3.9246406092629615,0.521135482017236,0.5152320066588663,0.024549914354709657,1689367540.0,1.0
1551,2019-03-04,GOOG,57.3494987487793,57.91400146484375,56.53450012207031,57.38999938964844,28920000.0,0.0,0.0,0.3404998779296875,0.0,0.3404998779296875,74.04804188020692,54.6259994506836,57.91400146484375,84.06320698896658,-15.936793011033412,0.6061042782652635,0.5334064609801458,0.026140715726349573,1718287540.0,1.0
1552,2019-03-05,GOOG,57.50299835205078,58.480499267578125,57.30974960327149,58.10150146484375,28864000.0,0.0,0.0,0.7115020751953125,0.0,0.7115020751953125,79.13019736199895,54.6259994506836,58.480499267578125,90.1673934170861,-9.832606582913893,0.7225261015148803,0.5712303890870927,0.043302260685964766,1747151540.0,1.0
1553,2019-03-06,GOOG,58.1245002746582,58.378299713134766,57.77450180053711,57.89300155639648,21986000.0,0.0,0.0,-0.20849990844727273,0.20849990844727273,0.0,74.21599608087817,54.6259994506836,58.480499267578125,84.7581336336661,-15.241866366333886,0.7888733936831471,0.6147589900063036,0.055507485113753585,1725165540.0,-1.0
1554,2019-03-07,GOOG,57.7859992980957,57.83774948120117,56.74549865722656,57.165000915527344,23332000.0,0.0,0.0,-0.7280006408691335,0.7280006408691335,0.0,59.36337570648828,54.6259994506836,58.480499267578125,65.87110093286641,-34.12889906713359,0.7737907550142182,0.6465653430078866,0.02965677379210252,1701833540.0,-1.0
1555,2019-03-08,GOOG,56.33649826049805,57.354000091552734,56.165000915527344,57.11600112915039,24248000.0,0.0,0.0,-0.048999786376953125,0.048999786376953125,0.0,58.45485160199786,54.6259994506836,58.480499267578125,64.59986500850124,-35.40013499149877,0.7492469297362447,0.6671016603535583,0.029673695190634453,1677585540.0,-1.0
1556,2019-03-11,GOOG,57.22249984741211,58.80950164794922,57.22249984741211,58.78799819946289,34384000.0,0.0,0.0,1.6719970703125,0.0,1.6719970703125,74.07591363270832,54.6259994506836,58.80950164794922,99.48599409125724,-0.5140059087427518,0.8548576941190476,0.7046528671066562,0.05437030556165223,1711969540.0,1.0
1557,2019-03-12,GOOG,58.91299819946289,60.0,58.91299819946289,59.65999984741211,40262000.0,0.0,0.0,0.8720016479492188,0.0,0.8720016479492188,78.85933453155828,54.6259994506836,60.0,93.67323934064092,-6.326760659359076,0.9974205874847826,0.7632064111822816,0.06912769235996197,1752231540.0,1.0
1558,2019-03-13,GOOG,60.0322494506836,60.04650115966797,59.59700012207031,59.66600036621094,28718000.0,0.0,0.0,0.006000518798828125,0.0,0.006000518798828125,78.8902615029146,54.77999877929688,60.04650115966797,92.77507601866458,-7.224923981335419,1.0982272195417693,0.8302105728541792,0.06554043306039259,1780949540.0,1.0
1559,2019-03-14,GOOG,59.72549819946289,59.89400100708008,59.2239990234375,59.27750015258789,23456000.0,0.0,0.0,-0.3885002136230469,0.3885002136230469,0.0,71.11798004885233,54.99599838256836,60.04650115966797,84.77377320596786,-15.226226794032142,1.1336998946302543,0.8909084372093943,0.03905381572035482,1757493540.0,-1.0
1560,2019-03-15,GOOG,59.66899871826172,59.82849884033203,59.13050079345703,59.22299957275391,49236000.0,0.0,0.0,-0.05450057983397727,0.05450057983397727,0.0,70.00165366140456,54.99599838256836,60.04650115966797,83.69466123950983,-16.305338760490176,1.1442245950161904,0.9415716687707537,0.031939365788459906,1708257540.0,-1.0
1561,2019-03-18,GOOG,59.165000915527344,59.5,58.87105178833008,59.2130012512207,25852000.0,0.0,0.0,-0.00999832153321023,0.00999832153321023,0.0,69.76983235970954,55.04999923706055,60.04650115966797,83.31833107726887,-16.681668922731127,1.1386332594695787,0.9809839869105188,0.019130310893075597,1682405540.0,-1.0
1562,2019-03-19,GOOG,59.44049835205078,60.0,59.29349899291992,59.942501068115234,30414000.0,0.0,0.0,0.7294998168945312,0.0,0.7294998168945312,76.36049894172831,55.55049896240234,60.04650115966797,97.68683183437977,-2.3131681656202234,1.179470423457758,1.0206812742199667,0.03540150720501578,1712819540.0,1.0
1563,2019-03-20,GOOG,59.86750030517578,61.35699844360352,59.80849838256836,61.19850158691406,44548000.0,0.0,0.0,1.2560005187988281,0.0,1.2560005187988281,83.5047903877101,56.165000915527344,61.35699844360352,96.94728559032676,-3.0527144096732455,1.2982178677007425,1.076188592916122,0.07055891903766454,1757367540.0,1.0
1564,2019-03-21,GOOG,60.79999923706055,61.589500427246094,60.657501220703125,61.57699966430664,24080000.0,0.0,0.0,0.3784980773925781,0.0,0.3784980773925781,85.0733628898148,56.165000915527344,61.589500427246094,99.76954992967651,-0.23045007032348805,1.406652687823268,1.142281411897551,0.07810418178732559,1781447540.0,1.0
1565,2019-03-22,GOOG,61.31600189208984,61.5,60.14125061035156,60.275001525878906,34284000.0,0.0,0.0,-1.3019981384277344,1.3019981384277344,0.0,61.762193407776444,56.165000915527344,61.589500427246094,75.76736990154713,-24.232630098452884,1.371715414052396,1.1881682123285202,0.025294335101711418,1747163540.0,-1.0
1566,2019-03-25,GOOG,59.84650039672852,60.31990051269531,59.35200119018555,59.650001525878906,29936000.0,0.0,0.0,-0.625,0.625,0.0,53.62368726246435,56.165000915527344,61.589500427246094,64.24556962025316,-35.754430379746836,1.2788532717640848,1.2063052242156331,-0.00016758836001973254,1717227540.0,-1.0
1567,2019-03-26,GOOG,59.92649841308594,60.14149856567383,58.83599853515625,59.23099899291992,38024000.0,0.0,0.0,-0.4190025329589844,0.4190025329589844,0.0,48.66337778749983,56.165000915527344,61.589500427246094,56.52130801687763,-43.47869198312237,1.15809950213675,1.1966640797998567,-0.007290607223898293,1679203540.0,-1.0
1568,2019-03-27,GOOG,59.275001525878906,59.37794876098633,57.96849822998047,58.6510009765625,28004000.0,0.0,0.0,-0.5799980163574219,0.5799980163574219,0.0,42.39915660298097,56.165000915527344,61.589500427246094,45.82911392405064,-54.17088607594936,1.0040264847177482,1.158136560783435,-0.010568920322427622,1651199540.0,-1.0
1569,2019-03-28,GOOG,58.57699966430664,58.578250885009766,57.97154998779297,58.42449951171875,19234000.0,0.0,0.0,-0.22650146484375,0.22650146484375,0.0,40.07466922005661,57.22249984741211,61.589500427246094,27.524605099831145,-72.47539490016885,0.8538036164991567,1.0972699719265795,-0.013482938500172126,1631965540.0,-1.0
1570,2019-03-29,GOOG,58.744998931884766,58.949501037597656,58.14400100708008,58.66550064086914,25398000.0,0.0,0.0,0.24100112915039062,0.0,0.24100112915039062,43.853754274631356,57.96849822998047,61.589500427246094,19.24888119137316,-80.75111880862683,0.7456028426817767,1.026936546077619,-0.009246290489966946,1657363540.0,1.0
1571,2019-04-01,GOOG,59.20500183105469,59.83300018310547,59.09999847412109,59.72150039672852,25050000.0,0.0,0.0,1.055999755859382,0.0,1.055999755859382,57.42746015199534,57.96849822998047,61.589500427246094,48.41207133405833,-51.58792866594166,0.7365725549141402,0.9688637478449232,-0.003686877715288861,1682413540.0,1.0
1572,2019-04-02,GOOG,59.76599884033203,60.067501068115234,59.28549957275391,60.02450180053711,16558000.0,0.0,0.0,0.30300140380858664,0.0,0.30300140380858664,60.582437240298965,57.96849822998047,61.589500427246094,56.77995920878528,-43.22004079121472,0.7452746060562561,0.9241459194871898,-0.019183472731103435,1698971540.0,1.0
1573,2019-04-03,GOOG,60.374000549316406,60.81499862670898,60.025001525878906,60.29600143432617,20286000.0,0.0,0.0,0.2714996337890625,0.0,0.2714996337890625,63.38765577808559,57.96849822998047,61.589500427246094,64.27787329439626,-35.722126705603735,0.7652573849336193,0.8923682125764758,-0.020803193350828475,1719257540.0,1.0
1574,2019-04-04,GOOG,60.297000885009766,60.78350067138672,60.20650100708008,60.75,19000000.0,0.0,0.0,0.4539985656738281,0.0,0.4539985656738281,67.80801736840218,57.96849822998047,61.589500427246094,76.8157990105602,-23.184200989439795,0.8084089361883358,0.8755763572988478,0.007880521975883292,1738257540.0,1.0
1575,2019-04-05,GOOG,60.7495002746582,60.81100082397461,60.25149917602539,60.35749816894531,18144000.0,0.0,0.0,-0.3925018310546875,0.3925018310546875,0.0,60.51917778992257,57.96849822998047,61.589500427246094,65.97620793405981,-34.02379206594018,0.8016938067887907,0.8607998471968364,0.011860798406844397,1720113540.0,-1.0
1576,2019-04-08,GOOG,60.39450073242188,60.43450164794922,59.99300003051758,60.19200134277344,17204000.0,0.0,0.0,-0.165496826171875,0.165496826171875,0.0,57.51152223922365,57.96849822998047,61.589500427246094,61.40573773945876,-38.59426226054124,0.7740945277436708,0.8434587833062034,0.016224652060458977,1702909540.0,-1.0
1577,2019-04-09,GOOG,59.79999923706055,60.11449813842773,59.65399932861328,59.86249923706055,17528000.0,0.0,0.0,-0.3295021057128906,0.3295021057128906,0.0,51.61827091181873,57.96849822998047,61.589500427246094,52.305988891979126,-47.69401110802087,0.717364502648671,0.818239927174697,0.02065605429278472,1685381540.0,-1.0
1578,2019-04-10,GOOG,60.03400039672852,60.18925094604492,59.82175064086914,60.108001708984375,14492000.0,0.0,0.0,0.24550247192382812,0.0,0.24550247192382812,55.535335240590285,57.96849822998047,61.5,60.58338968330953,-39.416610316690466,0.6843270505180357,0.7914573518433649,0.028815004173513792,1699873540.0,1.0
1579,2019-04-11,GOOG,60.198001861572266,60.39799880981445,60.00650024414063,60.23099899291992,14204000.0,0.0,0.0,0.12299728393554688,0.0,0.12299728393554688,57.52333920308124,57.96849822998047,60.81499862670898,79.48359204656188,-20.51640795343812,0.6604561571054859,0.7652571128957891,0.0266851613801824,1714077540.0,1.0
1580,2019-04-12,GOOG,60.5,60.91749954223633,60.40549850463867,60.89350128173828,18668000.0,0.0,0.0,0.6625022888183594,0.0,0.6625022888183594,66.75980047868141,57.96849822998047,60.91749954223633,99.18622414990757,-0.8137758500924245,0.687076509726694,0.7496209922619702,0.019624438053702287,1732745540.0,1.0
1581,2019-04-15,GOOG,60.900001525878906,61.209999084472656,60.45550155639648,61.05500030517578,23748000.0,0.0,0.0,0.1614990234375,0.0,0.1614990234375,68.67567636791982,57.96849822998047,61.209999084472656,95.21830206886813,-4.781697931131876,0.7129860925989888,0.742294012329374,0.01716796431002532,1756493540.0,1.0
1582,2019-04-16,GOOG,61.25,61.54100036621094,61.00600051879883,61.35649871826172,17126000.0,0.0,0.0,0.3014984130859375,0.0,0.3014984130859375,72.13524546084027,57.97154998779297,61.54100036621094,94.83109082942364,-5.168909170576354,0.7492115811627755,0.7436775260960544,0.017588185927895017,1773619540.0,1.0
1583,2019-04-17,GOOG,61.650001525878906,62.02799987792969,61.39099884033203,61.81700134277344,24438000.0,0.0,0.0,0.46050262451171875,0.0,0.46050262451171875,76.6752150206975,58.14400100708008,62.02799987792969,94.56749236618354,-5.432507633816456,0.8057906025779218,0.756100141392428,0.017563808111496826,1798057540.0,1.0
1584,2019-04-18,GOOG,61.95899963378906,62.09999847412109,61.730499267578125,61.81850051879883,26636000.0,0.0,0.0,0.001499176025390625,0.0,0.001499176025390625,76.68948154162119,59.09999847412109,62.09999847412109,90.61673482259138,-9.383265177408617,0.8410556892091705,0.7730912509557766,0.024205813596913206,1824693540.0,1.0
1585,2019-04-22,GOOG,61.79949951171875,62.454498291015625,61.41550064086914,62.44200134277344,16146000.0,0.0,0.0,0.6235008239746094,0.0,0.6235008239746094,81.97895752113084,59.28549957275391,62.454498291015625,99.60564994330315,-0.39435005669684975,0.9088383078360778,0.8002406623318369,0.03738038194123172,1840839540.0,1.0
1586,2019-04-23,GOOG,62.53450012207031,63.45000076293945,62.31900024414063,63.227500915527344,26398000.0,0.0,0.0,0.7854995727539062,0.0,0.7854995727539062,86.4488238450493,59.65399932861328,63.45000076293945,94.13857314699341,-5.861426853006585,1.014248150936261,0.8430421600527217,0.056212181605400424,1867237540.0,1.0
1587,2019-04-24,GOOG,63.20600128173828,63.4005012512207,62.75,62.79999923706055,20376000.0,0.0,0.0,-0.4275016784667969,0.4275016784667969,0.0,74.79828428492806,59.65399932861328,63.45000076293945,82.87667860182756,-17.123321398172443,1.0511731288614286,0.8846683538144631,0.044786009375417324,1846861540.0,-1.0
1588,2019-04-25,GOOG,63.23849868774414,63.370399475097656,62.60150146484375,63.17250061035156,22146000.0,0.0,0.0,0.3725013732910156,0.0,0.3725013732910156,77.80553472306576,59.65399932861328,63.45000076293945,92.68967208287819,-7.310327917121814,1.0978389831808713,0.9273024796877447,0.048837005306477055,1869007540.0,1.0
1589,2019-04-26,GOOG,63.45000076293945,63.65349960327149,63.01599884033203,63.60900115966797,24828000.0,0.0,0.0,0.43650054931640625,0.0,0.43650054931640625,80.88893068545485,59.65399932861328,63.65349960327149,98.88739991129704,-1.1126000887029688,1.156710121032674,0.9731840079567305,0.04459424767457176,1893835540.0,1.0
1590,2019-04-29,GOOG,63.70000076293945,64.4635009765625,63.31475067138672,64.37899780273438,49988000.0,0.0,0.0,0.7699966430664062,0.0,0.7699966430664062,85.10174230140156,59.65399932861328,64.4635009765625,98.24299522042669,-1.7570047795733124,1.2510765837989837,1.0287625231251813,0.05444267432550998,1943823540.0,1.0
1591,2019-04-30,GOOG,59.25,59.64049911499024,58.75,59.42399978637695,124140000.0,0.0,0.0,-4.954998016357422,4.954998016357422,0.0,32.274906222755675,58.75,64.4635009765625,11.796616280311932,-88.20338371968806,0.9154826421110442,1.006106546922354,-0.031496238740063354,1819683540.0,-1.0
1592,2019-05-01,GOOG,59.40250015258789,59.40250015258789,58.35900115966797,58.40399932861328,52784000.0,0.0,0.0,-1.0200004577636719,1.0200004577636719,0.0,28.12770393346223,58.35900115966797,64.4635009765625,0.7371311376040613,-99.26286886239593,0.5607525072107293,0.9170357389800291,-0.05521138101208045,1766899540.0,-1.0
1593,2019-05-02,GOOG,58.38800048828125,58.70949935913086,57.750099182128906,58.13050079345703,38896000.0,0.0,0.0,-0.27349853515625,0.27349853515625,0.0,27.052239627561903,57.750099182128906,64.4635009765625,5.666301868652259,-94.33369813134775,0.25462214792068494,0.7845530207681602,-0.05965851151986912,1728003540.0,-1.0
1594,2019-05-03,GOOG,58.682498931884766,59.34000015258789,58.45000076293945,59.27000045776367,39614000.0,0.0,0.0,1.1394996643066406,0.0,1.1394996643066406,38.37882048395957,57.750099182128906,64.4635009765625,22.639807986689988,-77.36019201331001,0.1027750060521413,0.6481974178249565,-0.05079915468431517,1767617540.0,1.0
1595,2019-05-06,GOOG,58.3129997253418,59.54249954223633,58.3129997253418,59.46950149536133,31278000.0,0.0,0.0,0.19950103759765625,0.0,0.19950103759765625,40.25287718626019,57.750099182128906,64.4635009765625,25.61149125109809,-74.38850874890191,-0.0014501648462186267,0.5182679012907215,-0.0594361530307318,1798895540.0,1.0
1596,2019-05-07,GOOG,59.02349853515625,59.52199935913086,58.05199813842773,58.70500183105469,31028000.0,0.0,0.0,-0.7644996643066406,0.7644996643066406,0.0,35.48158726578461,57.750099182128906,64.4635009765625,14.223826878908651,-85.77617312109135,-0.1440772643853947,0.38579886815549824,-0.06520696585596852,1767867540.0,-1.0
1597,2019-05-08,GOOG,58.60049819946289,59.02119827270508,58.2869987487793,58.3134994506836,26186000.0,0.0,0.0,-0.39150238037108664,0.39150238037108664,0.0,33.159133553681016,57.750099182128906,64.4635009765625,8.392172639239872,-91.60782736076013,-0.2854111959128076,0.2515568553418371,-0.07691639736787237,1741681540.0,-1.0
1598,2019-05-09,GOOG,57.95149993896485,58.483001708984375,57.54249954223633,58.11899948120117,23714000.0,0.0,0.0,-0.19449996948242898,0.19449996948242898,0.0,31.959956674425996,57.54249954223633,64.4635009765625,8.329718530407613,-91.67028146959238,-0.4084060264880094,0.11956427897586774,-0.08630856605790871,1717967540.0,-1.0
1599,2019-05-10,GOOG,58.179500579833984,58.630001068115234,57.125,58.2135009765625,26290000.0,0.0,0.0,0.09450149536132812,0.0,0.09450149536132812,33.312012836573686,57.125,64.4635009765625,14.832742818171232,-85.16725718182877,-0.4925767171777835,-0.0028639202548625406,-0.09576876056790695,1744257540.0,1.0
1600,2019-05-13,GOOG,57.09799957275391,57.39699935913086,56.105499267578125,56.60150146484375,37212000.0,0.0,0.0,-1.61199951171875,1.61199951171875,0.0,23.946271108484595,56.105499267578125,64.4635009765625,5.934459151072569,-94.06554084892743,-0.6815015587706625,-0.13859144795802258,-0.047497615974686824,1707045540.0,-1.0
1601,2019-05-14,GOOG,56.86050033569336,57.02099990844727,55.977500915527344,56.02199935913086,36732000.0,0.0,0.0,-0.5795021057128906,0.5795021057128906,0.0,21.445285700495646,55.977500915527344,64.4635009765625,0.5243747735501139,-99.47562522644988,-0.8679812857305507,-0.28446941551252825,-0.040784877694418964,1670313540.0,-1.0
1602,2019-05-15,GOOG,55.89350128173828,58.56650161743164,55.83330154418945,58.21049880981445,45786000.0,0.0,0.0,2.1884994506835938,0.0,2.1884994506835938,46.0144398453828,55.83330154418945,64.4635009765625,27.54510233805039,-72.4548976619496,-0.8296109585280007,-0.3934977241156228,0.0013761797208948767,1716099540.0,1.0
1603,2019-05-16,GOOG,58.22549819946289,59.40800094604492,58.141998291015625,58.94900131225586,30628000.0,0.0,0.0,0.7385025024414062,0.0,0.7385025024414062,51.875036114690964,55.83330154418945,64.4635009765625,36.102291638580155,-63.897708361419845,-0.7311825998864805,-0.4610346992697944,-0.005415878910555394,1746727540.0,1.0
1604,2019-05-17,GOOG,58.42350006103516,59.00749969482422,58.0004997253418,58.1150016784668,24172000.0,0.0,0.0,-0.8339996337890625,0.8339996337890625,0.0,45.446314012954396,55.83330154418945,59.64049911499024,59.93122478793297,-40.06877521206704,-0.7122636845592254,-0.5112804963276807,-0.022776377518486268,1722555540.0,-1.0
1605,2019-05-20,GOOG,57.22499847412109,57.33985137939453,56.57215118408203,56.942501068115234,27066000.0,0.0,0.0,-1.1725006103515625,1.1725006103515625,0.0,37.8394423051798,55.83330154418945,59.54249954223633,29.90402573574784,-70.09597426425216,-0.7828570197062632,-0.5655958010033972,-0.030023008397337292,1695489540.0,-1.0
1606,2019-05-21,GOOG,57.42449951171875,57.635398864746094,56.89699935913086,57.48149871826172,23196000.0,0.0,0.0,0.5389976501464844,0.0,0.5389976501464844,42.908214287662545,55.83330154418945,59.54249954223633,44.435405576627204,-55.564594423372796,-0.7862467772062871,-0.6097259962439753,-0.014267720858109567,1718685540.0,1.0
1607,2019-05-22,GOOG,57.337501525878906,57.92599868774414,57.29449844360352,57.57099914550781,18290000.0,0.0,0.0,0.08950042724609375,0.0,0.08950042724609375,43.78645779683498,55.83330154418945,59.54249954223633,46.84833762536715,-53.15166237463285,-0.7728028576643879,-0.6423413685280579,-0.009428936158314527,1736975540.0,1.0
1608,2019-05-23,GOOG,57.025001525878906,57.29864883422852,56.46120071411133,57.03850173950195,23978000.0,0.0,0.0,-0.5324974060058594,0.5324974060058594,0.0,39.60409493654517,55.83330154418945,59.54249954223633,32.49220440502538,-67.50779559497462,-0.7959414276458219,-0.6730613803516108,-0.020184308061692025,1712997540.0,-1.0
1609,2019-05-24,GOOG,57.36800003051758,57.48825073242188,56.58300018310547,56.67350006103516,22240000.0,0.0,0.0,-0.36500167846678977,0.36500167846678977,0.0,36.82234188128539,55.83330154418945,59.52199935913086,22.77764563533531,-77.2223543646647,-0.8341163223221244,-0.7052723687457135,0.0012720262595178333,1690757540.0,-1.0
1610,2019-05-28,GOOG,56.70000076293945,57.579349517822266,56.65599822998047,56.70750045776367,27300000.0,0.0,0.0,0.03400039672850852,0.0,0.03400039672850852,37.2957248862406,55.83330154418945,59.40800094604492,24.455172737614266,-75.54482726238574,-0.8518075463628492,-0.7345794042691407,0.012236284075446635,1718057540.0,1.0
1611,2019-05-29,GOOG,56.3759994506836,56.45500183105469,55.4109992980957,55.823001861572266,30764000.0,0.0,0.0,-0.8844985961914062,0.8844985961914062,0.0,30.447708098491916,55.4109992980957,59.40800094604492,10.307790683247598,-89.6922093167524,-0.9265192760469176,-0.7729673786246962,-0.041014885580050175,1687293540.0,-1.0
1612,2019-05-30,GOOG,55.777000427246094,56.15650177001953,55.60599899291992,55.897499084472656,19038000.0,0.0,0.0,0.07449722290039062,0.0,0.07449722290039062,31.667053524880046,55.4109992980957,59.40800094604492,12.171618358640568,-87.82838164135943,-0.9685526843595156,-0.8120844397716602,-0.05176512171290637,1706331540.0,1.0
1613,2019-05-31,GOOG,55.06449890136719,55.47999954223633,55.00899887084961,55.18149948120117,30156000.0,0.0,0.0,-0.7159996032714844,0.7159996032714844,0.0,26.51254430954387,55.00899887084961,59.40800094604492,3.9213577853086963,-96.0786422146913,-1.0475639819097324,-0.8591803481992748,-0.050477537856676524,1676175540.0,-1.0
1614,2019-06-03,GOOG,53.275001525878906,53.275001525878906,51.25,51.811500549316406,102612000.0,0.0,0.0,-3.3699989318847656,3.3699989318847656,0.0,14.072593007922094,51.25,59.40800094604492,6.8828203505986005,-93.11717964940141,-1.3663611927115582,-0.9606165171017317,-0.09010845014800228,1573563540.0,-1.0
1615,2019-06-04,GOOG,52.14500045776367,52.8025016784668,51.68450164794922,52.65250015258789,56670000.0,0.0,0.0,0.8409996032714844,0.0,0.8409996032714844,24.30023958584971,51.25,59.40800094604492,17.19171353207352,-82.80828646792648,-1.5334717320507494,-1.0751875600915353,-0.0840096148039311,1630233540.0,1.0
1616,2019-06-05,GOOG,52.57699966430664,52.6775016784668,51.52450180053711,52.11100006103516,43368000.0,0.0,0.0,-0.5415000915527273,0.5415000915527273,0.0,22.32597610694117,51.25,59.40800094604492,10.554056891260654,-89.44594310873934,-1.6901199199526076,-1.1981740320637497,-0.09483940118309875,1586865540.0,-1.0
1617,2019-06-06,GOOG,52.2495002746582,52.3745002746582,51.685001373291016,52.21699905395508,34064000.0,0.0,0.0,0.10599899291991477,0.0,0.10599899291991477,23.725641521279925,51.25,59.00749969482422,12.465344402143606,-87.53465559785639,-1.7851335957117058,-1.315565944793341,-0.08453066855730096,1620929540.0,1.0
1618,2019-06-07,GOOG,52.53150177001953,53.54600143432617,52.41999816894531,53.30199813842773,36048000.0,0.0,0.0,1.0849990844726491,0.0,1.0849990844726491,37.11020331508643,51.25,57.92599868774414,30.736946401664284,-69.26305359833572,-1.752678473448654,-1.4029884505244037,-0.05948991890348154,1656977540.0,1.0
1619,2019-06-10,GOOG,53.64899826049805,54.632999420166016,53.6161003112793,54.01900100708008,29284000.0,0.0,0.0,0.7170028686523509,0.0,0.7170028686523509,44.53197702430378,51.25,57.92599868774414,41.47695553271206,-58.52304446728793,-1.6500803172138987,-1.452406823862303,-0.047409944521995206,1686261540.0,1.0
1620,2019-06-11,GOOG,54.69900131225586,55.0994987487793,53.880149841308594,53.93600082397461,28734000.0,0.0,0.0,-0.08300018310546875,0.08300018310546875,0.0,43.840921009990765,51.25,57.92599868774414,40.23369310880175,-59.76630689119825,-1.5575139095031858,-1.4734282409904798,-0.03380328851316472,1657527540.0,-1.0
1621,2019-06-12,GOOG,53.900001525878906,54.04650115966797,53.37699890136719,53.85150146484375,21220000.0,0.0,0.0,-0.08449935913085938,0.08449935913085938,0.0,43.056050989315835,51.25,57.579349517822266,41.10219316405909,-58.89780683594091,-1.4739816140536277,-1.4735389156031096,-0.03660266833292458,1636307540.0,-1.0
1622,2019-06-13,GOOG,54.18199920654297,54.70849990844727,54.00749969482422,54.4384994506836,21154000.0,0.0,0.0,0.5869979858398509,0.0,0.5869979858398509,50.202016722525556,51.25,57.579349517822266,50.3764161183607,-49.623583881639306,-1.3449125220070215,-1.447813636883892,-0.013464658218841796,1657461540.0,1.0
1623,2019-06-14,GOOG,54.32099914550781,54.634498596191406,54.00859832763672,54.26750183105469,22230000.0,0.0,0.0,-0.17099761962891336,0.17099761962891336,0.0,48.170161271623705,51.25,57.579349517822266,47.674754294386275,-52.325245705613725,-1.2421042113197416,-1.406671751771062,0.04740262790498706,1635231540.0,-1.0
1624,2019-06-17,GOOG,54.31399917602539,54.95899963378906,54.31399917602539,54.625,18832000.0,0.0,0.0,0.3574981689453125,0.0,0.3574981689453125,52.78042124892965,51.25,56.45500183105469,64.84147574864781,-35.15852425135218,-1.1188829833574943,-1.3491139980883486,0.03746260560649106,1654063540.0,1.0
1625,2019-06-18,GOOG,55.484500885009766,55.81949996948242,54.949501037597656,55.18000030517578,27734000.0,0.0,0.0,0.5550003051757812,0.0,0.5550003051757812,59.27013880368847,51.25,56.15650177001953,80.09780673451458,-19.90219326548542,-0.9653178033917698,-1.272354759149033,0.05889352038045792,1681797540.0,1.0
1626,2019-06-19,GOOG,55.27999877929688,55.34999847412109,54.67399978637695,55.11650085449219,26776000.0,0.0,0.0,-0.06349945068359375,0.06349945068359375,0.0,58.21391691745498,51.25,55.81949996948242,84.61540388039741,-15.384596119602595,-0.8390679142607098,-1.1856973901713683,0.05552792870270262,1655021540.0,-1.0
1627,2019-06-20,GOOG,55.9995002746582,56.00600051879883,55.23699951171875,55.57099914550781,25240000.0,0.0,0.0,0.454498291015625,0.0,0.454498291015625,63.57474641850281,51.25,56.00600051879883,90.8536306593827,-9.146369340617296,-0.6943358820199066,-1.0874250885410761,0.04256877952656457,1680261540.0,1.0
1628,2019-06-21,GOOG,55.46200180053711,56.20550155639648,55.40399932861328,56.09400177001953,38952000.0,0.0,0.0,0.5230026245117188,0.0,0.5230026245117188,68.87638258279628,51.52450180053711,56.20550155639648,97.6180347747855,-2.381965225214505,-0.5313081729582834,-0.9762017054245176,0.038412423855589184,1719213540.0,1.0
1629,2019-06-24,GOOG,55.980499267578125,56.09999847412109,55.55049896240234,55.7760009765625,27912000.0,0.0,0.0,-0.31800079345703125,0.31800079345703125,0.0,62.49486576813017,51.52450180053711,56.20550155639648,90.82459726052417,-9.175402739475828,-0.4228927015423736,-0.8655399046480887,0.03411450838917229,1691301540.0,-1.0
1630,2019-06-25,GOOG,55.632999420166016,55.71749877929688,54.18999862670898,54.317501068115234,30938000.0,0.0,0.0,-1.4584999084472656,1.4584999084472656,0.0,41.933854169766086,51.685001373291016,56.20550155639648,58.23469944017926,-41.76530055982074,-0.4494800861320698,-0.782327940944885,0.008653418950179237,1660363540.0,-1.0
1631,2019-06-26,GOOG,54.32500076293945,54.64849853515625,53.61199951171875,53.9900016784668,36218000.0,0.0,0.0,-0.3274993896484375,0.3274993896484375,0.0,38.64010563744648,52.41999816894531,56.20550155639648,41.47410129722776,-58.52589870277224,-0.49131368535655184,-0.7241250898272185,-0.008238613788815075,1624145540.0,-1.0
1632,2019-06-27,GOOG,54.20000076293945,54.35499954223633,53.76449966430664,53.80049896240234,20086000.0,0.0,0.0,-0.18950271606446023,0.18950271606446023,0.0,36.714715779821034,53.37699890136719,56.20550155639648,14.972588421726748,-85.02741157827325,-0.5336073067101452,-0.6860215332038039,-0.008605571527987799,1604059540.0,-1.0
1633,2019-06-28,GOOG,53.81949996948242,54.04999923706055,53.66849899291992,54.045501708984375,33864000.0,0.0,0.0,0.24500274658203836,0.0,0.24500274658203836,41.093438722392776,53.37699890136719,56.20550155639648,23.634512289692903,-76.36548771030711,-0.541117961243188,-0.6570408188116807,-0.010608664366418719,1637923540.0,1.0
1634,2019-07-01,GOOG,54.900001525878906,55.37900161743164,54.685150146484375,54.897499084472656,28726000.0,0.0,0.0,0.8519973754882812,0.0,0.8519973754882812,53.893731829796494,53.37699890136719,56.20550155639648,53.75636400418099,-46.24363599581901,-0.47287018813191395,-0.6202066926757275,-0.005119630647711815,1666649540.0,1.0
1635,2019-07-02,GOOG,55.11199951171875,55.5885009765625,54.90850067138672,55.5625,19832000.0,0.0,0.0,0.6650009155273438,0.0,0.6650009155273438,61.43989721516171,53.61199951171875,56.20550155639648,75.2072084263046,-24.792791573695393,-0.3609623704883447,-0.568357828238251,0.00809193505743866,1686481540.0,1.0
1636,2019-07-03,GOOG,55.87049865722656,56.3380012512207,55.69300079345703,56.07899856567383,15340000.0,0.0,0.0,0.5164985656738281,0.0,0.5164985656738281,66.37229762900171,53.61199951171875,56.3380012512207,90.49880703325613,-9.501192966743865,-0.22796960931226806,-0.5002801844530544,0.009141448380941775,1701821540.0,1.0
1637,2019-07-05,GOOG,55.88999938964844,56.64400100708008,55.80699920654297,56.579498291015625,25286000.0,0.0,0.0,0.5004997253417969,0.0,0.5004997253417969,70.580003634253,53.61199951171875,56.64400100708008,97.87260276213135,-2.127397237868652,-0.08124915327169902,-0.41647397821678334,0.008655052334946456,1727107540.0,1.0
1638,2019-07-08,GOOG,56.25849914550781,56.29899978637695,55.56050109863281,55.817501068115234,24728000.0,0.0,0.0,-0.7619972229003906,0.7619972229003906,0.0,57.86151646106943,53.61199951171875,56.64400100708008,72.74078062859436,-27.259219371405635,-0.02615741599809951,-0.3384106657730466,0.0007440492474564131,1702379540.0,-1.0
1639,2019-07-09,GOOG,55.59000015258789,56.401248931884766,55.35850143432617,56.24150085449219,26608000.0,0.0,0.0,0.4239997863769531,0.0,0.4239997863769531,62.23117417913823,53.61199951171875,56.64400100708008,86.7249355515267,-13.275064448473303,0.05112706101837006,-0.2605031204147633,0.035421360492343235,1728987540.0,1.0
1640,2019-07-10,GOOG,56.56100082397461,57.102500915527344,56.54850006103516,57.02399826049805,24190000.0,0.0,0.0,0.7824974060058594,0.0,0.7824974060058594,69.06267921712796,53.61199951171875,57.102500915527344,97.75096337323801,-2.249036626761995,0.17351637812271292,-0.17369922070726804,0.05619552672178041,1753177540.0,1.0
1641,2019-07-11,GOOG,57.16249847412109,57.65349960327149,56.979000091552734,57.21049880981445,23910000.0,0.0,0.0,0.18650054931640625,0.0,0.18650054931640625,70.52865881184749,53.61199951171875,57.65349960327149,89.0387038618911,-10.961296138108901,0.2823055863052346,-0.0824982593047675,0.0633823089595349,1777087540.0,1.0
1642,2019-07-12,GOOG,57.199501037597656,57.367000579833984,56.93899917602539,57.244998931884766,17280000.0,0.0,0.0,0.0345001220703125,0.0,0.0345001220703125,70.82375462705808,53.61199951171875,57.65349960327149,89.89235031218865,-10.107649687811344,0.3670742852309914,0.007416249602384309,0.059200065162287485,1794367540.0,1.0
1643,2019-07-15,GOOG,57.34299850463867,57.54100036621094,56.970001220703125,57.516998291015625,18076000.0,0.0,0.0,0.2719993591308594,0.0,0.2719993591308594,73.25947914911372,53.61199951171875,57.65349960327149,96.62250874270245,-3.377491257297554,0.45100327987293554,0.0961336556564946,0.047716184712025767,1812443540.0,1.0
1644,2019-07-16,GOOG,57.29999923706055,57.92900085449219,57.25,57.67900085449219,24776000.0,0.0,0.0,0.1620025634765625,0.0,0.1620025634765625,74.71039657749398,53.61199951171875,57.92900085449219,94.20894319575568,-5.791056804244325,0.5245432576062328,0.18181557604644227,0.03809225384912818,1837219540.0,1.0
1645,2019-07-17,GOOG,57.54850006103516,57.917999267578125,57.28850173950195,57.317501068115234,23400000.0,0.0,0.0,-0.3614997863769531,0.3614997863769531,0.0,65.55249213907895,53.66849899291992,57.92900085449219,85.64723578946426,-14.35276421053574,0.5473447585397864,0.25492141254511114,0.022084961110548473,1813819540.0,-1.0
1646,2019-07-18,GOOG,57.08700180053711,57.3802490234375,56.63650131225586,57.31650161743164,25814000.0,0.0,0.0,-0.00099945068359375,0.00099945068359375,0.0,65.52686880066267,53.66849899291992,57.92900085449219,85.62377726941037,-14.37622273058964,0.5588919069826019,0.31571551143260934,0.013025978467063215,1788005540.0,-1.0
1647,2019-07-19,GOOG,57.40950012207031,57.55699920654297,56.48099899291992,56.505001068115234,32944000.0,0.0,0.0,-0.8115005493164062,0.8115005493164062,0.0,47.96276270247004,54.685150146484375,57.92900085449219,56.10156216925617,-43.89843783074383,0.496834593059468,0.3519393277579811,0.012316925459651573,1755061540.0,-1.0
1648,2019-07-22,GOOG,56.67250061035156,56.962501525878906,56.21200180053711,56.90349960327149,26030000.0,0.0,0.0,0.3984985351562571,0.0,0.3984985351562571,54.823969675442676,54.90850067138672,57.92900085449219,66.04862807303833,-33.95137192696167,0.4743413146642581,0.37641972513923655,0.011770645141423675,1781091540.0,1.0
1649,2019-07-23,GOOG,57.20000076293945,57.345001220703125,56.59000015258789,57.31050109863281,21874000.0,0.0,0.0,0.407001495361321,0.0,0.407001495361321,60.899519243416925,55.35850143432617,57.92900085449219,75.93853742945295,-24.061462570547057,0.48378013247843654,0.3978918066070766,0.00502425026084552,1802965540.0,1.0
1650,2019-07-24,GOOG,56.595001220703125,57.20000076293945,56.3494987487793,56.89049911499024,31796000.0,0.0,0.0,-0.420001983642571,0.420001983642571,0.0,52.493568469877886,55.35850143432617,57.92900085449219,59.59922296209371,-40.400777037906295,0.45215762201402043,0.4087449696884654,-0.0055933736199013095,1771169540.0,-1.0
1651,2019-07-25,GOOG,56.89099884033203,57.084999084472656,56.04600143432617,56.60599899291992,44196000.0,0.0,0.0,-0.2845001220703196,0.2845001220703196,0.0,47.381880946400905,55.35850143432617,57.92900085449219,48.5313300912233,-51.4686699087767,0.3995341910062251,0.4069028139520174,-0.011162546089400482,1726973540.0,-1.0
1652,2019-07-26,GOOG,61.20199966430664,63.27750015258789,61.20000076293945,62.52050018310547,96116000.0,0.0,0.0,5.914501190185547,0.0,5.914501190185547,84.22639251322465,55.35850143432617,63.27750015258789,90.44071104928037,-9.559288950719633,0.8255639717299488,0.49063504550760373,0.08699170750834218,1823089540.0,1.0
1653,2019-07-29,GOOG,62.0525016784668,62.368499755859375,61.4114990234375,61.97050094604492,44474000.0,0.0,0.0,-0.5499992370605469,0.5499992370605469,0.0,78.3404575582254,56.04600143432617,63.27750015258789,81.92630245176701,-18.073697548232996,1.1060652685231318,0.6137210901107095,0.0744031628144699,1778615540.0,-1.0
1654,2019-07-30,GOOG,61.27050018310547,61.743499755859375,61.165000915527344,61.25699996948242,29066000.0,0.0,0.0,-0.7135009765625,0.7135009765625,0.0,70.92176791306339,56.04600143432617,63.27750015258789,72.05973115914277,-27.94026884085723,1.2563090525695273,0.7422386826024732,0.06873116985134353,1749549540.0,-1.0
1655,2019-07-31,GOOG,61.150001525878906,61.70000076293945,60.38819885253906,60.83399963378906,34510000.0,0.0,0.0,-0.4230003356933594,0.4230003356933594,0.0,66.60702258806273,56.04600143432617,63.27750015258789,66.21031664393094,-33.78968335606907,1.325960890185101,0.8589831241189989,0.06136972629340742,1715039540.0,-1.0
1656,2019-08-01,GOOG,60.70149993896485,61.70550155639648,60.2859992980957,60.45050048828125,33970000.0,0.0,0.0,-0.3834991455078125,0.3834991455078125,0.0,62.621625960188894,56.04600143432617,63.27750015258789,60.90714007640473,-39.09285992359526,1.3348282283882966,0.9541521449728584,0.06982566756188224,1681069540.0,-1.0
1657,2019-08-02,GOOG,60.0369987487793,60.345001220703125,59.446998596191406,59.699501037597656,32902000.0,0.0,0.0,-0.7509994506835938,0.7509994506835938,0.0,55.163549114015765,56.04600143432617,63.27750015258789,50.52202517916922,-49.47797482083079,1.2666550673432369,1.016652729446934,0.04913584320507103,1648167540.0,-1.0
1658,2019-08-05,GOOG,58.50199890136719,58.762001037597656,57.00699996948242,57.61600112915039,51950000.0,0.0,0.0,-2.0834999084472656,2.0834999084472656,0.0,39.93755237958159,56.04600143432617,63.27750015258789,21.710571431887214,-78.28942856811278,1.0326031100973978,1.0198428055770268,0.005330611749351233,1596217540.0,-1.0
1659,2019-08-06,GOOG,58.16550064086914,58.99800109863281,58.0,58.497501373291016,34188000.0,0.0,0.0,0.881500244140625,0.0,0.881500244140625,47.06961927605468,56.04600143432617,63.27750015258789,33.9003024749775,-66.09969752502249,0.9077806205046457,0.9974303685625505,0.028247287039134816,1630405540.0,1.0
1660,2019-08-07,GOOG,57.79999923706055,58.92224884033203,57.481201171875,58.699501037597656,28886000.0,0.0,0.0,0.20199966430664062,0.0,0.20199966430664062,48.68088675945699,56.04600143432617,63.27750015258789,36.69363304415164,-63.30636695584836,0.8157540777142245,0.9610951103928854,0.036983748753194545,1659291540.0,1.0
1661,2019-08-08,GOOG,59.14149856567383,60.2504997253418,58.6510009765625,60.2400016784668,29360000.0,0.0,0.0,1.5405006408691406,0.0,1.5405006408691406,59.52331791053835,56.04600143432617,63.27750015258789,57.996279990336,-42.00372000966401,0.8572461072473061,0.9403253097637696,-0.03647601183547344,1688651540.0,1.0
1662,2019-08-09,GOOG,59.89950180053711,60.19400024414063,59.18014907836914,59.4005012512207,21314000.0,0.0,0.0,-0.8395004272460938,0.8395004272460938,0.0,52.54308317325499,56.04600143432617,63.27750015258789,46.38733888486222,-53.61266111513778,0.8130162261353817,0.9148634930380922,-0.041471339679209795,1667337540.0,-1.0
1663,2019-08-12,GOOG,58.96049880981445,59.24800109863281,58.38359832763672,58.73550033569336,20060000.0,0.0,0.0,-0.6650009155273438,0.6650009155273438,0.0,47.456482232372174,56.04600143432617,63.27750015258789,37.191445454804416,-62.808554545195584,0.7160495371180531,0.8751007018540844,-0.04116263667899578,1647277540.0,-1.0
1664,2019-08-13,GOOG,58.573001861572266,60.23899841308594,58.573001861572266,59.86349868774414,25888000.0,0.0,0.0,1.1279983520507812,0.0,1.1279983520507812,55.826203075505894,56.04600143432617,63.27750015258789,52.789848994616214,-47.210151005383786,0.7219011503066071,0.8444607915445889,-0.015953265474688227,1673165540.0,1.0
1665,2019-08-14,GOOG,58.81549835205078,59.1150016784668,58.027000427246094,58.214500427246094,31574000.0,0.0,0.0,-1.6489982604980469,1.6489982604980469,0.0,44.00302994870282,57.00699996948242,63.27750015258789,19.256844310714246,-80.74315568928576,0.5867149330179586,0.7929116198392628,-0.036988942076147446,1641591540.0,-1.0
1666,2019-08-15,GOOG,58.17499923706055,58.79199981689453,58.105499267578125,58.36299896240234,24374000.0,0.0,0.0,0.1484985351562429,0.0,0.1484985351562429,45.208778691832386,57.00699996948242,62.368499755859375,25.291411861385793,-74.7085881386142,0.4859596324422384,0.7315212223598581,-0.0223871565417878,1665965540.0,1.0
1667,2019-08-16,GOOG,58.977500915527344,59.13600158691406,58.59049987792969,58.880001068115234,26266000.0,0.0,0.0,0.5170021057128977,0.0,0.5170021057128977,49.5708428430442,57.00699996948242,61.743499755859375,39.54399204281417,-60.45600795718583,0.4427246260942894,0.6737619031067444,0.021938348968917554,1692231540.0,1.0
1668,2019-08-19,GOOG,59.50450134277344,60.3494987487793,59.50450134277344,59.92250061035156,24632000.0,0.0,0.0,1.0424995422363281,0.0,1.0424995422363281,57.45202599435262,57.00699996948242,61.70550155639648,62.05171131556481,-37.9482886844352,0.4869681073836176,0.6364031439621192,0.024360001771138506,1716863540.0,1.0
1669,2019-08-20,GOOG,59.76250076293945,59.803001403808594,59.105499267578125,59.134498596191406,18310000.0,0.0,0.0,-0.7880020141601562,0.7880020141601562,0.0,50.56042970914006,57.00699996948242,61.70550155639648,45.28036411936835,-54.71963588063166,0.45322174991508746,0.5997668651527128,0.007410583580857555,1698553540.0,-1.0
1670,2019-08-21,GOOG,59.657501220703125,59.95000076293945,59.37149810791016,59.5625,14814000.0,0.0,0.0,0.42800140380859375,0.0,0.42800140380859375,54.017238086625945,57.00699996948242,60.3494987487793,76.4547782738503,-23.545221726149716,0.4557599379581987,0.5709654797138101,-0.011246707496506803,1713367540.0,1.0
1671,2019-08-22,GOOG,59.70349884033203,59.90060043334961,58.92900085449219,59.47650146484375,18950000.0,0.0,0.0,-0.08599853515625,0.08599853515625,0.0,53.155563836820555,57.00699996948242,60.3494987487793,73.88189670127001,-26.118103298729995,0.4456944193703123,0.5459112676451106,0.001279454079042619,1694417540.0,-1.0
1672,2019-08-23,GOOG,59.0994987487793,59.70399856567383,57.38750076293945,57.56449890136719,33740000.0,0.0,0.0,-1.9120025634765625,1.9120025634765625,0.0,37.71986761780916,57.38750076293945,60.3494987487793,5.975633314873723,-94.02436668512628,0.2802047696082113,0.4927699680377307,-0.019936859780430916,1660677540.0,-1.0
1673,2019-08-26,GOOG,57.86299896240234,58.4734992980957,57.64799880981445,58.44449996948242,24522000.0,0.0,0.0,0.8800010681152344,0.0,0.8800010681152344,46.04102640515308,57.38750076293945,60.3494987487793,35.68534521617062,-64.31465478382938,0.21755393526125744,0.43772676148243606,-0.023703905541228143,1685199540.0,1.0
1674,2019-08-27,GOOG,59.0265007019043,59.119998931884766,58.0724983215332,58.391998291015625,21544000.0,0.0,0.0,-0.052501678466796875,0.052501678466796875,0.0,45.621421083972635,57.38750076293945,60.3494987487793,33.912836297603256,-66.08716370239675,0.16180110852756258,0.38254163089146137,0.0030490318128102434,1663655540.0,-1.0
1675,2019-08-28,GOOG,58.08549880981445,58.82099914550781,57.8650016784668,58.55099868774414,16040000.0,0.0,0.0,0.15900039672851562,0.0,0.15900039672851562,47.29976691044552,57.38750076293945,60.3494987487793,39.28084794003632,-60.719152059963676,0.1289600239763402,0.3318253095084372,0.00322121427418276,1679695540.0,1.0
1676,2019-08-29,GOOG,59.055999755859375,59.803001403808594,59.055999755859375,59.64250183105469,21768000.0,0.0,0.0,1.0915031433105469,0.0,1.0915031433105469,57.65252007319156,57.38750076293945,60.3494987487793,76.13108040233364,-23.868919597666363,0.18883167544415613,0.303226582695581,0.01295008065739256,1701463540.0,1.0
1677,2019-08-30,GOOG,59.92499923706055,59.92499923706055,59.19015121459961,59.40499877929688,22596000.0,0.0,0.0,-0.2375030517578054,0.2375030517578054,0.0,54.942670411134955,57.38750076293945,60.3494987487793,68.112740994501,-31.887259005499008,0.2146416241696656,0.2855095909903979,-0.008636185502667093,1678867540.0,-1.0
1678,2019-09-03,GOOG,58.85150146484375,59.34450149536133,58.15999984741211,58.41949844360352,29598000.0,0.0,0.0,-0.9855003356933594,0.9855003356933594,0.0,44.84964435549104,57.38750076293945,60.3494987487793,34.84126881914328,-65.1587311808567,0.15380162417941534,0.2591679976282014,-0.01209108337030751,1649269540.0,-1.0
1679,2019-09-04,GOOG,58.83549880981445,59.17399978637695,58.54999923706055,59.070499420166016,21378000.0,0.0,0.0,0.6510009765624929,0.0,0.6510009765624929,51.623266154448245,57.38750076293945,60.3494987487793,56.819709711901304,-43.1802902880987,0.15631393429256946,0.23859718496107502,-0.00826024058483077,1670647540.0,1.0
1680,2019-09-05,GOOG,59.57649993896485,60.652000427246094,59.57649993896485,60.56900024414063,28162000.0,0.0,0.0,1.4985008239746165,0.0,1.4985008239746165,63.52254021430174,57.38750076293945,60.652000427246094,97.4574914492114,-2.5425085507886047,0.2760394403188755,0.24608563603263517,0.018368578386249723,1698809540.0,1.0
1681,2019-09-06,GOOG,60.40650177001953,60.60074996948242,60.1260986328125,60.24649810791016,21442000.0,0.0,0.0,-0.32250213623046875,0.32250213623046875,0.0,59.86586250949357,57.38750076293945,60.652000427246094,87.57842361665378,-12.421576383346222,0.34096906020919704,0.26506232086794757,0.04659120217720303,1677367540.0,-1.0
1682,2019-09-09,GOOG,60.20000076293945,61.0,59.63100051879883,60.22050094604492,29438000.0,0.0,0.0,-0.02599716186524148,0.02599716186524148,0.0,59.54703176420905,57.38750076293945,61.0,78.42216695969884,-21.577833040301165,0.3858803100575656,0.28922591870587117,0.03038782053897049,1647929540.0,-1.0
1683,2019-09-10,GOOG,59.75749969482422,60.5,59.729000091552734,60.29999923706055,25202000.0,0.0,0.0,0.079498291015625,0.0,0.079498291015625,60.293181184314705,57.38750076293945,61.0,80.62281215845913,-19.377187841540874,0.42301143432111843,0.31598302182892063,0.03267572615918657,1673131540.0,1.0
1684,2019-09-11,GOOG,60.170501708984375,61.130001068115234,60.11000061035156,61.00849914550781,26140000.0,0.0,0.0,0.7084999084472656,0.0,0.7084999084472656,66.6237515995809,57.38750076293945,61.130001068115234,96.75345590648615,-3.246544093513843,0.503800639083849,0.3535465452799063,0.041971964831371444,1699271540.0,1.0
1685,2019-09-12,GOOG,61.21500015258789,62.09299850463867,61.1510009765625,61.712501525878906,34518000.0,0.0,0.0,0.7040023803710938,0.0,0.7040023803710938,71.78183895840533,57.38750076293945,62.09299850463867,91.91377831535495,-8.086221684645057,0.617515440804091,0.4063403243847434,0.034706788469198724,1733789540.0,1.0
1686,2019-09-13,GOOG,61.567501068115234,62.04399871826172,61.35049819946289,61.97800064086914,26028000.0,0.0,0.0,0.2654991149902344,0.0,0.2654991149902344,73.55991710215592,57.64799880981445,62.09299850463867,97.41287127863168,-2.587128721368314,0.7207504377544467,0.4692223470586841,0.04331288468048866,1759817540.0,1.0
1687,2019-09-16,GOOG,61.47600173950195,61.97800064086914,61.28049850463867,61.56499862670898,21066000.0,0.0,0.0,-0.41300201416016336,0.41300201416016336,0.0,66.08568576647357,57.8650016784668,62.09299850463867,87.51181943512107,-12.488180564878942,0.7604728480503056,0.5274724472570085,0.053843327431885246,1738751540.0,-1.0
1688,2019-09-17,GOOG,61.52000045776367,61.75,61.18450164794922,61.45750045776367,19102000.0,0.0,0.0,-0.1074981689453054,0.1074981689453054,0.0,64.12875737967957,57.8650016784668,62.09299850463867,84.96928751362393,-15.030712486376071,0.7743526848272069,0.5768484947710482,0.040409359342283846,1719649540.0,-1.0
1689,2019-09-18,GOOG,61.3754997253418,61.78049850463867,60.82649993896485,61.62049865722656,22702000.0,0.0,0.0,0.16299819946289062,0.0,0.16299819946289062,65.89563761796916,58.15999984741211,62.09299850463867,87.98626980093344,-12.013730199066549,0.7894053741699381,0.6193598706508262,0.017360339593646357,1742351540.0,1.0
1690,2019-09-19,GOOG,61.60300064086914,62.22200012207031,61.60100173950195,61.93550109863281,19920000.0,0.0,0.0,0.31500244140625,0.0,0.31500244140625,69.27077404576316,58.15999984741211,62.22200012207031,92.94684874284978,-7.053151257150208,0.8173311189902961,0.6589541203187202,0.028034874121602993,1762271540.0,1.0
1691,2019-09-20,GOOG,61.65599822998047,62.16600036621094,61.15399932861328,61.49649810791016,45400000.0,0.0,0.0,-0.43900299072264914,0.43900299072264914,0.0,59.76042340000235,58.15999984741211,62.22200012207031,82.13929184873832,-17.86070815126167,0.7948757674501437,0.686138449745005,0.021188750372709064,1716871540.0,-1.0
1692,2019-09-23,GOOG,61.29999923706055,61.954498291015625,61.20849990844727,61.70149993896485,21248000.0,0.0,0.0,0.2050018310546875,0.0,0.2050018310546875,62.53210864163053,58.54999923706055,62.22200012207031,85.82516182851963,-14.174838171480381,0.7845775524250342,0.705826270281011,0.023242134654007485,1738119540.0,1.0
1693,2019-09-24,GOOG,62.0,62.33700180053711,60.53400039672852,60.9379997253418,31664000.0,0.0,0.0,-0.763500213623054,0.763500213623054,0.0,48.25013139658355,59.57649993896485,62.33700180053711,49.32073422335954,-50.679265776640456,0.7066620956642069,0.7059934353576502,-0.001155567193971918,1706455540.0,-1.0
1694,2019-09-25,GOOG,60.79100036621094,62.415000915527344,60.50450134277344,62.32600021362305,29060000.0,0.0,0.0,1.38800048828125,0.0,1.38800048828125,65.01226908049826,59.63100051879883,62.415000915527344,96.80313616302347,-3.196863836976524,0.7482877785131876,0.7144523039887578,0.00994123836459404,1735515540.0,1.0
1695,2019-09-26,GOOG,62.09799957275391,62.25,61.613399505615234,62.06949996948242,30760000.0,0.0,0.0,-0.256500244140625,0.256500244140625,0.0,60.8121954360992,59.63100051879883,62.415000915527344,87.5897666375723,-12.410233362427704,0.7519114390074222,0.7219441309924908,0.0014763194628280019,1704755540.0,-1.0
1696,2019-09-27,GOOG,62.1505012512207,62.20100021362305,60.72249984741211,61.25450134277344,27078000.0,0.0,0.0,-0.8149986267089844,0.8149986267089844,0.0,49.16688053466341,59.729000091552734,62.415000915527344,56.79451910827573,-43.20548089172427,0.6811675624605087,0.7137888172860944,-0.005043406007660289,1677677540.0,-1.0
1697,2019-09-30,GOOG,61.04850006103516,61.29999923706055,60.6150016784668,60.95000076293945,28082000.0,0.0,0.0,-0.3045005798339844,0.3045005798339844,0.0,45.417472785465485,60.11000061035156,62.415000915527344,36.44251806395451,-63.55748193604549,0.5936882105072456,0.6897686959303247,-0.008257734060840849,1649595540.0,-1.0
1698,2019-10-01,GOOG,60.95000076293945,61.561500549316406,60.17900085449219,60.255001068115234,25470000.0,0.0,0.0,-0.6949996948242188,0.6949996948242188,0.0,37.821649095250464,60.17900085449219,62.415000915527344,3.3989361157647986,-96.6010638842352,0.46294300798800947,0.6444035583418617,-0.022159794530503873,1624125540.0,-1.0
1699,2019-10-02,GOOG,59.8489990234375,59.8489990234375,58.56449890136719,58.83150100708008,32302000.0,0.0,0.0,-1.4235000610351562,1.4235000610351562,0.0,27.107420878623103,58.56449890136719,62.415000915527344,6.934215453751093,-93.0657845462489,0.24167604378936147,0.5638580554313617,-0.05011665420466349,1591823540.0,-1.0
1700,2019-10-03,GOOG,59.0,59.45299911499024,58.12149810791016,59.39149856567383,32424000.0,0.0,0.0,0.55999755859375,0.0,0.55999755859375,35.41252850594624,58.12149810791016,62.415000915527344,29.57958838434982,-70.42041161565018,0.11023676262365711,0.47313379686982077,-0.03422958391130848,1624247540.0,1.0
1701,2019-10-04,GOOG,59.59450149536133,60.571998596191406,59.45849990844727,60.45000076293945,23248000.0,0.0,0.0,1.058502197265625,0.0,1.058502197265625,48.26768572034251,58.12149810791016,62.415000915527344,54.23316949736824,-45.766830502631755,0.09043993114893567,0.39659502372564376,-0.020283124028806165,1647495540.0,1.0
1702,2019-10-07,GOOG,60.220001220703125,60.91019821166992,60.1875,60.38399887084961,16858000.0,0.0,0.0,-0.06600189208984375,0.06600189208984375,0.0,47.58625274624582,58.12149810791016,62.415000915527344,52.69591902736159,-47.30408097263841,0.06863383041201132,0.3310027850629173,-0.009091221520055925,1630637540.0,-1.0
1703,2019-10-08,GOOG,59.87950134277344,60.30400085449219,59.45050048828125,59.45650100708008,20786000.0,0.0,0.0,-0.9274978637695312,0.9274978637695312,0.0,38.72221993396639,58.12149810791016,62.415000915527344,31.093560642407457,-68.90643935759255,-0.023221306937983854,0.26015796666273705,-0.0460401629610071,1609851540.0,-1.0
1704,2019-10-09,GOOG,59.96749877929688,60.41749954223633,59.88150024414063,60.115501403808594,17354000.0,0.0,0.0,0.6590003967285156,0.0,0.6590003967285156,46.84029519911547,58.12149810791016,62.415000915527344,46.44234288983888,-53.55765711016112,-0.04235312014338888,0.19965574930151184,-0.031480816933188494,1627205540.0,1.0
1705,2019-10-10,GOOG,59.92900085449219,60.75,59.867000579833984,60.43349838256836,16932000.0,0.0,0.0,0.3179969787597656,0.0,0.3179969787597656,50.4921174182619,58.12149810791016,62.415000915527344,53.848812455797976,-46.151187544202024,-0.03149249548709321,0.15342610034379084,-0.01340314494784367,1644137540.0,1.0
1706,2019-10-11,GOOG,61.11050033569336,61.41949844360352,60.6870002746582,60.772499084472656,25454000.0,0.0,0.0,0.3390007019042969,0.0,0.3390007019042969,54.34954422571759,58.12149810791016,62.415000915527344,61.74447986523508,-38.25552013476492,0.004418220797099082,0.12362452443445249,-0.0029122506356837885,1669591540.0,1.0
1707,2019-10-14,GOOG,60.617000579833984,61.31650161743164,60.5880012512207,60.85699844360352,17350000.0,0.0,0.0,0.08449935913086648,0.0,0.08449935913086648,55.350107333484964,58.12149810791016,62.415000915527344,63.71255495257297,-36.28744504742703,0.03924373689575589,0.10674836692671316,0.009990828392945517,1686941540.0,1.0
1708,2019-10-15,GOOG,61.02000045776367,62.36650085449219,61.02000045776367,62.1505012512207,27634000.0,0.0,0.0,1.2935028076171804,0.0,1.2935028076171804,67.81140470051307,58.12149810791016,62.36650085449219,94.91167341539644,-5.088326584603559,0.1692668724878601,0.11925206803894257,0.056415358903407986,1714575540.0,1.0
1709,2019-10-16,GOOG,62.05849838256836,62.73699951171875,61.92250061035156,62.18199920654297,21892000.0,0.0,0.0,0.031497955322265625,0.0,0.031497955322265625,68.0618514908528,58.12149810791016,62.73699951171875,87.97529766283225,-12.024702337167746,0.27172054071264995,0.14974576257368408,0.04698484982296702,1736467540.0,1.0
1710,2019-10-17,GOOG,62.54650115966797,63.1662483215332,62.49700164794922,62.65349960327149,19048000.0,0.0,0.0,0.47150039672852273,0.0,0.47150039672852273,71.84548530406146,58.12149810791016,63.1662483215332,89.83599392340447,-10.164006076595527,0.3865065455769354,0.19709791917433436,0.03645159325925018,1755515540.0,1.0
1711,2019-10-18,GOOG,62.67300033569336,62.94449996948242,62.05400085449219,62.27450180053711,27056000.0,0.0,0.0,-0.3789978027343821,0.3789978027343821,0.0,64.7329077634052,58.12149810791016,63.1662483215332,82.32327700610455,-17.67672299389545,0.44180052471884323,0.24603844028323615,0.031308011477195086,1728459540.0,-1.0
1712,2019-10-21,GOOG,62.61299896240234,62.73144912719727,62.02999877929688,62.307498931884766,20544000.0,0.0,0.0,0.03299713134765625,0.0,0.03299713134765625,65.08019335214621,58.12149810791016,63.1662483215332,82.97736551297551,-17.022634487024497,0.48271950432819466,0.2933746530922279,0.04795098730187952,1749003540.0,1.0
1713,2019-10-22,GOOG,62.39250183105469,62.52999877929688,62.06900024414063,62.13999938964844,20476000.0,0.0,0.0,-0.16749954223632812,0.16749954223632812,0.0,61.53125676454461,58.12149810791016,63.1662483215332,79.65709126462906,-20.342908735370944,0.4959156701192029,0.3338828564976229,0.03367680446081378,1728527540.0,-1.0
1714,2019-10-23,GOOG,62.11800003051758,62.99449920654297,62.11800003051758,62.95650100708008,18230000.0,0.0,0.0,0.8165016174316406,0.0,0.8165016174316406,70.56081525444293,59.45050048828125,63.1662483215332,94.3551789877636,-5.6448210122364,0.5657371179828274,0.38025370879466386,0.04174841258634565,1746757540.0,1.0
1715,2019-10-24,GOOG,63.04499816894531,63.20000076293945,62.68574905395508,63.04949951171875,20562000.0,0.0,0.0,0.09299850463867188,0.0,0.09299850463867188,71.441775957745,59.45050048828125,63.20000076293945,95.98609840788923,-4.013901592110765,0.6214120690382359,0.4284853808433784,0.03746761218558925,1767319540.0,1.0
1716,2019-10-25,GOOG,62.55149841308594,63.47999954223633,62.5004997253418,63.25650024414063,24262000.0,0.0,0.0,0.2070007324218821,0.0,0.2070007324218821,73.47998335394087,59.45050048828125,63.47999954223633,94.45342224671019,-5.546577753289817,0.6744633048556139,0.47768096564582546,0.039428526905755046,1791581540.0,1.0
1717,2019-10-28,GOOG,63.772499084472656,64.96549987792969,63.62699890136719,64.5,52264000.0,0.0,0.0,1.243499755859368,0.0,1.243499755859368,82.25725739678455,59.867000579833984,64.96549987792969,90.86986482270278,-9.130135177297218,0.8075380336146338,0.5436523792395872,0.037803375700580455,1843845540.0,1.0
1718,2019-10-29,GOOG,63.811500549316406,64.07949829101562,62.860599517822266,63.13100051879883,37728000.0,0.0,0.0,-1.3689994812011719,1.3689994812011719,0.0,57.91020248901634,59.867000579833984,64.96549987792969,64.01883668364832,-35.98116331635169,0.7933882125338414,0.5935995458984381,0.015261672579932162,1806117540.0,-1.0
1719,2019-10-30,GOOG,62.64849853515625,63.46799850463867,62.59999847412109,63.06449890136719,28178000.0,0.0,0.0,-0.06650161743164062,0.06650161743164062,0.0,56.965144956104304,60.5880012512207,64.96549987792969,56.5733507039001,-43.4266492960999,0.7679557369342902,0.6284707841056085,0.006559877751413534,1777939540.0,-1.0
1720,2019-10-31,GOOG,63.06399917602539,63.38349914550781,62.54214859008789,63.00550079345703,29114000.0,0.0,0.0,-0.05899810791015625,0.05899810791015625,0.0,56.02915535743367,60.5880012512207,64.96549987792969,55.225592247731,-44.774407752269,0.7345719740878565,0.6496910221020582,0.011738335462903926,1748825540.0,-1.0
1721,2019-11-01,GOOG,63.25,63.73099899291992,63.025001525878906,63.6870002746582,33402000.0,0.0,0.0,0.6814994812011719,0.0,0.6814994812011719,63.92865381598357,61.02000045776367,64.96549987792969,67.59600073093691,-32.40399926906309,0.7544100447274928,0.6706348266271452,0.022140213721008495,1782227540.0,1.0
1722,2019-11-04,GOOG,63.8224983215332,64.70649719238281,63.8177490234375,64.56849670410156,30020000.0,0.0,0.0,0.8814964294433594,0.0,0.8814964294433594,71.5553748341657,61.92250061035156,64.96549987792969,86.95355670775125,-13.046443292248755,0.8316742306859126,0.7028427074388988,0.03908106434351977,1812247540.0,1.0
1723,2019-11-05,GOOG,64.64450073242188,64.94650268554688,64.56144714355469,64.60150146484375,25654000.0,0.0,0.0,0.0330047607421875,0.0,0.0330047607421875,71.8128472200203,62.02999877929688,64.96549987792969,87.60012683165175,-12.399873168348256,0.8853639387104266,0.7393469536932045,0.0261291595220432,1837901540.0,1.0
1724,2019-11-06,GOOG,64.4729995727539,64.6865005493164,64.125,64.58999633789062,23060000.0,0.0,0.0,-0.011505126953125,0.011505126953125,0.0,71.55234164222112,62.02999877929688,64.96549987792969,87.20819623559495,-12.79180376440504,0.9164211193292644,0.7747617868204165,0.02443313330164587,1814841540.0,-1.0
1725,2019-11-07,GOOG,64.71399688720703,66.18699645996094,64.71224975585938,65.44300079345703,40600000.0,0.0,0.0,0.8530044555664062,0.0,0.8530044555664062,78.2896863690194,62.02999877929688,66.18699645996094,82.1025720085305,-17.897427991469492,0.9983560622031149,0.8194806418969562,0.03456562631314619,1855441540.0,1.0
1726,2019-11-08,GOOG,65.26399993896484,65.9000015258789,65.21824645996094,65.56849670410156,25028000.0,0.0,0.0,0.12549591064453125,0.0,0.12549591064453125,79.12879084417818,62.06900024414063,66.18699645996094,84.98056522045225,-15.019434779547748,1.0611838984981077,0.8678212932171867,0.016565840373667706,1880469540.0,1.0
1727,2019-11-11,GOOG,65.15899658203125,65.32125091552734,64.87049865722656,64.95950317382812,20238000.0,0.0,0.0,-0.6089935302734375,0.6089935302734375,0.0,65.0509888120425,62.11800003051758,66.18699645996094,69.83302130101072,-30.166978698989276,1.0497340424852197,0.9042038430707933,0.02896362547722986,1860231540.0,-1.0
1728,2019-11-12,GOOG,65.0,65.5,64.78849792480469,64.94000244140625,21718000.0,0.0,0.0,-0.019500732421875,0.019500732421875,0.0,64.62617859647754,62.5004997253418,66.18699645996094,66.17400995247276,-33.82599004752725,1.0272449624815252,0.9288120669529398,0.02973945044695192,1838513540.0,-1.0
1729,2019-11-13,GOOG,64.70349884033203,65.21499633789062,64.67549896240234,64.9000015258789,16534000.0,0.0,0.0,-0.04000091552734375,0.04000091552734375,0.0,63.642495597495035,62.5004997253418,66.18699645996094,65.08894414591165,-34.911055854088346,0.9947278613826356,0.941995225838879,0.030068814763212215,1821979540.0,-1.0
1730,2019-11-14,GOOG,64.875,65.8499984741211,64.78250122070312,65.572998046875,23870000.0,0.0,0.0,0.6729965209960938,0.0,0.6729965209960938,71.9352479057421,62.54214859008789,66.18699645996094,83.15434731416312,-16.84565268583689,1.0116019022378069,0.9559165611186646,0.02961354380145398,1845849540.0,1.0
1731,2019-11-15,GOOG,65.9469985961914,66.74400329589844,65.71399688720703,66.74349975585938,35652000.0,0.0,0.0,1.170501708984375,0.0,1.170501708984375,80.74766686440122,62.54214859008789,66.74400329589844,99.9880162434373,-0.011983756562695473,1.1066674335135502,0.9860667355976418,0.03368520505789707,1881501540.0,1.0
1732,2019-11-18,GOOG,66.61100006103516,66.77645111083984,65.875,66.03500366210938,29748000.0,0.0,0.0,-0.70849609375,0.70849609375,0.0,66.22437380094493,62.54214859008789,66.77645111083984,82.48950222387988,-17.510497776120115,1.1120191735186111,1.0112572231818358,0.022189920741172653,1851753540.0,-1.0
1733,2019-11-19,GOOG,66.38500213623047,66.38500213623047,65.63999938964844,65.77300262451172,25384000.0,0.0,0.0,-0.26200103759765625,0.26200103759765625,0.0,61.50424683429735,62.54214859008789,66.77645111083984,76.30191793311153,-23.698082066888468,1.0826391813664173,1.0255336148187522,0.01831562708925416,1826369540.0,-1.0
1734,2019-11-20,GOOG,65.58699798583984,65.75,64.55750274658203,65.15249633789062,26172000.0,0.0,0.0,-0.6205062866210938,0.6205062866210938,0.0,51.47780338564028,63.025001525878906,66.77645111083984,56.71127290476093,-43.28872709523907,0.9977838235524246,1.0199836565654867,-0.004439045460083002,1800197540.0,-1.0
1735,2019-11-21,GOOG,65.0739974975586,65.62950134277344,64.6500015258789,65.06749725341797,19910000.0,0.0,0.0,-0.08499908447265625,0.08499908447265625,0.0,50.184712027619824,63.8177490234375,66.77645111083984,42.239745437760924,-57.760254562239076,0.9131503960359311,0.9986170044595756,-0.007640856140785246,1780287540.0,-1.0
1736,2019-11-22,GOOG,65.28099822998047,65.4365005493164,64.57050323486328,64.76699829101562,27714000.0,0.0,0.0,-0.30049896240234375,0.30049896240234375,0.0,45.52035799302184,64.125,66.77645111083984,24.213091781740335,-75.78690821825967,0.812464455584518,0.9613864946845642,-0.0029634599005070594,1752573540.0,-1.0
1737,2019-11-25,GOOG,64.95899963378906,65.56549835205078,64.90650177001953,65.33450317382812,20724000.0,0.0,0.0,0.5675048828125,0.0,0.5675048828125,54.69590671936711,64.125,66.77645111083984,45.616650025465354,-54.383349974534646,0.7695916500924227,0.9230275257661359,0.006074849362345258,1773297540.0,1.0
1738,2019-11-26,GOOG,65.49299621582031,65.73999786376953,65.25450134277344,65.67749786376953,21394000.0,0.0,0.0,0.34299468994140625,0.0,0.34299468994140625,59.4577132132792,64.55750274658203,66.77645111083984,50.47414059867557,-49.52585940132443,0.754592969772375,0.8893406145673838,0.011979912474741505,1794691540.0,1.0
1739,2019-11-27,GOOG,65.75,65.91799926757812,65.48149871826172,65.64949798583984,19912000.0,0.0,0.0,-0.0279998779296875,0.0279998779296875,0.0,58.87483124083681,64.55750274658203,66.77645111083984,49.21228708370868,-50.78771291629132,0.7320089083788304,0.8578742733296731,0.0011666378119565834,1774779540.0,-1.0
1740,2019-11-29,GOOG,65.35600280761719,65.51024627685547,65.19850158691406,65.24800109863281,11740000.0,0.0,0.0,-0.40149688720703125,0.40149688720703125,0.0,50.65816205696689,64.55750274658203,66.77645111083984,31.11827040111126,-68.88172959888874,0.673944619608065,0.8210883425853516,-0.022406656269103875,1763039540.0,-1.0
1741,2019-12-02,GOOG,65.05000305175781,65.29149627685547,64.05000305175781,64.49600219726562,30218000.0,0.0,0.0,-0.7519989013671875,0.7519989013671875,0.0,38.919547569319874,64.05000305175781,66.77645111083984,16.358248381888345,-83.64175161811166,0.5607838585577127,0.7690274457798238,-0.023305843560160522,1732821540.0,-1.0
1742,2019-12-03,GOOG,63.97850036621094,64.92304992675781,63.95000076293945,64.76399993896484,22876000.0,0.0,0.0,0.26799774169921875,0.0,0.26799774169921875,44.23333212002533,63.95000076293945,66.77645111083984,28.799344613644617,-71.20065538635538,0.48711318062180453,0.71264459274822,-0.015340681514984467,1755697540.0,1.0
1743,2019-12-04,GOOG,65.35050201416016,66.29000091552734,65.24349975585938,66.0270004272461,30750000.0,0.0,0.0,1.26300048828125,0.0,1.26300048828125,62.14245831071922,63.95000076293945,66.77645111083984,73.48438531211156,-26.515614687888444,0.524595016852615,0.6750346775690991,0.013422418763820776,1786447540.0,1.0
1744,2019-12-05,GOOG,66.4000015258789,66.46790313720703,65.8219985961914,66.40650177001953,24254000.0,0.0,0.0,0.3795013427734375,0.0,0.3795013427734375,65.93527845795266,63.95000076293945,66.77645111083984,86.91116788606858,-13.088832113931414,0.5782564484586459,0.6556790317470085,0.020578700167098063,1810701540.0,1.0
1745,2019-12-06,GOOG,66.6719970703125,67.19999694824219,66.6719970703125,67.03099822998047,26296000.0,0.0,0.0,0.6244964599609375,0.0,0.6244964599609375,71.37966680941794,63.95000076293945,67.19999694824219,94.80003333462447,-5.199966665375537,0.6635264449735416,0.6572485143923151,0.03495607328893158,1836997540.0,1.0
1746,2019-12-09,GOOG,66.9020004272461,67.97250366210938,66.89199829101562,67.1780014038086,27086000.0,0.0,0.0,0.147003173828125,0.0,0.147003173828125,72.5703839849208,63.95000076293945,67.97250366210938,80.2485597098082,-19.751440290191802,0.7344986162809306,0.6726985347700383,0.028216304409259596,1864083540.0,1.0
1747,2019-12-10,GOOG,67.07499694824219,67.49874877929688,66.802001953125,67.23300170898438,21882000.0,0.0,0.0,0.05500030517578125,0.0,0.05500030517578125,73.05434346019126,63.95000076293945,67.97250366210938,81.61587519855853,-18.384124801441477,0.786120727931447,0.6953829734023201,0.023683969332104038,1885965540.0,1.0
1748,2019-12-11,GOOG,67.54199981689453,67.55999755859375,67.13349914550781,67.2509994506836,17008000.0,0.0,0.0,0.01799774169921875,0.0,0.01799774169921875,73.23266150036702,63.95000076293945,67.97250366210938,82.0633016429977,-17.9366983570023,0.8190424788139126,0.7201148744846387,0.024394725229874403,1902973540.0,1.0
1749,2019-12-12,GOOG,67.2969970703125,67.78874969482422,67.0250015258789,67.51349639892578,25620000.0,0.0,0.0,0.2624969482421875,0.0,0.2624969482421875,75.91496516086191,63.95000076293945,67.97250366210938,88.58901349012542,-11.410986509874583,0.8564419834526689,0.7473802962782449,0.03472129815698577,1928593540.0,1.0
1750,2019-12-13,GOOG,67.39749908447266,67.65464782714844,67.19349670410156,67.3915023803711,30992000.0,0.0,0.0,-0.1219940185546875,0.1219940185546875,0.0,72.04363209926109,63.95000076293945,67.97250366210938,85.55622466156144,-14.443775338438558,0.8662518504678047,0.7711546071161569,0.04489425831773852,1897601540.0,-1.0
1751,2019-12-16,GOOG,67.82499694824219,68.23400115966797,67.63349914550781,68.05850219726562,27946000.0,0.0,0.0,0.6669998168945312,0.0,0.6669998168945312,78.84837785048568,63.95000076293945,68.23400115966797,95.90338594421317,-4.096614055786826,0.9172737903548125,0.800378443763888,0.05086934502818852,1925547540.0,1.0
1752,2019-12-17,GOOG,68.14450073242188,68.25,67.56614685058594,67.75599670410156,37080000.0,0.0,0.0,-0.3025054931640625,0.3025054931640625,0.0,69.93975232966022,63.95000076293945,68.25,88.51154921980554,-11.488450780194444,0.9226634897819253,0.8248354529674955,0.02618620057957366,1888467540.0,-1.0
1753,2019-12-18,GOOG,67.83000183105469,68.02349853515625,67.55000305175781,67.63099670410156,30452000.0,0.0,0.0,-0.125,0.125,0.0,66.36472087697457,63.95000076293945,68.25,85.604571959841,-14.395428040159011,0.9063999951475239,0.8411483614035012,0.018439383214654548,1858015540.0,-1.0
1754,2019-12-19,GOOG,67.59100341796875,67.90499877929688,67.44924926757812,67.802001953125,29398000.0,0.0,0.0,0.1710052490234375,0.0,0.1710052490234375,68.87601890096369,63.95000076293945,68.25,89.58143892180668,-10.418561078193324,0.8969700406392889,0.8523126972506588,0.011502196647874108,1887413540.0,1.0
1755,2019-12-20,GOOG,68.1675033569336,68.18199920654297,67.44999694824219,67.47949981689453,66300000.0,0.0,0.0,-0.32250213623046875,0.32250213623046875,0.0,59.24969636073886,63.95000076293945,68.25,82.08138791131093,-17.918612088689066,0.8536333526997595,0.852576828340479,0.004488052737288584,1821113540.0,-1.0
1756,2019-12-23,GOOG,67.79350280761719,67.98999786376953,67.32550048828125,67.44200134277344,17662000.0,0.0,0.0,-0.03749847412109375,0.03749847412109375,0.0,58.1591618378915,65.24349975585938,68.25,73.12494290325527,-26.875057096744726,0.8069607604787876,0.8434536147681407,0.003108586980746564,1803451540.0,-1.0
1757,2019-12-24,GOOG,67.42500305175781,67.51300048828125,67.13899993896484,67.1780014038086,6950000.0,0.0,0.0,-0.26399993896484375,0.26399993896484375,0.0,50.59442095444451,65.8219985961914,68.25,55.848518270629675,-44.151481729370325,0.7401379565081356,0.8227904831161398,-0.001085456684231545,1796501540.0,-1.0
1758,2019-12-26,GOOG,67.30850219726562,68.06635284423828,67.22350311279297,68.0199966430664,13350000.0,0.0,0.0,0.8419952392578125,0.0,0.8419952392578125,66.5876624248897,66.6719970703125,68.25,85.42440241355303,-14.575597586446973,0.7465169986199811,0.807535786216908,0.007502207279383111,1809851540.0,1.0
1759,2019-12-27,GOOG,68.14949798583984,68.22650146484375,67.46549987792969,67.59449768066406,20768000.0,0.0,0.0,-0.42549896240234375,0.42549896240234375,0.0,56.014646703107076,66.802001953125,68.25,54.730441746754344,-45.269558253245656,0.7090645702410967,0.7878415430217459,0.003012179475495591,1789083540.0,-1.0
1760,2019-12-30,GOOG,67.5,67.6500015258789,66.70099639892578,66.80699920654297,21018000.0,0.0,0.0,-0.7874984741210938,0.7874984741210938,0.0,41.83064457099406,66.70099639892578,68.25,6.843289940944978,-93.15671005905503,0.6088206005529315,0.7520373545279831,-0.018388635516767726,1768065540.0,-1.0
1761,2019-12-31,GOOG,66.50550079345703,66.9000015258789,66.4542465209961,66.85099792480469,19236000.0,0.0,0.0,0.04399871826171875,0.0,0.04399871826171875,42.76496818695246,66.4542465209961,68.25,22.093868030742694,-77.9061319692573,0.5268536206237826,0.7070006077471431,-0.01335673332722287,1787301540.0,1.0
1762,2020-01-02,GOOG,67.07749938964844,68.40699768066406,67.07749938964844,68.36849975585938,28132000.0,0.0,0.0,1.5175018310546875,0.0,1.5175018310546875,65.08366497536863,66.4542465209961,68.40699768066406,98.0285288981094,-1.9714711018905964,0.5776847240611573,0.6811374310099461,0.010904808263946242,1815433540.0,1.0
1763,2020-01-03,GOOG,67.39299774169922,68.625,67.2771987915039,68.03299713134766,23728000.0,0.0,0.0,-0.33550262451171875,0.33550262451171875,0.0,59.19512718690625,66.4542465209961,68.625,72.7282312626307,-27.2717687373693,0.58416261882671,0.6617424685732989,0.003406907931455372,1791705540.0,-1.0
1764,2020-01-06,GOOG,67.5,69.82499694824219,67.5,69.71050262451172,34646000.0,0.0,0.0,1.6775054931640625,0.0,1.6775054931640625,73.189560878339,66.4542465209961,69.82499694824219,96.60329869559608,-3.396701304403919,0.7163988706609246,0.6726737489908241,0.033061934567846674,1826351540.0,1.0
1765,2020-01-07,GOOG,69.89700317382812,70.14949798583984,69.51899719238281,69.66699981689453,30054000.0,0.0,0.0,-0.0435028076171875,0.0435028076171875,0.0,72.4460975714743,66.4542465209961,70.14949798583984,86.94275143286589,-13.057248567134103,0.808368372536961,0.6998126737000515,0.032991287770547606,1796297540.0,-1.0
1766,2020-01-08,GOOG,69.60399627685547,70.5790023803711,69.54199981689453,70.21600341796875,30560000.0,0.0,0.0,0.5490036010742188,0.0,0.5490036010742188,75.99659401143705,66.4542465209961,70.5790023803711,91.19950429121042,-8.800495708789583,0.9150072339496091,0.7428515857499631,0.04522316756490952,1826857540.0,1.0
1767,2020-01-09,GOOG,71.02850341796875,71.36650085449219,70.51349639892578,70.99150085449219,30018000.0,0.0,0.0,0.7754974365234375,0.0,0.7754974365234375,80.16278952396632,66.4542465209961,71.36650085449219,92.36603045076639,-7.633969549233606,1.0499918099477128,0.8042796305895131,0.04368574475265996,1856875540.0,1.0
1768,2020-01-10,GOOG,71.37799835205078,71.74645233154297,70.9175033569336,71.48650360107422,36414000.0,0.0,0.0,0.49500274658203125,0.0,0.49500274658203125,82.41121163843317,66.4542465209961,71.74645233154297,95.0880834991206,-4.911916500879393,1.1832706363408363,0.8800778317397778,0.0575787387132769,1893289540.0,1.0
1769,2020-01-13,GOOG,71.80650329589844,72.0260009765625,71.3010025024414,71.96150207519531,33046000.0,0.0,0.0,0.47499847412109375,0.0,0.47499847412109375,84.37241098867631,66.4542465209961,72.0260009765625,98.84239512201134,-1.157604877988665,1.3120984197828136,0.966481949348385,0.07715513239438421,1926335540.0,1.0
1770,2020-01-14,GOOG,71.95050048828125,72.08999633789062,71.41850280761719,71.54399871826172,31178000.0,0.0,0.0,-0.41750335693359375,0.41750335693359375,0.0,75.800572716886,66.4542465209961,72.08999633789062,90.31189038959562,-9.688109610404378,1.364774068709508,1.0461403732206098,0.07020090857485495,1895157540.0,-1.0
1771,2020-01-15,GOOG,71.510498046875,72.06974792480469,71.510498046875,71.95999908447266,25654000.0,0.0,0.0,0.4160003662109375,0.0,0.4160003662109375,78.33152263524137,66.4542465209961,72.08999633789062,97.6933459141804,-2.3066540858196074,1.4236763975810476,1.1216475780926973,0.052531492448106176,1920811540.0,1.0
1772,2020-01-16,GOOG,72.37200164794922,72.59950256347656,72.0459976196289,72.58499908447266,23474000.0,0.0,0.0,0.625,0.0,0.625,81.65718827399547,66.4542465209961,72.59950256347656,99.76398902008887,-0.23601097991113273,1.503458263248703,1.1980097151238986,0.06690873759885507,1944285540.0,1.0
1773,2020-01-17,GOOG,73.14550018310547,74.06475067138672,72.91100311279297,74.01950073242188,47924000.0,0.0,0.0,1.4345016479492188,0.0,1.4345016479492188,86.95818177908536,66.4542465209961,74.06475067138672,99.40542783933019,-0.5945721606698184,1.6632651753518104,1.2910608071694811,0.061812753397004094,1992209540.0,1.0
1774,2020-01-21,GOOG,73.95600128173828,74.59249877929688,73.55999755859375,74.22000122070312,40734000.0,0.0,0.0,0.20050048828125,0.0,0.20050048828125,87.53895696109089,66.4542465209961,74.59249877929688,95.4228801618454,-4.577119838154602,1.7855097730692506,1.389950600349435,0.06535377461029213,2032943540.0,1.0
1775,2020-01-22,GOOG,74.55000305175781,75.16069793701172,74.24649810791016,74.29750061035156,32216000.0,0.0,0.0,0.0774993896484375,0.0,0.0774993896484375,87.78162583879944,67.07749938964844,75.16069793701172,89.32109211963216,-10.678907880367841,1.8671200528133483,1.4853844908422178,0.058127734329839864,2065159540.0,1.0
1776,2020-01-23,GOOG,74.38200378417969,74.7760009765625,74.1050033569336,74.3324966430664,27024000.0,0.0,0.0,0.03499603271484375,0.0,0.03499603271484375,87.90435762694287,67.2771987915039,75.16069793701172,89.49449630603132,-10.505503693968679,1.9125737155893887,1.5708223357916522,0.04706191231851964,2092183540.0,1.0
1777,2020-01-24,GOOG,74.67949676513672,74.77474975585938,73.26249694824219,73.33550262451172,35692000.0,0.0,0.0,-0.9969940185546875,0.9969940185546875,0.0,66.08400961700815,67.5,75.16069793701172,76.1745557975626,-23.8254442024374,1.8468575614056846,1.626029380914459,0.02586500850224427,2056491540.0,-1.0
1778,2020-01-27,GOOG,71.55000305175781,71.90350341796875,71.05999755859375,71.69499969482422,35104000.0,0.0,0.0,-1.6405029296875,1.6405029296875,0.0,44.915844909455195,69.51899719238281,75.16069793701172,38.56997385962089,-61.43002614037911,1.643457405629647,1.6295149858574969,-0.003703402134277556,2021387540.0,-1.0
1779,2020-01-28,GOOG,72.1500015258789,72.80000305175781,71.62349700927734,72.62799835205078,31548000.0,0.0,0.0,0.9329986572265625,0.0,0.9329986572265625,54.48353794020512,69.54199981689453,75.16069793701172,54.92372911274839,-45.07627088725161,1.5397966932120113,1.6115713273284,0.01515151030427897,2052935540.0,1.0
1780,2020-01-29,GOOG,72.94000244140625,73.27149963378906,72.33699798583984,72.93150329589844,21554000.0,0.0,0.0,0.30350494384765625,0.0,0.30350494384765625,57.26935532021217,70.51349639892578,75.16069793701172,52.03146188423261,-47.96853811576739,1.4652447152634096,1.582306004915402,0.013500614560671975,2074489540.0,1.0
1781,2020-01-30,GOOG,71.99800109863281,72.86399841308594,71.81999969482422,72.79199981689453,26788000.0,0.0,0.0,-0.13950347900390625,0.13950347900390625,0.0,55.46882560819768,70.9175033569336,75.16069793701172,44.17653785574039,-55.82346214425961,1.3790086178017873,1.5416465274926794,0.0028518390167777685,2047701540.0,-1.0
1782,2020-01-31,GOOG,73.44499969482422,73.50650024414062,71.42649841308594,71.71150207519531,48344000.0,0.0,0.0,-1.0804977416992188,1.0804977416992188,0.0,43.30210054788683,71.05999755859375,75.16069793701172,15.887640073155257,-84.11235992684473,1.2095359738111,1.4752244167563637,-0.031180954132207672,1999357540.0,-1.0
1783,2020-02-03,GOOG,73.0999984741211,74.5,72.94950103759766,74.2969970703125,60736000.0,0.0,0.0,2.5854949951171875,0.0,2.5854949951171875,64.68760936896517,71.05999755859375,75.16069793701172,78.93772314493188,-21.062276855068124,1.2692246885421525,1.4340244711135217,0.0010374002740907162,2060093540.0,1.0
1784,2020-02-04,GOOG,72.85350036621094,73.4749984741211,71.31500244140625,72.35350036621094,78660000.0,0.0,0.0,-1.9434967041015625,1.9434967041015625,0.0,48.74192096343658,71.05999755859375,75.16069793701172,31.543460586023475,-68.45653941397653,1.1464884779496316,1.3765172724807437,-0.026165082649762472,1981433540.0,-1.0
1785,2020-02-05,GOOG,73.12100219726562,73.19200134277344,71.52799987792969,72.4114990234375,39724000.0,0.0,0.0,0.0579986572265625,0.0,0.0579986572265625,49.173336528936,71.05999755859375,75.16069793701172,32.95782037519047,-67.04217962480953,1.041888906945644,1.309591599373724,-0.025843308194708592,2021157540.0,1.0
1786,2020-02-06,GOOG,72.5165023803711,74.0999984741211,72.47850036621094,73.8115005493164,33588000.0,0.0,0.0,1.4000015258789062,0.0,1.4000015258789062,58.825421253868306,71.05999755859375,75.16069793701172,67.09836703027237,-32.90163296972764,1.0597453316485854,1.2596223458286964,0.0064906887901465815,2054745540.0,1.0
1787,2020-02-07,GOOG,73.36499786376953,74.29199981689453,73.31749725341797,73.96150207519531,23446000.0,0.0,0.0,0.15000152587890625,0.0,0.15000152587890625,59.76990748289835,71.05999755859375,75.16069793701172,70.75631596671175,-29.243684033288247,1.0736244717948011,1.2224227710219173,0.0316131165355833,2078191540.0,1.0
1788,2020-02-10,GOOG,73.71600341796875,75.4749984741211,73.71600341796875,75.43399810791016,28398000.0,0.0,0.0,1.4724960327148438,0.0,1.4724960327148438,68.06679705349339,71.05999755859375,75.4749984741211,99.07133957624468,-0.9286604237553203,1.1897274762650198,1.215883712070538,0.038635234613761726,2106589540.0,1.0
1789,2020-02-11,GOOG,75.59049987792969,76.48149871826172,75.28189849853516,75.43949890136719,26892000.0,0.0,0.0,0.00550079345703125,0.0,0.00550079345703125,68.09515925716549,71.05999755859375,76.48149871826172,80.78023436301642,-19.219765636983592,1.2675720305130227,1.226221375759035,0.034388371171965026,2133481540.0,1.0
1790,2020-02-12,GOOG,75.7239990234375,76.03475189208984,75.40550231933594,75.91349792480469,23352000.0,0.0,0.0,0.4739990234375,0.0,0.4739990234375,70.68398293115598,71.05999755859375,76.48149871826172,89.52318229344772,-10.476817706552286,1.351927976246344,1.251362695856497,0.042882433725713875,2156833540.0,1.0
1791,2020-02-13,GOOG,75.6344985961914,76.35900115966797,75.2300033569336,75.73300170898438,18590000.0,0.0,0.0,-0.1804962158203125,0.1804962158203125,0.0,68.25070567158598,71.05999755859375,76.48149871826172,86.19391590569752,-13.806084094302475,1.3882136717697477,1.2787328910391471,0.056078864860091615,2138243540.0,-1.0
1792,2020-02-14,GOOG,75.77999877929688,76.03700256347656,75.36699676513672,76.03700256347656,23956000.0,0.0,0.0,0.3040008544921875,0.0,0.3040008544921875,70.2415422596904,71.31500244140625,76.48149871826172,91.39656488718707,-8.603435112812932,1.42507331709065,1.3080009762494478,0.023419593816387696,2162199540.0,1.0
1793,2020-02-18,GOOG,75.75,76.58149719238281,75.62950134277344,75.9834976196289,22414000.0,0.0,0.0,-0.05350494384765625,0.05350494384765625,0.0,69.35832580158859,71.31500244140625,76.58149719238281,88.64520708687652,-11.35479291312347,1.4334436041765457,1.3330895018348674,0.050170305998259224,2139785540.0,-1.0
1794,2020-02-19,GOOG,76.25350189208984,76.60530090332031,76.06999969482422,76.33450317382812,18986000.0,0.0,0.0,0.35100555419921875,0.0,0.35100555419921875,72.02130935258299,71.31500244140625,76.60530090332031,94.88123909375406,-5.118760906245944,1.4516664248303641,1.3568048864339668,0.05417653554058943,2158771540.0,1.0
1795,2020-02-20,GOOG,76.0999984741211,76.48200225830078,75.34100341796875,75.90750122070312,21932000.0,0.0,0.0,-0.427001953125,0.427001953125,0.0,64.19075904479865,71.31500244140625,76.60530090332031,86.80982391370186,-13.19017608629815,1.4153375225311606,1.3685114136534058,0.028396667941824383,2136839540.0,-1.0
1796,2020-02-21,GOOG,75.40149688720703,75.61074829101562,74.02200317382812,74.25550079345703,34634000.0,0.0,0.0,-1.6520004272460938,1.6520004272460938,0.0,43.2157704944998,71.31500244140625,76.60530090332031,55.582844204727365,-44.41715579527264,1.2389619949377249,1.3426015299102698,0.003975023627329932,2102205540.0,-1.0
1797,2020-02-24,GOOG,71.30549621582031,71.84850311279297,70.56950378417969,71.07949829101562,57342000.0,0.0,0.0,-3.1760025024414062,3.1760025024414062,0.0,25.054807366622114,70.56950378417969,76.60530090332031,8.449497171113505,-91.5505028288865,0.8333004902758887,1.2407413219833936,-0.05772595813714276,2044863540.0,-1.0
1798,2020-02-25,GOOG,71.6500015258789,71.90699768066406,69.12000274658203,69.42250061035156,49566000.0,0.0,0.0,-1.6569976806640625,1.6569976806640625,0.0,19.996180596081956,69.12000274658203,76.60530090332031,4.041226647695016,-95.95877335230499,0.3737960720374218,1.0673522719941992,-0.07975925580951304,1995297540.0,-1.0
1799,2020-02-26,GOOG,69.80699920654297,70.78500366210938,68.94999694824219,69.65899658203125,44048000.0,0.0,0.0,0.2364959716796875,0.0,0.2364959716796875,22.57070279673266,68.94999694824219,76.60530090332031,9.261547783726465,-90.73845221627353,0.02839147916932916,0.8595601134292252,-0.0823898452020847,2039345540.0,1.0
1800,2020-02-27,GOOG,68.10299682617188,68.58519744873047,65.8584976196289,65.90450286865234,59566000.0,0.0,0.0,-3.7544937133789062,3.7544937133789062,0.0,14.200146933419276,65.8584976196289,76.60530090332031,0.42808310349601203,-99.57191689650399,-0.5420519764717255,0.579237695449035,-0.129778281839396,1979779540.0,-1.0
1801,2020-02-28,GOOG,63.875,67.05699920654297,63.54999923706055,66.96649932861328,75782000.0,0.0,0.0,1.0619964599609375,0.0,1.0619964599609375,23.464055450056165,63.54999923706055,76.60530090332031,26.169445784484374,-73.83055421551563,-0.8980857129859601,0.28377301376203595,-0.11929064704110504,2055561540.0,1.0
1802,2020-03-02,GOOG,67.58049774169922,69.54350280761719,66.34075164794922,69.45549774169922,48630000.0,0.0,0.0,2.4889984130859375,0.0,2.4889984130859375,40.760861169995664,63.54999923706055,76.60530090332031,45.23448523522741,-54.7655147647726,-0.9682423486642051,0.03336994127678766,-0.085913390175965,2104191540.0,1.0
1803,2020-03-03,GOOG,69.97100067138672,70.50749969482422,66.5999984741211,67.06950378417969,48046000.0,0.0,0.0,-2.3859939575195312,2.3859939575195312,0.0,32.60939352003817,63.54999923706055,76.60530090332031,26.9584314257171,-73.0415685742829,-1.202509973243707,-0.21380604162731134,-0.12137367775290653,2056145540.0,-1.0
1804,2020-03-04,GOOG,67.96150207519531,69.40450286865234,67.15550231933594,69.32599639892578,38266000.0,0.0,0.0,2.2564926147460938,0.0,2.2564926147460938,44.68132385180194,63.54999923706055,76.60530090332031,44.24254076635219,-55.7574592336478,-1.1923440577266007,-0.40951364484716934,-0.08670427449115259,2094411540.0,1.0
1805,2020-03-05,GOOG,67.51000213623047,67.94550323486328,65.25499725341797,65.9520034790039,51226000.0,0.0,0.0,-3.373992919921875,3.373992919921875,0.0,34.13250795384664,63.54999923706055,76.60530090332031,18.398688160160404,-81.6013118398396,-1.4399417749907144,-0.6155992708758785,-0.11182332925811711,2043185540.0,-1.0
1806,2020-03-06,GOOG,63.85300064086914,65.31099700927734,63.0525016784668,64.92050170898438,53212000.0,0.0,0.0,-1.0315017700195312,1.0315017700195312,0.0,31.508422028253065,63.0525016784668,76.60530090332031,13.783130698874263,-86.21686930112573,-1.6998040391166853,-0.8324402245240399,-0.08664940988771364,1989973540.0,-1.0
1807,2020-03-09,GOOG,60.26499938964844,62.73799896240234,60.0,60.77799987792969,67308000.0,0.0,0.0,-4.1425018310546875,4.1425018310546875,0.0,23.232077828376703,60.0,76.60530090332031,4.685250104526094,-95.31474989547391,-2.2144848304206874,-1.1088491457033696,-0.12452015782233139,1922665540.0,-1.0
1808,2020-03-10,GOOG,63.0,64.05750274658203,60.9384994506836,64.01950073242188,52228000.0,0.0,0.0,3.2415008544921875,0.0,3.2415008544921875,37.94831579372765,60.0,76.48200225830078,24.387211392338852,-75.61278860766116,-2.333907207517953,-1.3538607580662865,-0.08095861448374786,1974893540.0,1.0
1809,2020-03-11,GOOG,62.48500061035156,63.04800033569336,59.80350112915039,60.77050018310547,52170000.0,0.0,0.0,-3.2490005493164062,3.2490005493164062,0.0,31.061856612989786,59.80350112915039,75.61074829101562,6.117441222074075,-93.88255877792592,-2.6600540458442623,-1.615099415621882,-0.07790063595167296,1922723540.0,-1.0
1810,2020-03-12,GOOG,56.29999923706055,59.69350051879883,55.665000915527344,55.74549865722656,84534000.0,0.0,0.0,-5.025001525878906,5.025001525878906,0.0,23.46335575262863,55.665000915527344,71.90699768066406,0.4956148117946085,-99.50438518820539,-3.2861230118869003,-1.949304134874886,-0.1675614043422491,1838189540.0,-1.0
1811,2020-03-13,GOOG,58.95000076293945,60.98799896240234,55.85715103149414,60.98649978637695,74002000.0,0.0,0.0,5.241001129150391,0.0,5.241001129150391,40.870597444254145,55.665000915527344,71.90699768066406,32.76382176280291,-67.23617823719708,-3.321098630114733,-2.2236630339228554,-0.121934162603196,1912191540.0,1.0
1812,2020-03-16,GOOG,54.79999923706055,57.61334991455078,53.72200012207031,54.21649932861328,85048000.0,0.0,0.0,-6.770000457763672,6.770000457763672,0.0,30.523523380908173,53.72200012207031,70.78500366210938,2.8980783212205594,-97.10192167877943,-3.8507109187460102,-2.5490726108874866,-0.1916370888463046,1827143540.0,-1.0
1813,2020-03-17,GOOG,54.65549850463867,56.542999267578125,52.80049896240234,55.9900016784668,77230000.0,0.0,0.0,1.7735023498535156,0.0,1.7735023498535156,35.46221178306443,52.80049896240234,70.50749969482422,18.0126649581282,-81.9873350418718,-4.080290605078531,-2.8553162097256957,-0.19236643413993004,1904373540.0,1.0
1814,2020-03-18,GOOG,52.82550048828125,55.32500076293945,51.86399841308594,54.84000015258789,84668000.0,0.0,0.0,-1.1500015258789062,1.1500015258789062,0.0,33.67140146434802,51.86399841308594,70.50749969482422,15.962676186886698,-84.03732381311329,-4.305399704923943,-3.1453329087653454,-0.16848621331046554,1819705540.0,-1.0
1815,2020-03-19,GOOG,54.65250015258789,57.89849853515625,53.005401611328125,55.76449966430664,73022000.0,0.0,0.0,0.92449951171875,0.0,0.92449951171875,36.639370911213184,51.86399841308594,70.50749969482422,20.921506064106797,-79.0784939358932,-4.358953600393072,-3.388057047090891,-0.14103406171629496,1892727540.0,1.0
1816,2020-03-20,GOOG,56.7859992980957,57.199501037597656,53.27450180053711,53.61600112915039,72036000.0,0.0,0.0,-2.14849853515625,2.14849853515625,0.0,32.71409815784705,51.86399841308594,70.50749969482422,9.397391024295304,-90.6026089757047,-4.522627292235853,-3.6149710961198833,-0.11783867128177794,1820691540.0,-1.0
1817,2020-03-23,GOOG,53.06600189208984,53.56600189208984,50.67679977416992,52.83100128173828,80882000.0,0.0,0.0,-0.7849998474121094,0.7849998474121094,0.0,31.300407960415612,50.67679977416992,69.40450286865234,11.502753416691194,-88.49724658330881,-4.66194282447335,-3.8243654417905772,-0.1747670525805478,1739809540.0,-1.0
1818,2020-03-24,GOOG,55.1884994506836,56.75,54.53099822998047,56.72299957275391,66890000.0,0.0,0.0,3.891998291015632,0.0,3.891998291015632,44.917488427783425,50.67679977416992,67.94550323486328,35.01247104246256,-64.98752895753745,-4.407492818544512,-3.9409909171413644,-0.06660304914648019,1806699540.0,1.0
1819,2020-03-25,GOOG,56.32350158691406,57.44499969482422,54.30049896240234,55.1245002746582,81630000.0,0.0,0.0,-1.5984992980957102,1.5984992980957102,0.0,41.06055310068246,50.67679977416992,65.31099700927734,30.392514389639718,-69.60748561036027,-4.2854251759293405,-4.00987776889896,-0.011139883892452351,1725069540.0,-1.0
1820,2020-03-26,GOOG,55.59000015258789,58.49850082397461,54.67649841308594,58.087501525878906,71434000.0,0.0,0.0,2.963001251220703,0.0,2.963001251220703,50.20539987251854,50.67679977416992,64.05750274658203,55.383500904161195,-44.616499095838805,-3.9045866076755757,-3.988819536654283,-0.04753508187308064,1796503540.0,1.0
1821,2020-03-27,GOOG,56.28350067138672,57.53350067138672,55.295501708984375,55.53549957275391,64170000.0,0.0,0.0,-2.552001953124993,2.552001953124993,0.0,43.49823360339382,50.67679977416992,64.05750274658203,36.31124469769262,-63.68875530230738,-3.7652906019405705,-3.9441137497115406,0.024328391918961856,1732333540.0,-1.0
1822,2020-03-30,GOOG,56.25199890136719,57.58150100708008,54.82400131225586,57.34099960327149,51482000.0,0.0,0.0,1.8055000305175781,0.0,1.8055000305175781,49.05422102212953,50.67679977416992,63.04800033569336,53.86865887396877,-46.13134112603123,-3.4692177676403304,-3.8491345532972985,0.02412927101811957,1783815540.0,1.0
1823,2020-03-31,GOOG,57.3650016784668,58.76549911499024,56.90700149536133,58.14049911499024,49728000.0,0.0,0.0,0.79949951171875,0.0,0.79949951171875,51.49139548568525,50.67679977416992,60.98799896240234,72.3843968540363,-27.615603145963707,-3.133938887779223,-3.7060954201936838,0.06018415304921554,1833543540.0,1.0
1824,2020-04-01,GOOG,56.09999847412109,56.484500885009766,54.872501373291016,55.28099822998047,46884000.0,0.0,0.0,-2.8595008850097727,2.8595008850097727,0.0,43.00183283528762,50.67679977416992,60.98799896240234,44.65240532900438,-55.347594670995626,-3.0636499341249532,-3.5776063229799373,-0.008670416434053418,1786659540.0,-1.0
1825,2020-04-02,GOOG,54.91299819946289,56.34299850463867,54.81999969482422,56.04199981689453,39298000.0,0.0,0.0,0.7610015869140625,0.0,0.7610015869140625,45.74849761813091,50.67679977416992,58.76549911499024,66.32957681649341,-33.6704231835066,-2.9129601722303136,-3.4446770928300126,0.045247661829542096,1825957540.0,1.0
1826,2020-04-03,GOOG,55.95074844360352,56.17699813842773,53.990501403808594,54.89400100708008,46268000.0,0.0,0.0,-1.1479988098144531,1.1479988098144531,0.0,42.20815781146678,50.67679977416992,58.76549911499024,52.13695126023149,-47.8630487397685,-2.8532805182840306,-3.326397777920816,0.03904903702922824,1779689540.0,-1.0
1827,2020-04-06,GOOG,56.900001525878906,59.733001708984375,56.547000885009766,59.34600067138672,53294000.0,0.0,0.0,4.451999664306641,0.0,4.451999664306641,57.07299845309012,50.67679977416992,59.733001708984375,95.72667393700752,-4.27332606299249,-2.418861664982188,-3.144890555333091,0.046242284759086205,1832983540.0,1.0
1828,2020-04-07,GOOG,61.04999923706055,61.25,59.11149978637695,59.32550048828125,47746000.0,0.0,0.0,-0.02050018310546875,0.02050018310546875,0.0,56.9951084309044,50.67679977416992,61.25,81.79832528833377,-18.20167471166623,-2.0525749806773987,-2.9264274404019526,0.07620931151650412,1785237540.0,-1.0
1829,2020-04-08,GOOG,60.32500076293945,60.95349884033203,59.40800094604492,60.51399993896485,39502000.0,0.0,0.0,1.1884994506836009,0.0,1.1884994506836009,60.59273881213452,50.67679977416992,61.25,93.03900384637454,-6.96099615362545,-1.6473979928549838,-2.6706215508925593,0.04177315858567088,1824739540.0,1.0
1830,2020-04-09,GOOG,61.20399856567383,61.27849960327149,59.83675003051758,60.5724983215332,43508000.0,0.0,0.0,0.05849838256835227,0.0,0.05849838256835227,60.77908016307727,50.67679977416992,61.27849960327149,93.34067844667399,-6.659321553326017,-1.3065113309333256,-2.3977995069007125,0.09069872041360871,1868247540.0,1.0
1831,2020-04-13,GOOG,60.45899963378906,61.0255012512207,59.37990188598633,60.87799835205078,34796000.0,0.0,0.0,0.3055000305175781,0.0,0.3055000305175781,61.86566702120228,53.990501403808594,61.27849960327149,94.50464667718735,-5.4953533228126465,-1.000175495586653,-2.1182747046379005,0.061683590681204103,1903043540.0,1.0
1832,2020-04-14,GOOG,62.25450134277344,64.10350036621094,61.84650039672852,63.46149826049805,49408000.0,0.0,0.0,2.5834999084472656,0.0,2.5834999084472656,69.98073007220623,53.990501403808594,64.10350036621094,93.6517139169133,-6.348286083086703,-0.5426796148481756,-1.8031556866799554,0.0915196674693819,1952451540.0,1.0
1833,2020-04-15,GOOG,62.28049850463867,64.02300262451172,62.02000045776367,63.12350082397461,33434000.0,0.0,0.0,-0.3379974365234375,0.3379974365234375,0.0,67.80264303485299,53.990501403808594,64.10350036621094,90.30950615262864,-9.690493847371355,-0.2050210466435729,-1.4835287586726789,0.141866153743601,1919017540.0,-1.0
1834,2020-04-16,GOOG,63.70500183105469,63.95000076293945,62.13100051879883,63.17350006103516,50362000.0,0.0,0.0,0.04999923706055398,0.0,0.04999923706055398,67.97278592350798,53.990501403808594,64.10350036621094,90.80391179082201,-9.196088209177987,0.06585122993915604,-1.173652760950312,0.12725277947684432,1969379540.0,1.0
1835,2020-04-17,GOOG,64.24250030517578,64.72149658203125,63.561500549316406,64.1624984741211,38980000.0,0.0,0.0,0.9889984130859304,0.0,0.9889984130859304,71.41977103170954,53.990501403808594,64.72149658203125,94.79080832088546,-5.209191679114531,0.3562171179929976,-0.8676787851616501,0.16884354022301262,2008359540.0,1.0
1836,2020-04-20,GOOG,63.54999923706055,64.08000183105469,63.06850051879883,63.33050155639648,33910000.0,0.0,0.0,-0.8319969177246165,0.8319969177246165,0.0,64.66425467209211,53.990501403808594,64.72149658203125,87.03759527860342,-12.962404721396577,0.5132821808036638,-0.5914865919685872,0.06714017524235394,1974449540.0,-1.0
1837,2020-04-21,GOOG,62.34999847412109,62.7135009765625,60.48550033569336,60.81700134277344,43060000.0,0.0,0.0,-2.5135002136230398,2.5135002136230398,0.0,48.6299804335581,53.990501403808594,64.72149658203125,63.61478898824272,-36.38521101175728,0.42998234481584063,-0.3871928046117016,0.02514097381760494,1931389540.0,-1.0
1838,2020-04-22,GOOG,62.277000427246094,64.28064727783203,62.09999847412109,63.16049957275391,41848000.0,0.0,0.0,2.343498229980476,0.0,2.343498229980476,59.44766880133225,53.990501403808594,64.72149658203125,85.45338075964098,-14.54661924035903,0.5467645845980016,-0.20040132676976094,0.04373367545457829,1973237540.0,1.0
1839,2020-04-23,GOOG,63.57749938964844,64.66549682617188,63.28350067138672,63.81549835205078,31324000.0,0.0,0.0,0.6549987792968679,0.0,0.6549987792968679,62.0265345562497,53.990501403808594,64.72149658203125,91.55718351435765,-8.442816485642355,0.6842803208430652,-0.02346499724719567,0.0535391492902102,2004561540.0,1.0
1840,2020-04-24,GOOG,63.05849838256836,64.0199966430664,62.47249984741211,63.96549987792969,32792000.0,0.0,0.0,0.15000152587890625,0.0,0.15000152587890625,62.65409987406647,56.547000885009766,64.72149658203125,90.75176338551351,-9.248236614486476,0.7961884373918622,0.14046568968061596,0.05071621290871331,2037353540.0,1.0
1841,2020-04-27,GOOG,64.80000305175781,64.80750274658203,63.45000076293945,63.79399871826172,32012000.0,0.0,0.0,-0.17150115966796875,0.17150115966796875,0.0,61.317255957537476,59.11149978637695,64.80750274658203,82.20675032296995,-17.793249677030058,0.8611113599862961,0.28459482374175205,0.005239404471650166,2005341540.0,-1.0
1842,2020-04-28,GOOG,64.39649963378906,64.40249633789062,61.61000061035156,61.68349838256836,59026000.0,0.0,0.0,-2.1105003356933594,2.1105003356933594,0.0,47.05966095037421,59.37990188598633,64.80750274658203,42.442260507881215,-57.557739492118785,0.7338046616219458,0.37443679131779084,-0.02281246164438544,1946315540.0,-1.0
1843,2020-04-29,GOOG,67.072998046875,67.99949645996094,66.26699829101562,67.0739974975586,75872000.0,0.0,0.0,5.390499114990234,0.0,5.390499114990234,68.5862378335114,59.37990188598633,67.99949645996094,89.26284810196607,-10.737151898033922,1.0557118255052487,0.5106917981552825,0.06174262044615153,2022187540.0,1.0
1844,2020-04-30,GOOG,66.24400329589844,67.64099884033203,66.12449645996094,67.43299865722656,53378000.0,0.0,0.0,0.35900115966796875,0.0,0.35900115966796875,69.53807015685088,59.37990188598633,67.99949645996094,93.42779062434307,-6.572209375656926,1.3245256580881275,0.6734585701418516,0.05097214511408987,2075565540.0,1.0
1845,2020-05-01,GOOG,66.42500305175781,67.60350036621094,65.55000305175781,66.03050231933594,41450000.0,0.0,0.0,-1.402496337890625,1.402496337890625,0.0,61.181731157063794,60.48550033569336,67.99949645996094,73.79564604424218,-26.204353955757814,1.4081604269399932,0.8203989415014801,0.04263349723411047,2034115540.0,-1.0
1846,2020-05-04,GOOG,65.4114990234375,66.38300323486328,64.94999694824219,66.33999633789062,30080000.0,0.0,0.0,0.3094940185546875,0.0,0.3094940185546875,62.33422536309754,60.48550033569336,67.99949645996094,77.91454647267241,-22.085453527327594,1.4823278122563295,0.9527847156524502,0.0908133395789903,2064195540.0,1.0
1847,2020-05-05,GOOG,66.89600372314453,68.6969985961914,66.87300109863281,67.55549621582031,33030000.0,0.0,0.0,1.2154998779296875,0.0,1.2154998779296875,66.80085599229768,60.48550033569336,68.6969985961914,86.09873199556814,-13.901268004431861,1.6205064911594604,1.0863290707538524,0.06958457695547282,2097225540.0,1.0
1848,2020-05-06,GOOG,68.08450317382812,68.55599975585938,67.364501953125,67.36499786376953,24308000.0,0.0,0.0,-0.19049835205078125,0.19049835205078125,0.0,65.39841508898022,60.48550033569336,68.6969985961914,83.77883438361606,-16.221165616383946,1.695102379695932,1.2080837325422684,0.055621277015455384,2072917540.0,-1.0
1849,2020-05-07,GOOG,68.2969970703125,68.87999725341797,67.76349639892578,68.62799835205078,27952000.0,0.0,0.0,1.26300048828125,0.0,1.26300048828125,70.18663170568796,60.48550033569336,68.87999725341797,96.99804641258366,-3.0019535874163337,1.8349812215780403,1.333463230349423,0.0728908315110317,2100869540.0,1.0
1850,2020-05-08,GOOG,69.15650177001953,69.93800354003906,68.77400207519531,69.41850280761719,27738000.0,0.0,0.0,0.7905044555664062,0.0,0.7905044555664062,72.89538669140214,60.48550033569336,69.93800354003906,94.50409355922737,-5.495906440772632,1.9867216243903698,1.4641149091576124,0.08816666461363232,2128607540.0,1.0
1851,2020-05-11,GOOG,68.91400146484375,70.82649993896484,68.85759735107422,70.16300201416016,28242000.0,0.0,0.0,0.7444992065429688,0.0,0.7444992065429688,75.33104955759505,61.61000061035156,70.82649993896484,92.8009768009768,-7.199023199023199,2.142356103191034,1.5997631479642969,0.13746794286862452,2156849540.0,1.0
1852,2020-05-12,GOOG,70.35600280761719,70.75,68.7385025024414,68.78700256347656,27812000.0,0.0,0.0,-1.3759994506835938,1.3759994506835938,0.0,63.21652191683516,61.61000061035156,70.82649993896484,77.87123610852424,-22.128763891475757,2.130111295892675,1.7058327775499726,0.025539033453020554,2129037540.0,-1.0
1853,2020-05-13,GOOG,68.85250091552734,69.27410125732422,66.41999816894531,67.46649932861328,36252000.0,0.0,0.0,-1.3205032348632812,1.3205032348632812,0.0,53.660889223262345,61.61000061035156,70.82649993896484,63.54363527244883,-36.45636472755117,1.9909037239075076,1.7628469668214797,0.0004967993720257358,2092785540.0,-1.0
1854,2020-05-14,GOOG,66.7509994506836,67.87100219726562,66.19550323486328,67.80650329589844,32062000.0,0.0,0.0,0.34000396728515625,0.0,0.34000396728515625,55.65243832321536,61.61000061035156,70.82649993896484,67.23271455474845,-32.767285445251545,1.886272424455754,1.7875320583483347,0.02689667523614192,2124847540.0,1.0
1855,2020-05-15,GOOG,67.5,68.7239990234375,66.94999694824219,68.65950012207031,34154000.0,0.0,0.0,0.852996826171875,0.0,0.852996826171875,60.55925436647376,61.61000061035156,70.82649993896484,76.48782103019391,-23.51217896980609,1.8508456839593492,1.8001947834705376,0.0349638817036666,2159001540.0,1.0
1856,2020-05-18,GOOG,68.0875015258789,69.61624908447266,67.7125015258789,69.1969985961914,36448000.0,0.0,0.0,0.5374984741210938,0.0,0.5374984741210938,63.495886605119864,64.94999694824219,70.82649993896484,72.27090081727242,-27.729099182727573,1.844874803341213,1.8091307874446727,0.024298576316084786,2195449540.0,1.0
1857,2020-05-19,GOOG,69.349853515625,69.5999984741211,68.67424774169922,68.67424774169922,25612000.0,0.0,0.0,-0.5227508544921875,0.5227508544921875,0.0,58.59962405520322,64.94999694824219,70.82649993896484,63.37528968055619,-36.624710319443814,1.777471625822315,1.802798955120201,0.019435165433796087,2169837540.0,-1.0
1858,2020-05-20,GOOG,69.47899627685547,70.52100372314453,69.36250305175781,70.33599853515625,33108000.0,0.0,0.0,1.6617507934570312,0.0,1.6617507934570312,67.72751698383308,64.94999694824219,70.82649993896484,91.65317528838227,-8.346824711617733,1.8369680984599626,1.8096327837881534,0.02488780416330516,2202945540.0,1.0
1859,2020-05-21,GOOG,70.4000015258789,70.77449798583984,69.67250061035156,70.13999938964844,27700000.0,0.0,0.0,-0.1959991455078125,0.1959991455078125,0.0,65.75451279888597,64.94999694824219,70.82649993896484,88.31787288460166,-11.682127115398346,1.8470127751189267,1.8171087820543081,0.010393433347745562,2175245540.0,-1.0
1860,2020-05-22,GOOG,69.83550262451172,70.63800048828125,69.59149932861328,70.52100372314453,26188000.0,0.0,0.0,0.38100433349609375,0.0,0.38100433349609375,67.85490869168855,66.19550323486328,70.82649993896484,93.40322968596065,-6.596770314039348,1.8642274654853992,1.8265325187405266,0.005102428612050014,2201433540.0,1.0
1861,2020-05-26,GOOG,71.8635025024414,72.05000305175781,70.60649871826172,70.85099792480469,41212000.0,0.0,0.0,0.32999420166015625,0.0,0.32999420166015625,69.71143379842559,66.19550323486328,72.05000305175781,79.51993911600928,-20.480060883990717,1.8827943248452925,1.83778487996148,0.03000560112244277,2242645540.0,1.0
1862,2020-05-27,GOOG,70.86250305175781,71.08699798583984,69.56449890136719,70.89199829101562,33716000.0,0.0,0.0,0.0410003662109375,0.0,0.0410003662109375,69.96015521415183,66.19550323486328,72.05000305175781,80.22026138935911,-19.779738610640884,1.8791553484307428,1.8460589736553328,0.050773331897917995,2276361540.0,1.0
1863,2020-05-28,GOOG,69.84300231933594,72.04199981689453,69.80000305175781,70.83650207519531,33844000.0,0.0,0.0,-0.0554962158203125,0.0554962158203125,0.0,69.0742763281706,66.19550323486328,72.05000305175781,79.27233727020268,-20.72766272979732,1.8504623742122277,1.846939653766712,0.04468596125764468,2242517540.0,-1.0
1864,2020-05-29,GOOG,70.84700012207031,71.62850189208984,70.6675033569336,71.44599914550781,36418000.0,0.0,0.0,0.6094970703125,0.0,0.6094970703125,73.35057124893568,66.19550323486328,72.05000305175781,89.68308266904364,-10.316917330956356,1.8555150823655424,1.8486547394864783,0.040584318535429986,2278935540.0,1.0
1865,2020-06-01,GOOG,70.91950225830078,71.89800262451172,70.9000015258789,71.59100341796875,24342000.0,0.0,0.0,0.1450042724609375,0.0,0.1450042724609375,74.3251410020437,66.19550323486328,72.05000305175781,92.15988302767538,-7.840116972324629,1.849895578210564,1.8489029072312955,0.034596945970848836,2303277540.0,1.0
1866,2020-06-02,GOOG,71.52749633789062,71.98049926757812,70.94149780273438,71.96099853515625,25562000.0,0.0,0.0,0.3699951171875,0.0,0.3699951171875,76.82080686922095,66.19550323486328,72.05000305175781,98.47972466674746,-1.520275333252537,1.8539266817028448,1.8499076621256054,0.04786001887955593,2328839540.0,1.0
1867,2020-06-03,GOOG,71.91500091552734,72.32759857177734,71.48885345458984,71.81900024414062,25124000.0,0.0,0.0,-0.141998291015625,0.141998291015625,0.0,73.65058537183756,66.19550323486328,72.32759857177734,91.70596183371363,-8.294038166286365,1.8246300850792778,1.8448521467163401,0.02108453338077121,2303715540.0,-1.0
1868,2020-06-04,GOOG,71.5199966430664,71.947998046875,70.23650360107422,70.60900115966797,29686000.0,0.0,0.0,-1.2099990844726562,1.2099990844726562,0.0,52.39230680345429,66.94999694824219,72.32759857177734,68.04156327631435,-31.958436723685647,1.6843592623527002,1.8127535698436124,0.00668665204021579,2274029540.0,-1.0
1869,2020-06-05,GOOG,70.65850067138672,72.25250244140625,70.30000305175781,71.91950225830078,34698000.0,0.0,0.0,1.3105010986328125,0.0,1.3105010986328125,65.01247978254008,67.7125015258789,72.32759857177734,91.15736225223587,-8.84263774776413,1.6598068904509944,1.782164233965089,0.019830950515771884,2308727540.0,1.0
1870,2020-06-08,GOOG,71.11699676513672,72.39949798583984,71.11699676513672,72.33049774169922,28084000.0,0.0,0.0,0.4109954833984375,0.0,0.4109954833984375,68.07492071097302,68.67424774169922,72.39949798583984,98.14776888481104,-1.8522311151889503,1.6544414878879792,1.756619684749667,0.020881848671556513,2336811540.0,1.0
1871,2020-06-09,GOOG,72.26799774169922,73.4000015258789,72.1604995727539,72.80799865722656,28184000.0,0.0,0.0,0.47750091552734375,0.0,0.47750091552734375,71.42756085163208,69.36250305175781,73.4000015258789,85.33738470870347,-14.662615291296536,1.6694750319859253,1.739190754196919,0.027027032844322507,2364995540.0,1.0
1872,2020-06-10,GOOG,72.97699737548828,73.71295166015625,72.8134994506836,73.2925033569336,30504000.0,0.0,0.0,0.48450469970703125,0.0,0.48450469970703125,74.55589943787272,69.56449890136719,73.71295166015625,89.86493693746712,-10.135063062532874,1.7008780407915935,1.7315282115158537,0.03467140823993753,2395499540.0,1.0
1873,2020-06-11,GOOG,72.1240005493164,72.72374725341797,70.0999984741211,70.19200134277344,39826000.0,0.0,0.0,-3.1005020141601562,3.1005020141601562,0.0,41.22661273388609,69.56449890136719,73.71295166015625,15.126180238567272,-84.87381976143273,1.4587648181759505,1.6769755328478728,-0.017551686836661973,2355673540.0,-1.0
1874,2020-06-12,GOOG,71.42449951171875,71.8499984741211,69.3010025024414,70.65899658203125,38928000.0,0.0,0.0,0.4669952392578125,0.0,0.4669952392578125,45.46361498293189,69.3010025024414,73.71295166015625,30.7799122574933,-69.22008774250669,1.2897040523845362,1.5995212367552056,-0.01301849103156405,2394601540.0,1.0
1875,2020-06-15,GOOG,69.54000091552734,71.23999786376953,69.39600372314453,70.99250030517578,30078000.0,0.0,0.0,0.33350372314453125,0.0,0.33350372314453125,48.52162526087201,69.3010025024414,73.71295166015625,38.339013943000225,-61.660986056999775,1.1691558399796094,1.5134481574000866,-0.01345865468372165,2424679540.0,1.0
1876,2020-06-16,GOOG,72.26100158691406,72.7509994506836,71.29499816894531,72.13600158691406,34184000.0,0.0,0.0,1.1435012817382812,0.0,1.1435012817382812,57.86809432379941,69.3010025024414,73.71295166015625,64.25729270962486,-35.74270729037512,1.1526049970092345,1.4412795253219164,0.0044138924476229136,2458863540.0,1.0
1877,2020-06-17,GOOG,72.35800170898438,73.0,71.56900024414062,72.55599975585938,30992000.0,0.0,0.0,0.4199981689453125,0.0,0.4199981689453125,60.878318934046064,69.3010025024414,73.71295166015625,73.7768532016331,-26.22314679836689,1.1600068401020422,1.3850249882779417,0.02757436819972381,2489855540.0,1.0
1878,2020-06-18,GOOG,72.45800018310547,72.57050323486328,71.35050201416016,71.7979965209961,31638000.0,0.0,0.0,-0.7580032348632812,0.7580032348632812,0.0,52.99365414051862,69.3010025024414,73.71295166015625,56.596164853540564,-43.403835146459436,1.092119059230086,1.3264438024683707,-0.0016894685514965424,2458217540.0,-1.0
1879,2020-06-19,GOOG,72.19999694824219,72.38999938964844,71.06749725341797,71.58599853515625,63158000.0,0.0,0.0,-0.21199798583984375,0.21199798583984375,0.0,50.86761835739933,69.3010025024414,73.71295166015625,51.791078070771576,-48.208921929228424,1.0095733054402842,1.2630697030627536,-0.010293019262796466,2395059540.0,-1.0
1880,2020-06-22,GOOG,71.44999694824219,72.63749694824219,71.1604995727539,72.59300231933594,30848000.0,0.0,0.0,1.0070037841796875,0.0,1.0070037841796875,59.723732309732846,69.3010025024414,73.71295166015625,74.61554290892177,-25.384457091078243,1.0137263836256807,1.2132010391753392,-0.002952921957143806,2425907540.0,1.0
1881,2020-06-23,GOOG,72.78199768066406,73.79705047607422,72.26200103759766,73.22049713134766,28596000.0,0.0,0.0,0.6274948120117188,0.0,0.6274948120117188,64.34463864260363,69.3010025024414,73.79705047607422,87.17644144128856,-12.823558558711435,1.0554843485909373,1.1816577010584588,-0.0009824500772646072,2454503540.0,1.0
1882,2020-06-24,GOOG,73.07550048828125,73.77100372314453,71.48750305175781,71.59850311279297,35120000.0,0.0,0.0,-1.6219940185546875,1.6219940185546875,0.0,47.9401034634876,69.3010025024414,73.79705047607422,51.100446966431704,-48.899553033568296,0.9467825550056119,1.1346826718478895,0.020037920890032312,2419383540.0,-1.0
1883,2020-06-25,GOOG,71.49500274658203,72.1449966430664,71.0,72.06649780273438,24610000.0,0.0,0.0,0.46799468994140625,0.0,0.46799468994140625,52.01309827992339,69.3010025024414,73.79705047607422,61.50947046186531,-38.49052953813469,0.888160697063654,1.0853782768910425,0.01991963215992021,2443993540.0,1.0
1884,2020-06-26,GOOG,71.56950378417969,71.67250061035156,67.59950256347656,67.99500274658203,85354000.0,0.0,0.0,-4.071495056152344,4.071495056152344,0.0,29.133036205040796,67.59950256347656,73.79705047607422,6.381559105038008,-93.61844089496199,0.5073187731475457,0.9697663761423432,-0.04222273543977739,2358639540.0,-1.0
1885,2020-06-29,GOOG,67.90899658203125,69.77999877929688,67.35050201416016,69.74849700927734,36204000.0,0.0,0.0,1.7534942626953125,0.0,1.7534942626953125,41.84541389436088,67.35050201416016,73.79705047607422,37.1981225191192,-62.8018774808808,0.34303682211034925,0.8444204653359445,-0.03309726800923529,2394843540.0,1.0
1886,2020-06-30,GOOG,69.52200317382812,70.93250274658203,69.197998046875,70.68049621582031,40848000.0,0.0,0.0,0.9319992065429688,0.0,0.9319992065429688,47.609071299032074,67.35050201416016,73.79705047607422,51.65545906206434,-48.34454093793567,0.2847641553284035,0.7324892033344363,-0.025849048270988773,2435691540.0,1.0
1887,2020-07-01,GOOG,70.55500030517578,72.1500015258789,70.49099731445312,71.9020004272461,35504000.0,0.0,0.0,1.2215042114257812,0.0,1.2215042114257812,54.437886818010746,67.35050201416016,73.79705047607422,70.6036484480959,-29.39635155190411,0.3333056879026941,0.652652500248088,0.0014485627912972365,2471195540.0,1.0
1888,2020-07-02,GOOG,72.34700012207031,74.14749908447266,72.32099914550781,73.23500061035156,37182000.0,0.0,0.0,1.3330001831054688,0.0,1.3330001831054688,60.8614647678222,67.35050201416016,74.14749908447266,86.57497620373196,-13.425023796268027,0.47387464469264273,0.616896929136999,0.02303525981251031,2508377540.0,1.0
1889,2020-07-06,GOOG,74.00299835205078,75.32949829101562,73.64299774169922,74.78500366210938,31280000.0,0.0,0.0,1.5500030517578125,0.0,1.5500030517578125,67.08717076235438,67.35050201416016,75.32949829101562,93.17590070212646,-6.824099297873541,0.7022537044866084,0.633968284206921,0.030195766433944282,2539657540.0,1.0
1890,2020-07-07,GOOG,74.5,75.83999633789062,74.17749786376953,74.25900268554688,29164000.0,0.0,0.0,-0.5260009765625,0.5260009765625,0.0,63.153624826546945,67.35050201416016,75.83999633789062,81.37705743056523,-18.622942569434773,0.831220084206393,0.6734186442068154,0.014183262814185582,2510493540.0,-1.0
1891,2020-07-08,GOOG,74.71600341796875,75.29399871826172,74.28150177001953,74.80000305175781,24994000.0,0.0,0.0,0.5410003662109375,0.0,0.5410003662109375,65.55071244842134,67.35050201416016,75.83999633789062,87.74964389544681,-12.250356104553195,0.9659462504172751,0.7319241654489075,0.0447146211132563,2535487540.0,1.0
1892,2020-07-09,GOOG,75.32250213623047,76.13600158691406,74.40425109863281,75.54949951171875,28466000.0,0.0,0.0,0.7494964599609375,0.0,0.7494964599609375,68.7957709469572,67.35050201416016,76.13600158691406,93.32420347484613,-6.67579652515386,1.1202818959592378,0.8095957115509737,0.048330386728633545,2563953540.0,1.0
1893,2020-07-10,GOOG,75.30750274658203,77.19149780273438,74.8270034790039,77.08699798583984,37126000.0,0.0,0.0,1.5374984741210938,0.0,1.5374984741210938,74.4847584946765,67.35050201416016,77.19149780273438,98.93811745132683,-1.0618825486731702,1.351082842442409,0.917893137729261,0.13371563897340755,2601079540.0,1.0
1894,2020-07-13,GOOG,77.5,78.85659790039062,75.26215362548828,75.56700134277344,36928000.0,0.0,0.0,-1.5199966430664062,1.5199966430664062,0.0,61.66118085300754,67.35050201416016,78.85659790039062,71.4099674629524,-28.59003253704761,1.3952595458818422,1.0133664193597773,0.08342121454921347,2564151540.0,-1.0
1895,2020-07-14,GOOG,74.5155029296875,76.14749908447266,74.17500305175781,76.02899932861328,31700000.0,0.0,0.0,0.46199798583984375,0.0,0.46199798583984375,63.84423594315007,67.35050201416016,78.85659790039062,75.42521286337292,-24.574787136627087,1.4508250697161316,1.1008581494310483,0.07567155579187657,2595851540.0,1.0
1896,2020-07-15,GOOG,76.15650177001953,76.7665023803711,74.9000015258789,75.68199920654297,32214000.0,0.0,0.0,-0.3470001220703125,0.3470001220703125,0.0,60.84185455746119,67.35050201416016,78.85659790039062,72.40941910064603,-27.590580899353967,1.4501447715896205,1.1707154738627628,0.052571538438929144,2563637540.0,-1.0
1897,2020-07-16,GOOG,75.0,75.93450164794922,74.31549835205078,75.9000015258789,30386000.0,0.0,0.0,0.2180023193359375,0.0,0.2180023193359375,62.13273924276232,67.35050201416016,78.85659790039062,74.30408712263622,-25.695912877363774,1.4504764065476223,1.2266676603997348,0.036389716574272146,2594023540.0,1.0
1898,2020-07-17,GOOG,76.08100128173828,76.1719970703125,74.9209976196289,75.77749633789062,29134000.0,0.0,0.0,-0.12250518798828125,0.12250518798828125,0.0,60.832444297727605,67.35050201416016,78.85659790039062,73.23938899044974,-26.760611009550257,1.4244340952187997,1.266220947363548,0.013271279363246347,2564889540.0,-1.0
1899,2020-07-20,GOOG,75.76300048828125,78.5145034790039,75.18000030517578,78.28600311279297,31146000.0,0.0,0.0,2.5085067749023438,0.0,2.5085067749023438,73.79147776398887,69.197998046875,78.85659790039062,94.09236539196759,-5.907634608032406,1.5879065103212753,1.3305580599550935,0.05422912080167053,2596035540.0,1.0
1900,2020-07-21,GOOG,79.34950256347656,79.34950256347656,77.71399688720703,77.9209976196289,24324000.0,0.0,0.0,-0.3650054931640625,0.3650054931640625,0.0,69.90813363203006,70.49099731445312,79.34950256347656,83.87419882146445,-16.125801178535564,1.6687701408150133,1.3982004761270777,0.041724524606122415,2571711540.0,-1.0
1901,2020-07-22,GOOG,78.0250015258789,78.5,77.30500030517578,78.42449951171875,18640000.0,0.0,0.0,0.5035018920898438,0.0,0.5035018920898438,72.2338905185646,72.32099914550781,79.34950256347656,86.83926012765403,-13.16073987234597,1.753272906629931,1.4692149622276485,0.038054520792080826,2590351540.0,1.0
1902,2020-07-23,GOOG,78.34850311279297,78.59349822998047,75.36959838867188,75.78399658203125,32552000.0,0.0,0.0,-2.6405029296875,2.6405029296875,0.0,49.21638139905062,73.64299774169922,79.34950256347656,37.518567094896405,-62.481432905103595,1.5888600489129203,1.493143979564703,-0.01690299840250553,2557799540.0,-1.0
1903,2020-07-24,GOOG,74.94650268554688,75.88179779052734,74.41999816894531,75.59349822998047,30880000.0,0.0,0.0,-0.19049835205078125,0.19049835205078125,0.0,47.94460848863867,74.17500305175781,79.34950256347656,27.413186048431804,-72.5868139515682,1.4267434394392637,1.4798638715396153,0.0003506409773605945,2526919540.0,-1.0
1904,2020-07-27,GOOG,75.77999877929688,77.04850006103516,75.760498046875,76.51000213623047,24920000.0,0.0,0.0,0.91650390625,0.0,0.91650390625,54.4750214372846,74.17500305175781,79.34950256347656,45.125119428160275,-54.874880571839725,1.3565812400432264,1.4552073452403378,0.006326570280613453,2551839540.0,1.0
1905,2020-07-28,GOOG,76.25900268554688,76.3239974975586,74.88300323486328,75.01699829101562,34044000.0,0.0,0.0,-1.4930038452148438,1.4930038452148438,0.0,44.08066553348408,74.17500305175781,79.34950256347656,16.272013116455724,-83.72798688354428,1.167051218789382,1.3975761199501469,-0.0087867778665901,2517795540.0,-1.0
1906,2020-07-29,GOOG,75.31600189208984,76.5625991821289,75.06649780273438,76.10099792480469,22130000.0,0.0,0.0,1.0839996337890625,0.0,1.0839996337890625,51.787498624502035,74.17500305175781,79.34950256347656,37.22089196617087,-62.77910803382913,1.0917322131658125,1.3364073385932802,0.00264817384565208,2539925540.0,1.0
1907,2020-07-30,GOOG,74.8499984741211,76.89350128173828,74.61100006103516,76.57250213623047,33428000.0,0.0,0.0,0.47150421142578125,0.0,0.47150421142578125,54.90661208232554,74.17500305175781,79.34950256347656,46.33296571084821,-53.66703428915179,1.0578930750483693,1.2807044858842982,0.010491317828645652,2573353540.0,1.0
1908,2020-07-31,GOOG,75.25050354003906,75.44750213623047,72.70149993896484,74.14800262451172,68798000.0,0.0,0.0,-2.42449951171875,2.42449951171875,0.0,39.67684983408426,72.70149993896484,79.34950256347656,21.75845539250396,-78.24154460749604,0.8259177998044578,1.1897471486683302,-0.05285747545853503,2504555540.0,-1.0
1909,2020-08-03,GOOG,74.33200073242188,74.52349853515625,73.28199768066406,73.72250366210938,46604000.0,0.0,0.0,-0.42549896240234375,0.42549896240234375,0.0,37.56678032036823,72.70149993896484,79.34950256347656,15.358052347633086,-84.64194765236691,0.6008156834552807,1.0719608556257203,-0.05388141946044456,2457951540.0,-1.0
1910,2020-08-04,GOOG,73.82849884033203,74.27799987792969,72.93250274658203,73.24849700927734,38070000.0,0.0,0.0,-0.47400665283203125,0.47400665283203125,0.0,35.163079974176625,72.70149993896484,79.34950256347656,8.227991190852993,-91.77200880914701,0.3797942275887891,0.933527530018334,-0.0659998155508531,2419881540.0,-1.0
1911,2020-08-05,GOOG,73.46499633789062,74.12049865722656,73.1729965209961,73.68049621582031,39590000.0,0.0,0.0,0.43199920654296875,0.0,0.43199920654296875,39.25064293773828,72.70149993896484,79.34950256347656,14.7261716360615,-85.27382836393849,0.23676260510890756,0.7941745450364487,-0.027756524610496602,2459471540.0,1.0
1912,2020-08-06,GOOG,73.5875015258789,75.11949920654297,73.30000305175781,75.00499725341797,39908000.0,0.0,0.0,1.3245010375976562,0.0,1.3245010375976562,50.328726454604364,72.70149993896484,79.34950256347656,34.649464576923386,-65.35053542307662,0.2276608457081437,0.6808718051707877,-0.007785073985755786,2499379540.0,1.0
1913,2020-08-07,GOOG,75.0,75.84224700927734,74.08200073242188,74.72450256347656,31556000.0,0.0,0.0,-0.28049468994140625,0.28049468994140625,0.0,48.18175716951577,72.70149993896484,79.34950256347656,30.430232037706272,-69.56976796229372,0.19555976725685298,0.5838093975880008,-0.023336812480735825,2467823540.0,-1.0
1914,2020-08-10,GOOG,74.35900115966797,75.20375061035156,73.65399932861328,74.80500030517578,25786000.0,0.0,0.0,0.08049774169921875,0.0,0.08049774169921875,48.90354182874192,72.70149993896484,78.59349822998047,35.70096701179371,-64.29903298820628,0.1746022206028499,0.5019679621909706,-0.0028259993157475627,2493609540.0,1.0
1915,2020-08-11,GOOG,74.62200164794922,75.5,73.9000015258789,74.01599884033203,29088000.0,0.0,0.0,-0.78900146484375,0.78900146484375,0.0,42.248136069125835,72.70149993896484,78.59349822998047,22.309899569583933,-77.69010043041607,0.09325243362881963,0.4202248564785404,-0.027397789008402285,2464521540.0,-1.0
1916,2020-08-12,GOOG,74.27899932861328,75.61930084228516,74.26249694824219,75.33100128173828,28740000.0,0.0,0.0,1.31500244140625,0.0,1.31500244140625,54.22753836943782,72.70149993896484,77.04850006103516,60.490022289695844,-39.509977710304156,0.1333546194037467,0.3628508090635817,-0.016213403243417912,2493261540.0,1.0
1917,2020-08-13,GOOG,75.51699829101562,76.86250305175781,75.40025329589844,75.92250061035156,29104000.0,0.0,0.0,0.5914993286132812,0.0,0.5914993286132812,58.6763444980988,72.70149993896484,77.04850006103516,74.09709180897556,-25.902908191024448,0.2104391316876928,0.33236847358840393,0.02393183798660048,2522365540.0,1.0
1918,2020-08-14,GOOG,75.78299713134766,76.09500122070312,75.14399719238281,75.3864974975586,27096000.0,0.0,0.0,-0.5360031127929688,0.5360031127929688,0.0,53.263451080337056,72.70149993896484,76.89350128173828,64.05049376289918,-35.949506237100834,0.22567673052851944,0.31103012497642707,0.022571043477792818,2495269540.0,-1.0
1919,2020-08-17,GOOG,75.7334976196289,76.28050231933594,75.39849853515625,75.89900207519531,27566000.0,0.0,0.0,0.5125045776367188,0.0,0.5125045776367188,57.58071062668006,72.70149993896484,76.89350128173828,76.27626698504334,-23.723733014956665,0.27592676167648733,0.30400945231643917,0.03618511197004182,2522835540.0,1.0
1920,2020-08-18,GOOG,76.30899810791016,78.12349700927734,76.18550109863281,77.93000030517578,40542000.0,0.0,0.0,2.0309982299804688,0.0,2.0309982299804688,70.17740620655144,72.70149993896484,78.12349700927734,96.4312650561722,-3.5687349438278138,0.47416893249825876,0.33804134835280314,0.05767474851021759,2563377540.0,1.0
1921,2020-08-19,GOOG,77.66549682617188,78.68399810791016,77.19750213623047,77.37650299072266,33212000.0,0.0,0.0,-0.553497314453125,0.553497314453125,0.0,64.18399758796659,72.70149993896484,78.68399810791016,78.14466331181501,-21.855336688184988,0.5799296061202028,0.38641899990628314,0.03161796979062781,2530165540.0,-1.0
1922,2020-08-20,GOOG,77.17250061035156,79.29350280761719,76.91000366210938,79.0875015258789,34138000.0,0.0,0.0,1.71099853515625,0.0,1.71099853515625,72.54679616516822,72.93250274658203,79.29350280761719,96.76149536611138,-3.238504633888616,0.7926715599832619,0.467669511921679,0.058387795337895954,2564303540.0,1.0
1923,2020-08-21,GOOG,78.85150146484375,79.88600158691406,78.40025329589844,79.02100372314453,28930000.0,0.0,0.0,-0.066497802734375,0.066497802734375,0.0,71.79504422483197,72.93250274658203,79.88600158691406,87.56025011822354,-12.439749881776459,0.9450117668090314,0.5631379628991495,0.05635991445450261,2535373540.0,-1.0
1924,2020-08-24,GOOG,79.6989974975586,80.70850372314453,79.02850341796875,79.41000366210938,28198000.0,0.0,0.0,0.38899993896484375,0.0,0.38899993896484375,73.63883272361133,73.1729965209961,80.70850372314453,82.76824603571552,-17.231753964284486,1.0846285990052422,0.6674360901203681,0.0728762011766313,2563571540.0,1.0
1925,2020-08-25,GOOG,79.10350036621094,80.58100128173828,79.10350036621094,80.41100311279297,44942000.0,0.0,0.0,1.0009994506835938,0.0,1.0009994506835938,77.92375622017074,73.30000305175781,80.70850372314453,95.98433443489347,-4.015665565106529,1.2615063741535977,0.7862501469270141,0.06743574019486953,2608513540.0,1.0
1926,2020-08-26,GOOG,80.4000015258789,82.96099853515625,80.18000030517578,82.61900329589844,79868000.0,0.0,0.0,2.2080001831054688,0.0,2.2080001831054688,84.3841315484058,73.65399932861328,82.96099853515625,96.32539735237772,-3.67460264762228,1.5618464533448844,0.9413694082105885,0.0882018193778229,2688381540.0,1.0
1927,2020-08-27,GOOG,82.68399810791016,82.75,81.2874984741211,81.71649932861328,37232000.0,0.0,0.0,-0.9025039672851562,0.9025039672851562,0.0,74.15019360001776,73.65399932861328,82.96099853515625,86.62835164240622,-13.371648357593777,1.707362193744416,1.0945679653173541,0.08396731564906146,2651149540.0,-1.0
1928,2020-08-28,GOOG,81.67449951171875,82.3584976196289,81.5374984741211,82.22049713134766,29980000.0,0.0,0.0,0.503997802734375,0.0,0.503997802734375,76.02384568028756,73.9000015258789,82.96099853515625,91.82759465596985,-8.172405344030151,1.842118086369652,1.2440779895278138,0.08328824995471562,2681129540.0,1.0
1929,2020-08-31,GOOG,82.39450073242188,82.39824676513672,81.5155029296875,81.70899963378906,36468000.0,0.0,0.0,-0.5114974975585938,0.5114974975585938,0.0,70.07594895227305,74.26249694824219,82.96099853515625,85.60672905721277,-14.393270942787225,1.8859000470386746,1.372442401029986,0.04849222781745954,2644661540.0,-1.0
1930,2020-09-01,GOOG,81.83149719238281,83.2864990234375,81.61100006103516,83.0354995727539,36506000.0,0.0,0.0,1.3264999389648438,0.0,1.3264999389648438,75.75258084056617,75.14399719238281,83.2864990234375,96.91741609776116,-3.0825839022388295,2.0045280734968856,1.498859535523366,0.07313585343485673,2681167540.0,1.0
1931,2020-09-02,GOOG,83.68875122070312,86.65899658203125,83.31649780273438,86.41400146484375,50224000.0,0.0,0.0,3.3785018920898438,0.0,3.3785018920898438,84.43170930601809,75.14399719238281,86.65899658203125,97.8723827166874,-2.1276172833125955,2.3441367571451366,1.6679149798477204,0.09263789849989723,2731391540.0,1.0
1932,2020-09-03,GOOG,85.48570251464844,85.48570251464844,80.75299835205078,82.09200286865234,62156000.0,0.0,0.0,-4.321998596191406,4.321998596191406,0.0,55.24382134672742,75.39849853515625,86.65899658203125,59.44234709364091,-40.55765290635908,2.2387233106532136,1.7820766460088193,0.03886307438294856,2669235540.0,-1.0
1933,2020-09-04,GOOG,81.21299743652344,82.25550079345703,77.38065338134766,79.552001953125,52172000.0,0.0,0.0,-2.5400009155273438,2.5400009155273438,0.0,44.7528647899078,76.18550109863281,86.65899658203125,32.14304966119894,-67.85695033880106,1.9280007560587364,1.811261468018803,0.0017881662821706001,2617063540.0,-1.0
1934,2020-09-08,GOOG,76.67549896240234,78.19325256347656,76.40049743652344,76.61949920654297,52218000.0,0.0,0.0,-2.9325027465820312,2.9325027465820312,0.0,35.71718119653447,76.40049743652344,86.65899658203125,2.1348324634352767,-97.86516753656473,1.42865379753448,1.7347399339219385,-0.04715155587515352,2564845540.0,-1.0
1935,2020-09-09,GOOG,77.87650299072266,78.44999694824219,76.80255126953125,77.8479995727539,35494000.0,0.0,0.0,1.2285003662109375,0.0,1.2285003662109375,41.432993627786075,76.40049743652344,86.65899658203125,14.110272035888688,-85.88972796411132,1.119146622234183,1.6116212715843874,-0.05774705010731329,2600339540.0,1.0
1936,2020-09-10,GOOG,78.03199768066406,79.20404815673828,76.29025268554688,76.60099792480469,32372000.0,0.0,0.0,-1.2470016479492188,1.2470016479492188,0.0,37.52508512969794,76.29025268554688,86.65899658203125,2.9969419860314397,-97.00305801396856,0.7644255229775041,1.4421821218630109,-0.06260059407632246,2567967540.0,-1.0
1937,2020-09-11,GOOG,76.80000305175781,78.76000213623047,74.86799621582031,76.03600311279297,31942000.0,0.0,0.0,-0.5649948120117188,0.5649948120117188,0.0,35.76172169264915,74.86799621582031,86.65899658203125,9.905918587872945,-90.09408141212705,0.43272791863611815,1.2402912812176323,-0.07521839728936364,2536025540.0,-1.0
1938,2020-09-14,GOOG,76.95024871826172,78.19999694824219,75.78700256347656,75.96399688720703,33932000.0,0.0,0.0,-0.0720062255859375,0.0720062255859375,0.0,35.51629528142158,74.86799621582031,86.65899658203125,9.295230577105993,-90.704769422894,0.16217541953403725,1.0246681088809133,-0.0703105260415684,2502093540.0,-1.0
1939,2020-09-15,GOOG,76.80000305175781,77.97850036621094,76.59175109863281,77.0719985961914,26622000.0,0.0,0.0,1.108001708984375,0.0,1.108001708984375,42.52014518927346,74.86799621582031,86.65899658203125,18.692242489339815,-81.30775751066018,0.03674353611624781,0.8270831943279802,-0.07181869209249969,2528715540.0,1.0
1940,2020-09-16,GOOG,77.7770004272461,78.0999984741211,75.99099731445312,76.04499816894531,26234000.0,0.0,0.0,-1.0270004272460938,1.0270004272460938,0.0,38.094950665768586,74.86799621582031,86.65899658203125,9.982206060292338,-90.01779393970766,-0.14387399678189183,0.6328917561060058,-0.11999216701146409,2502481540.0,-1.0
1941,2020-09-17,GOOG,74.80000305175781,75.41490173339844,73.5,74.77649688720703,37596000.0,0.0,0.0,-1.2685012817382812,1.2685012817382812,0.0,33.174447466001595,73.5,86.65899658203125,9.70056401526923,-90.29943598473076,-0.3849348556096288,0.4293264337628788,-0.08911350345721447,2464885540.0,-1.0
1942,2020-09-18,GOOG,74.90049743652344,75.150146484375,71.85649871826172,72.99949645996094,62078000.0,0.0,0.0,-1.7770004272460938,1.7770004272460938,0.0,27.44459480155679,71.85649871826172,86.65899658203125,7.721654495197128,-92.27834550480287,-0.7111684986810758,0.20122744727408784,-0.08236757507403825,2402807540.0,-1.0
1943,2020-09-21,GOOG,72.00299835205078,72.41799926757812,70.32749938964844,71.55799865722656,57776000.0,0.0,0.0,-1.441497802734375,1.441497802734375,0.0,23.625237422014038,70.32749938964844,86.65899658203125,7.5345159912959065,-92.4654840087041,-1.0736514511781934,-0.05374833241636847,-0.06606021445888255,2345031540.0,-1.0
1944,2020-09-22,GOOG,72.50450134277344,73.47599792480469,71.72650146484375,73.27300262451172,31664000.0,0.0,0.0,1.7150039672851562,0.0,1.7150039672851562,35.875763344226286,70.32749938964844,86.65899658203125,18.035720792562092,-81.96427920743791,-1.2086032889217933,-0.2847193237174535,-0.05876833025062589,2376695540.0,1.0
1945,2020-09-23,GOOG,72.93900299072266,73.0479965209961,70.38500213623047,70.760498046875,33148000.0,0.0,0.0,-2.5125045776367188,2.5125045776367188,0.0,28.22328566687466,70.32749938964844,85.48570251464844,2.8565302473908,-97.1434697526092,-1.500989244470631,-0.5279733078680892,-0.07624574138920504,2343547540.0,-1.0
1946,2020-09-24,GOOG,70.55149841308594,72.1854476928711,70.49250030517578,71.41449737548828,29004000.0,0.0,0.0,0.6539993286132812,0.0,0.6539993286132812,32.544788263486,70.32749938964844,82.25550079345703,9.112993443249989,-90.88700655675001,-1.6607903829232669,-0.7545367228791248,-0.06078049276799935,2372551540.0,1.0
1947,2020-09-25,GOOG,71.63150024414062,72.5,70.66699981689453,72.24800109863281,26460000.0,0.0,0.0,0.8335037231445312,0.0,0.8335037231445312,38.03136296635656,70.32749938964844,79.20404815673828,21.63568025564971,-78.36431974435028,-1.7005739934495665,-0.9437441769932132,-0.048917855047724945,2399011540.0,1.0
1948,2020-09-28,GOOG,73.71050262451172,73.83999633789062,72.46504974365234,73.22599792480469,40158000.0,0.0,0.0,0.977996826171875,0.0,0.977996826171875,44.17840058346154,70.32749938964844,79.20404815673828,32.653440106165455,-67.34655989383455,-1.6343468874328124,-1.0818647190811332,-0.04990140052728276,2439169540.0,1.0
1949,2020-09-29,GOOG,73.51950073242188,73.8331527709961,72.94024658203125,73.46649932861328,19564000.0,0.0,0.0,0.24050140380859375,0.0,0.24050140380859375,45.70656239888277,70.32749938964844,79.20404815673828,35.362842263682595,-64.6371577363174,-1.5446492207348683,-1.1744216194118804,-0.033907540304011996,2458733540.0,1.0
1950,2020-09-30,GOOG,73.33999633789062,74.48750305175781,72.99400329589844,73.4800033569336,34032000.0,0.0,0.0,0.0135040283203125,0.0,0.0135040283203125,45.80268786253215,70.32749938964844,78.76000213623047,37.385151977127656,-62.61484802287234,-1.455693186495992,-1.230675932828703,-0.017338249105585568,2492765540.0,1.0
1951,2020-10-01,GOOG,74.2135009765625,74.9520034790039,73.96050262451172,74.50450134277344,35590000.0,0.0,0.0,1.0244979858398438,0.0,1.0244979858398438,53.07526899502437,70.32749938964844,78.19999694824219,53.058154950652415,-46.941845049347585,-1.2876828566806466,-1.2420773175990918,0.020616647453698178,2528355540.0,1.0
1952,2020-10-02,GOOG,73.10150146484375,74.16000366210938,72.5459976196289,72.9209976196289,25682000.0,0.0,0.0,-1.5835037231445312,1.5835037231445312,0.0,42.826355440612204,70.32749938964844,78.0999984741211,33.36762348626807,-66.63237651373193,-1.2676957687094301,-1.2472010078211595,0.019047471812778216,2502673540.0,-1.0
1953,2020-10-05,GOOG,73.31050109863281,74.4104995727539,73.2135009765625,74.3010025024414,22266000.0,0.0,0.0,1.3800048828125,0.0,1.3800048828125,52.122924170347915,70.32749938964844,78.0999984741211,51.12259351346788,-48.87740648653212,-1.12750383427732,-1.2232615731123917,0.014029722286633683,2524939540.0,1.0
1954,2020-10-06,GOOG,73.77899932861328,74.33799743652344,72.42949676513672,72.6719970703125,24908000.0,0.0,0.0,-1.6290054321289062,1.6290054321289062,0.0,42.67226112347278,70.32749938964844,75.41490173339844,46.0843770995297,-53.9156229004703,-1.134766953347608,-1.2055626491594351,0.02701364569496434,2500031540.0,-1.0
1955,2020-10-07,GOOG,73.2145004272461,73.447998046875,71.80000305175781,73.0145034790039,34924000.0,0.0,0.0,0.34250640869140625,0.0,0.34250640869140625,45.08770621000705,70.32749938964844,75.150146484375,55.71637394520609,-44.28362605479391,-1.100203165562931,-1.1844907524401342,0.022404499958922797,2534955540.0,1.0
1956,2020-10-08,GOOG,73.25450134277344,74.5,73.25450134277344,74.29650115966797,23756000.0,0.0,0.0,1.2819976806640625,0.0,1.2819976806640625,53.54170312365128,70.32749938964844,74.9520034790039,85.82545702911689,-14.174542970883108,-0.9583177257861877,-1.139256147109345,0.028353726468342666,2558711540.0,1.0
1957,2020-10-09,GOOG,74.73500061035156,75.82599639892578,74.47250366210938,75.76100158691406,28706000.0,0.0,0.0,1.4645004272460938,0.0,1.4645004272460938,61.37899829037842,70.38500213623047,75.82599639892578,98.80546075085324,-1.1945392491467577,-0.7194066750607249,-1.055286252699621,0.03461890221984487,2587417540.0,1.0
1958,2020-10-12,GOOG,77.1500015258789,79.69300079345703,76.62850189208984,78.4574966430664,49652000.0,0.0,0.0,2.6964950561523438,0.0,2.6964950561523438,71.56863433225023,70.38500213623047,79.69300079345703,86.72642534782273,-13.273574652177263,-0.3089222670208045,-0.9060134555638576,0.06793568987312915,2637069540.0,1.0
1959,2020-10-13,GOOG,79.1865005493164,79.5,78.16000366210938,78.58399963378906,32020000.0,0.0,0.0,0.12650299072265625,0.0,0.12650299072265625,71.96896907351324,70.49250030517578,79.69300079345703,87.946295301212,-12.053704698787987,0.02629421451565861,-0.7195519215479543,0.06946102400216958,2669089540.0,1.0
1960,2020-10-14,GOOG,78.92949676513672,79.38420104980469,77.52649688720703,78.40399932861328,38586000.0,0.0,0.0,-0.18000030517578125,0.18000030517578125,0.0,70.34280048226297,70.66699981689453,79.69300079345703,85.71901921802518,-14.280980781974817,0.27426956214965514,-0.5207876248084324,0.05233909247844504,2630503540.0,-1.0
1961,2020-10-15,GOOG,77.35749816894531,78.7552490234375,77.25150299072266,77.95649719238281,30800000.0,0.0,0.0,-0.44750213623046875,0.44750213623046875,0.0,66.06091868667177,71.80000305175781,79.69300079345703,77.999441303522,-22.000558696477988,0.42972848675451303,-0.3306844024958433,0.06905417831802185,2599703540.0,-1.0
1962,2020-10-16,GOOG,78.2925033569336,79.05650329589844,78.1500015258789,78.65049743652344,28694000.0,0.0,0.0,0.694000244140625,0.0,0.694000244140625,69.39460980243723,71.80000305175781,79.69300079345703,86.79204795123681,-13.207952048763183,0.6019914416127818,-0.14414923367411822,0.0585388458781444,2628397540.0,1.0
1963,2020-10-19,GOOG,79.02300262451172,79.40750122070312,76.4000015258789,76.73049926757812,32142000.0,0.0,0.0,-1.9199981689453125,1.9199981689453125,0.0,52.82960004165654,71.80000305175781,79.69300079345703,62.46671261252465,-37.53328738747534,0.576932746709943,6.71624026940654e-05,0.055846851068904746,2596255540.0,-1.0
1964,2020-10-20,GOOG,76.35250091552734,78.875,76.28350067138672,77.79650115966797,44834000.0,0.0,0.0,1.0660018920898438,0.0,1.0660018920898438,59.08623069122899,71.80000305175781,79.69300079345703,75.97237835544115,-24.027621644558845,0.6357623219048065,0.12720619430311658,0.06549380537853255,2641089540.0,1.0
1965,2020-10-21,GOOG,78.66649627685547,80.9365005493164,78.58149719238281,79.66549682617188,51366000.0,0.0,0.0,1.8689956665039062,0.0,1.8689956665039062,67.74201491539164,71.80000305175781,80.9365005493164,86.0887202838488,-13.911279716151206,0.8237023861585868,0.2665054326742107,0.07226444829434953,2692455540.0,1.0
1966,2020-10-22,GOOG,79.65249633789062,81.09950256347656,79.25,80.7665023803711,28672000.0,0.0,0.0,1.1010055541992188,0.0,1.1010055541992188,71.79758859042897,71.80000305175781,81.09950256347656,96.41916016355677,-3.580839836443231,1.0493914563657825,0.4230826374125251,0.06606962274270689,2721127540.0,1.0
1967,2020-10-23,GOOG,81.30349731445312,82.11799621582031,81.02549743652344,82.05000305175781,27516000.0,0.0,0.0,1.2835006713867188,0.0,1.2835006713867188,75.8770270465123,71.80000305175781,82.11799621582031,99.34102336586808,-0.6589766341319137,1.316642018418051,0.6017945136136303,0.04578920514167195,2748643540.0,1.0
1968,2020-10-26,GOOG,81.25050354003906,81.91200256347656,78.82499694824219,79.52249908447266,37066000.0,0.0,0.0,-2.5275039672851562,2.5275039672851562,0.0,57.10757762923484,71.80000305175781,82.11799621582031,74.84494232475599,-25.15505767524401,1.309397646357425,0.7433151401623894,0.011942627698476871,2711577540.0,-1.0
1969,2020-10-27,GOOG,79.78350067138672,80.34224700927734,79.13899993896484,80.21299743652344,24580000.0,0.0,0.0,0.6904983520507812,0.0,0.6904983520507812,60.21021836249066,73.25450134277344,82.11799621582031,78.5073629918847,-21.492637008115302,1.3438824354039127,0.8634285992106943,0.023072778473048672,2736157540.0,1.0
1970,2020-10-28,GOOG,77.98699951171875,78.06749725341797,75.73100280761719,75.83100128173828,36680000.0,0.0,0.0,-4.381996154785156,4.381996154785156,0.0,39.36148600212317,74.47250366210938,82.11799621582031,17.768608236620732,-82.23139176337926,1.0060245861509003,0.8919477965987355,-0.02726515412049857,2699477540.0,-1.0
1971,2020-10-29,GOOG,76.11799621582031,79.68550109863281,76.11199951171875,78.36199951171875,40062000.0,0.0,0.0,2.5309982299804688,0.0,2.5309982299804688,50.731192606917226,75.73100280761719,82.11799621582031,41.193039290168144,-58.806960709831856,0.9317594680604913,0.8999101308910866,-0.003668100447012712,2739539540.0,1.0
1972,2020-10-30,GOOG,83.60549926757812,84.3499984741211,80.2229995727539,81.05049896240234,86582000.0,0.0,0.0,2.6884994506835938,0.0,2.6884994506835938,59.93783269173234,75.73100280761719,84.3499984741211,61.718283203904726,-38.281716796095274,1.0774233976104455,0.9354127842349583,0.056300945987062034,2826121540.0,1.0
1973,2020-11-02,GOOG,81.40799713134766,83.03849792480469,80.80149841308594,81.30149841308594,50708000.0,0.0,0.0,0.25099945068359375,0.0,0.25099945068359375,60.72836357313892,75.73100280761719,84.3499984741211,64.63044908024987,-35.36955091975013,1.1992919778239468,0.9881886229527561,0.04505340473120234,2876829540.0,1.0
1974,2020-11-03,GOOG,81.58899688720703,83.08499908447266,80.83100128173828,82.510498046875,33234000.0,0.0,0.0,1.2089996337890625,0.0,1.2089996337890625,64.60960867525252,75.73100280761719,84.3499984741211,78.65760120526613,-21.342398794733867,1.3775503293724114,1.0660609642366872,0.035711836793170804,2910063540.0,1.0
1975,2020-11-04,GOOG,85.51399993896484,88.56825256347656,85.30149841308594,87.45649719238281,71418000.0,0.0,0.0,4.9459991455078125,0.0,4.9459991455078125,75.86773170697316,75.73100280761719,88.56825256347656,91.33961407437519,-8.660385925624805,1.8960654901489278,1.2320618694191354,0.08283130524217919,2981481540.0,1.0
1976,2020-11-05,GOOG,89.05000305175781,89.68199920654297,87.52549743652344,88.16850280761719,41316000.0,0.0,0.0,0.712005615234375,0.0,0.712005615234375,77.07887053717243,75.73100280761719,89.68199920654297,89.15133832991083,-10.848661670089168,2.3375001467857146,1.4531495248924515,0.07457037816317658,3022797540.0,1.0
1977,2020-11-06,GOOG,87.69750213623047,88.62149810791016,87.01750183105469,88.0875015258789,33218000.0,0.0,0.0,-0.08100128173828125,0.08100128173828125,0.0,76.57440004858098,75.73100280761719,89.68199920654297,88.57072545164704,-11.429274548352963,2.6502536912281585,1.6925703581595932,0.10770539834654946,2989579540.0,-1.0
1978,2020-11-09,GOOG,89.54499816894531,90.90299987792967,88.0009994506836,88.1500015258789,45366000.0,0.0,0.0,0.0625,0.0,0.0625,76.71010757625609,75.73100280761719,90.90299987792967,81.85473975975356,-18.145260240246447,2.870071953213241,1.9280706771703229,0.09894910230273357,3034945540.0,1.0
1979,2020-11-10,GOOG,86.55449676513672,88.1500015258789,85.86499786376953,87.01950073242188,52722000.0,0.0,0.0,-1.1305007934570312,1.1305007934570312,0.0,68.43573770713532,75.73100280761719,90.90299987792967,74.40350714866165,-25.596492851338343,2.9194044660800245,2.1263374349522635,0.14754518945509454,2982223540.0,-1.0
1980,2020-11-11,GOOG,87.5,88.21099853515625,87.36824798583984,87.635498046875,25280000.0,0.0,0.0,0.615997314453125,0.0,0.615997314453125,70.4403806508589,75.73100280761719,90.90299987792967,78.46360096227349,-21.536399037726515,2.9739251155920954,2.29585497108023,0.11834178036472176,3007503540.0,1.0
1981,2020-11-12,GOOG,87.38150024414062,88.41349792480469,87.27999877929688,87.49199676513672,24950000.0,0.0,0.0,-0.14350128173828125,0.14350128173828125,0.0,69.25805651704957,75.73100280761719,90.90299987792967,77.517771081914,-22.482228918086,2.97130244398177,2.430944465660538,0.07947511594866863,2982553540.0,-1.0
1982,2020-11-13,GOOG,87.88150024414062,89.052001953125,87.22750091552734,88.85099792480469,29998000.0,0.0,0.0,1.3590011596679688,0.0,1.3590011596679688,74.02261113534867,75.73100280761719,90.90299987792967,86.47507019929365,-13.524929800706337,3.0437969966938567,2.5535149718672017,0.09285806115602435,3012551540.0,1.0
1983,2020-11-16,GOOG,88.58499908447266,89.95349884033203,88.3844985961914,89.06900024414062,24936000.0,0.0,0.0,0.2180023193359375,0.0,0.2180023193359375,74.74703469442426,75.73100280761719,90.90299987792967,87.91194313253796,-12.088056867462042,3.083298076324766,2.659471592758715,0.07948688170006779,3037487540.0,1.0
1984,2020-11-17,GOOG,88.84700012207031,89.25,88.3499984741211,88.50749969482422,22942000.0,0.0,0.0,-0.5615005493164062,0.5615005493164062,0.0,69.02633849376078,76.11199951171875,90.90299987792967,83.80433964035441,-16.195660359645576,3.034316849009514,2.734440644008875,0.012017431936811596,3014545540.0,-1.0
1985,2020-11-18,GOOG,88.2614974975586,88.67350006103516,87.30699920654297,87.33899688720703,23470000.0,0.0,0.0,-1.1685028076171875,1.1685028076171875,0.0,58.310437381364196,80.2229995727539,90.90299987792967,66.62918643367972,-33.37081356632028,2.8681482349895333,2.761182162205007,-0.009408188797536132,2991075540.0,-1.0
1986,2020-11-19,GOOG,86.91899871826172,88.47949981689453,86.85025024414062,88.19599914550781,24998000.0,0.0,0.0,0.8570022583007812,0.0,0.8570022583007812,63.151431886501754,80.80149841308594,90.90299987792967,73.20199633843507,-26.798003661564945,2.77363855247377,2.76367344025876,0.0012317027699670913,3016073540.0,1.0
1987,2020-11-20,GOOG,88.260498046875,88.69999694824219,87.09300231933594,87.1094970703125,46270000.0,0.0,0.0,-1.0865020751953125,1.0865020751953125,0.0,53.981814223005316,80.83100128173828,90.90299987792967,62.33614638258943,-37.66385361741057,2.581311558151242,2.727201063837257,-0.011803793959787257,2969803540.0,-1.0
1988,2020-11-23,GOOG,87.4800033569336,87.69499969482422,85.88600158691406,86.74299621582031,43232000.0,0.0,0.0,-0.3665008544921875,0.3665008544921875,0.0,51.09424534257488,85.30149841308594,90.90299987792967,25.73413238899489,-74.2658676110051,2.371974824256455,2.6561558159210965,-0.0031775006093380798,2926571540.0,-1.0
1989,2020-11-24,GOOG,86.5250015258789,88.58000183105469,86.3844985961914,88.44400024414062,31560000.0,0.0,0.0,1.7010040283203125,0.0,1.7010040283203125,61.98422332146407,85.86499786376953,90.90299987792967,51.190975571712336,-48.809024428287664,2.316626139569479,2.588249880650773,0.009225738602331779,2958131540.0,1.0
1990,2020-11-25,GOOG,88.64450073242188,88.927001953125,87.8270034790039,88.57150268554688,20916000.0,0.0,0.0,0.12750244140625,0.0,0.12750244140625,62.702526058437236,85.86499786376953,90.90299987792967,53.721789196793935,-46.27821080320607,2.2570326225101525,2.522006429022649,0.012338339051833236,2979047540.0,1.0
1991,2020-11-27,GOOG,88.65450286865234,90.1999969482422,88.62200164794922,89.65950012207031,17698000.0,0.0,0.0,1.0879974365234375,0.0,1.0879974365234375,68.5528762320361,85.86499786376953,90.90299987792967,75.31760105763558,-24.682398942364415,2.2714131938528794,2.4718877819886953,0.00909952860574359,2996745540.0,1.0
1992,2020-11-30,GOOG,89.05919647216797,89.40325164794922,87.75,88.03700256347656,36476000.0,0.0,0.0,-1.62249755859375,1.62249755859375,0.0,53.98279704226842,85.86499786376953,90.1999969482422,50.103925223117876,-49.896074776882124,2.127364967936117,2.40298321917818,-0.01158649673663481,2960269540.0,-1.0
1993,2020-12-01,GOOG,88.71849822998047,91.2415008544922,88.46849822998047,89.90499877929688,34738000.0,0.0,0.0,1.8679962158203125,0.0,1.8679962158203125,64.11472979819601,85.88600158691406,91.2415008544922,75.04430477123903,-24.955695228760977,2.139277139001962,2.3502420031429363,0.01578961205876639,2995007540.0,1.0
1994,2020-12-02,GOOG,89.90499877929688,91.78250122070312,89.47364807128906,91.39749908447266,24440000.0,0.0,0.0,1.4925003051757812,0.0,1.4925003051757812,70.16974676716463,85.88600158691406,91.78250122070312,93.47066632508093,-6.529333674919068,2.243290663309736,2.3288517351762965,0.04646838573732337,3019447540.0,1.0
1995,2020-12-03,GOOG,91.20050048828124,92.36000061035156,91.13249969482422,91.3385009765625,24546000.0,0.0,0.0,-0.05899810791015625,0.05899810791015625,0.0,69.63383778344374,85.88600158691406,92.36000061035156,84.22150466672952,-15.778495333270481,2.294511773024581,2.3219837427459535,0.03563088871945452,2994901540.0,-1.0
1996,2020-12-04,GOOG,91.22599792480467,91.65799713134766,90.84950256347656,91.39949798583984,27564000.0,0.0,0.0,0.06099700927734375,0.0,0.06099700927734375,69.90800184131399,85.88600158691406,92.36000061035156,85.16368907325351,-14.836310926746489,2.3133598480651756,2.320258963809798,0.04924837198938903,3022465540.0,1.0
1997,2020-12-07,GOOG,90.9499969482422,91.61849975585938,90.28900146484376,90.9739990234375,26418000.0,0.0,0.0,-0.42549896240234375,0.42549896240234375,0.0,65.17192204128122,85.88600158691406,92.36000061035156,78.59126048835674,-21.408739511643255,2.2678208460612836,2.3097713402600952,0.04877630462625793,2996047540.0,-1.0
1998,2020-12-08,GOOG,90.50499725341795,91.09500122070312,89.81024932861328,90.92749786376952,21926000.0,0.0,0.0,-0.04650115966798296,0.04650115966798296,0.0,64.61988088034971,85.88600158691406,92.36000061035156,77.87298482134418,-22.127015178655824,2.202588534363244,2.288334779080725,0.028079887983056606,2974121540.0,-1.0
1999,2020-12-09,GOOG,90.60050201416016,91.7135009765625,88.3905029296875,89.20649719238281,30152000.0,0.0,0.0,-1.7210006713867045,1.7210006713867045,0.0,47.45449850530026,85.88600158691406,92.36000061035156,51.289714339587064,-48.710285660412936,1.9890920709636788,2.2284862374573158,0.007169286820054799,2943969540.0,-1.0
2000,2020-12-10,GOOG,88.48999786376953,89.06549835205078,87.01599884033203,88.7665023803711,27256000.0,0.0,0.0,-0.43999481201171875,0.43999481201171875,0.0,44.00612072773564,85.88600158691406,92.36000061035156,44.49337701517865,-55.50662298482134,1.7640557448808778,2.1356001389420283,-0.009959878657402887,2916713540.0,-1.0
2001,2020-12-11,GOOG,88.15299987792969,89.22250366210938,88.0,89.0885009765625,24414000.0,0.0,0.0,0.32199859619140625,0.0,0.32199859619140625,47.243318610589625,85.88600158691406,92.36000061035156,49.46709719996229,-50.53290280003772,1.5933285313226548,2.0271458174181536,0.011943823420473398,2941127540.0,1.0
2002,2020-12-14,GOOG,88.75,89.86949920654297,87.86074829101562,88.00299835205078,32004000.0,0.0,0.0,-1.0855026245117188,1.0855026245117188,0.0,38.56970918861176,86.3844985961914,92.36000061035156,27.0855863159951,-72.9144136840049,1.3548175018636215,1.8926801543072471,-0.021155669351770046,2909123540.0,-1.0
2003,2020-12-15,GOOG,88.22100067138672,88.57099914550781,87.49749755859375,88.38849639892578,29646000.0,0.0,0.0,0.385498046875,0.0,0.385498046875,42.867837151240195,87.01599884033203,92.36000061035156,25.68295479042728,-74.31704520957271,1.1832623514471123,1.7507965937352203,-0.0329221555916519,2938769540.0,1.0
2004,2020-12-16,GOOG,88.64399719238281,88.6500015258789,87.80400085449219,88.1500015258789,30270000.0,0.0,0.0,-0.238494873046875,0.238494873046875,0.0,40.82860762222392,87.01599884033203,92.36000061035156,21.220103105293887,-78.77989689470611,1.0163433422857509,1.6039059434453262,-0.034908602797212196,2908499540.0,-1.0
2005,2020-12-17,GOOG,88.42549896240234,88.58920288085938,86.93299865722656,87.3949966430664,32494000.0,0.0,0.0,-0.7550048828125,0.7550048828125,0.0,34.78442014355599,86.93299865722656,92.36000061035156,8.512950425120339,-91.48704957487966,0.8137557707550656,1.4458759089072744,-0.04381316561928861,2876005540.0,-1.0
2006,2020-12-18,GOOG,87.70899963378906,87.75550079345703,86.01100158691406,86.55049896240234,80328000.0,0.0,0.0,-0.8444976806640625,0.8444976806640625,0.0,29.204588922824968,86.01100158691406,92.36000061035156,8.497361135144489,-91.50263886485551,0.5783924080412248,1.2723792087340646,-0.048623783812070664,2795677540.0,-1.0
2007,2020-12-21,GOOG,85.67549896240234,87.0425033569336,84.94999694824219,86.96849822998047,36568000.0,0.0,0.0,0.417999267578125,0.0,0.417999267578125,35.14610560603266,84.94999694824219,92.36000061035156,27.240219759401345,-72.75978024059866,0.4207442174820244,1.1020522104836565,-0.043540180108338045,2832245540.0,1.0
2008,2020-12-22,GOOG,86.72149658203125,86.87024688720703,85.62875366210938,86.17500305175781,18734000.0,0.0,0.0,-0.7934951782226562,0.7934951782226562,0.0,29.68855309195456,84.94999694824219,92.36000061035156,16.531788098562256,-83.46821190143774,0.2291371113169589,0.927469190650317,-0.033982885059226975,2813511540.0,-1.0
2009,2020-12-23,GOOG,86.40550231933594,87.39949798583984,86.25199890136719,86.61900329589844,20676000.0,0.0,0.0,0.444000244140625,0.0,0.444000244140625,36.095337135721216,84.94999694824219,91.7135009765625,24.676651934673878,-75.32334806532613,0.11182515745734634,0.7643403840117229,-0.024192674340940745,2834187540.0,1.0
2010,2020-12-24,GOOG,86.75,87.30000305175781,86.45549774169922,86.94249725341797,6936000.0,0.0,0.0,0.32349395751953125,0.0,0.32349395751953125,40.64230562231683,84.94999694824219,91.7135009765625,29.459586285936023,-70.54041371406397,0.044445507512392624,0.6203614087118569,-0.02408844799969312,2841123540.0,1.0
2011,2020-12-28,GOOG,87.58174896240234,89.5363998413086,87.3167495727539,88.80449676513672,27860000.0,0.0,0.0,1.86199951171875,0.0,1.86199951171875,59.690627772088625,84.94999694824219,91.7135009765625,56.98968760504724,-43.01031239495277,0.1396842555557214,0.5242259780806298,0.009107626195639318,2868983540.0,1.0
2012,2020-12-29,GOOG,89.3895034790039,89.62200164794922,87.80449676513672,87.93599700927734,25988000.0,0.0,0.0,-0.868499755859375,0.868499755859375,0.0,50.899730042392434,84.94999694824219,91.7135009765625,44.148714165499165,-55.85128583450084,0.14342763312163243,0.4480663090888303,-0.005119437574841901,2842995540.0,-1.0
2013,2020-12-30,GOOG,88.10050201416016,88.25475311279297,86.27999877929688,86.97599792480469,26122000.0,0.0,0.0,-0.9599990844726562,0.9599990844726562,0.0,42.850848558711725,84.94999694824219,89.86949920654297,41.18304800336224,-58.81695199663777,0.06814485230368916,0.37208201773180205,-0.013318248221805828,2816873540.0,-1.0
2014,2020-12-31,GOOG,86.77100372314453,87.94650268554688,86.77100372314453,87.59400177001953,20238000.0,0.0,0.0,0.6180038452148438,0.0,0.6180038452148438,48.85796838650508,84.94999694824219,89.86949920654297,53.745372660741396,-46.254627339258604,0.057685489146621194,0.3092027120147659,0.002277076887660767,2837111540.0,1.0
2015,2021-01-04,GOOG,87.87699890136719,88.03250122070312,85.39250183105469,86.41200256347656,38038000.0,0.0,0.0,-1.1819992065429688,1.1819992065429688,0.0,39.65843163723718,84.94999694824219,89.86949920654297,29.718567823960274,-70.28143217603973,-0.04545708808410609,0.2382707519949915,-0.0016001802483650573,2799073540.0,-1.0
2016,2021-01-05,GOOG,86.25,87.38349914550781,85.90074920654297,87.0459976196289,22906000.0,0.0,0.0,0.6339950561523438,0.0,0.6339950561523438,45.95628237781867,84.94999694824219,89.62200164794922,44.86298294002473,-55.13701705997528,-0.075173665901346,0.175581868415724,0.0008911202472818847,2821979540.0,1.0
2017,2021-01-06,GOOG,85.13150024414062,87.4000015258789,84.94999694824219,86.7645034790039,52042000.0,0.0,0.0,-0.281494140625,0.281494140625,0.0,43.62373735928837,84.94999694824219,89.62200164794922,38.83785756627132,-61.16214243372868,-0.12005457807693176,0.11645457911719286,0.006840735786130869,2769937540.0,-1.0
2018,2021-01-07,GOOG,87.00299835205078,89.41999816894531,86.85250091552734,89.36250305175781,45300000.0,0.0,0.0,2.5979995727539062,0.0,2.5979995727539062,63.40412810754354,84.94999694824219,89.62200164794922,94.44566919618727,-5.554330803812734,0.05339828659863599,0.10384332061348149,0.03167318546124731,2815237540.0,1.0
2019,2021-01-08,GOOG,89.39900207519531,90.49199676513672,88.67675018310547,90.3604965209961,41012000.0,0.0,0.0,0.9979934692382812,0.0,0.9979934692382812,68.3294117443151,84.94999694824219,90.49199676513672,97.6272059096835,-2.3727940903165057,0.26829789280395744,0.1367342350515767,0.03931333209368737,2856249540.0,1.0
2020,2021-01-11,GOOG,89.30349731445312,89.71575164794922,88.0260009765625,88.33599853515625,24194000.0,0.0,0.0,-2.0244979858398438,2.0244979858398438,0.0,51.960780370772625,84.94999694824219,90.49199676513672,61.09710752050176,-38.90289247949824,0.27211058947554534,0.16380950593637045,-0.005275613815137303,2832055540.0,-1.0
2021,2021-01-12,GOOG,87.69599914550781,88.9020004272461,86.2655029296875,87.32749938964844,27140000.0,0.0,0.0,-1.0084991455078125,1.0084991455078125,0.0,45.6720715162289,84.94999694824219,90.49199676513672,42.8997206776973,-57.1002793223027,0.1915466953233249,0.16935694381376135,-0.006919778478939764,2804915540.0,-1.0
2022,2021-01-13,GOOG,86.92900085449219,88.25174713134766,86.90049743652344,87.72000122070312,21882000.0,0.0,0.0,0.3925018310546875,0.0,0.3925018310546875,48.472588490922746,84.94999694824219,90.49199676513672,49.9820347163619,-50.0179652836381,0.1575546542873525,0.1669964859084796,0.008554121983649576,2826797540.0,1.0
2023,2021-01-14,GOOG,87.68099975585938,88.75050354003906,86.66999816894531,87.00900268554688,23590000.0,0.0,0.0,-0.71099853515625,0.71099853515625,0.0,43.75796411758166,84.94999694824219,90.49199676513672,37.15275722362717,-62.84724277637282,0.07240938680467934,0.14807906608771956,-0.0066785290391069285,2803207540.0,-1.0
2024,2021-01-15,GOOG,86.90950012207031,87.80000305175781,86.07749938964844,86.80950164794922,26844000.0,0.0,0.0,-0.19950103759765625,0.19950103759765625,0.0,42.422084721946035,84.94999694824219,90.49199676513672,33.55295491057969,-66.44704508942031,-0.01103965922861505,0.11625532102445264,0.0046000448164671415,2776363540.0,-1.0
2025,2021-01-19,GOOG,87.61250305175781,90.46375274658205,87.072998046875,89.54299926757812,34692000.0,0.0,0.0,2.7334976196289062,0.0,2.7334976196289062,61.16551694253353,84.94999694824219,90.49199676513672,82.87626256021123,-17.123737439788766,0.14176263230234554,0.12135678328003123,0.028686001840780184,2811055540.0,1.0
2026,2021-01-20,GOOG,91.572998046875,95.1855010986328,91.27649688720705,94.34500122070312,49806000.0,0.0,0.0,4.802001953125,0.0,4.802001953125,76.6036082968171,84.94999694824219,95.1855010986328,91.78838808933904,-8.21161191066097,0.6429296816735928,0.22567136295874357,0.08736865236062363,2860861540.0,1.0
2027,2021-01-21,GOOG,94.9000015258789,96.74299621582033,94.35549926757812,94.5625,41278000.0,0.0,0.0,0.217498779296875,0.0,0.217498779296875,77.07979468825326,84.94999694824219,96.74299621582033,81.51024886590939,-18.48975113409061,1.0456054243251742,0.3896581752320297,0.05818992049976934,2902139540.0,1.0
2028,2021-01-22,GOOG,94.78399658203124,95.54750061035156,94.08799743652344,95.05249786376952,25442000.0,0.0,0.0,0.48999786376951704,0.0,0.48999786376951704,78.23150125947508,84.94999694824219,96.74299621582033,85.66523821723277,-14.334761782767224,1.3882645346312614,0.5893794471118762,0.051925360344641236,2927581540.0,1.0
2029,2021-01-25,GOOG,96.03350067138672,96.47899627685548,93.37650299072266,94.97000122070312,38546000.0,0.0,0.0,-0.08249664306639204,0.08249664306639204,0.0,77.47523238686314,84.94999694824219,96.74299621582033,84.96569909919691,-15.034300900803089,1.6343280422944702,0.798369166148395,0.07509965128097407,2889035540.0,-1.0
2030,2021-01-26,GOOG,94.44200134277344,96.25,94.21224975585938,95.86199951171876,26262000.0,0.0,0.0,0.8919982910156392,0.0,0.8919982910156392,79.89948263795326,84.94999694824219,96.74299621582033,92.52949411670329,-7.470505883296708,1.8796445795783683,1.0146242488343897,0.09772981227814692,2915297540.0,1.0
2031,2021-01-27,GOOG,94.12650299072266,94.5,90.4499969482422,91.53949737548828,54966000.0,0.0,0.0,-4.322502136230483,4.322502136230483,0.0,49.881748813008215,86.07749938964844,96.74299621582033,51.21184765098552,-48.78815234901448,1.705608709550745,1.1528211409776608,0.04354190722336315,2860331540.0,-1.0
2032,2021-01-28,GOOG,92.1969985961914,94.94149780273438,92.13200378417967,93.15550231933594,35462000.0,0.0,0.0,1.6160049438476562,0.0,1.6160049438476562,56.87138847547123,86.07749938964844,96.74299621582033,66.36355572596396,-33.63644427403603,1.6787307589294613,1.258003064568021,0.07064211109283369,2895793540.0,1.0
2033,2021-01-29,GOOG,92.30850219726562,92.86399841308594,90.51000213623048,91.78700256347656,32252000.0,0.0,0.0,-1.368499755859375,1.368499755859375,0.0,50.05082762566274,86.07749938964844,96.74299621582033,53.53246329620265,-46.46753670379735,1.5293736289561508,1.312277177445647,0.05733820401035472,2863541540.0,-1.0
2034,2021-02-01,GOOG,92.67849731445312,96.11959838867188,92.54650115966795,95.06749725341795,32044000.0,0.0,0.0,3.280494689941392,0.0,3.280494689941392,62.49267500423123,86.07749938964844,96.74299621582033,84.29047432379434,-15.709525676205654,1.656619059326161,1.3811455538217499,0.06169659304499242,2895585540.0,1.0
2035,2021-02-02,GOOG,96.12799835205078,97.78800201416016,95.72450256347656,96.37550354003906,45474000.0,0.0,0.0,1.308006286621108,0.0,1.308006286621108,66.34899457612875,86.07749938964844,97.78800201416016,87.93819087521882,-12.061809124781178,1.841776304738815,1.473271704005163,0.021522097546916585,2941059540.0,1.0
2036,2021-02-03,GOOG,103.6500015258789,105.8249969482422,100.91899871826172,103.50350189208984,82364000.0,0.0,0.0,7.127998352050781,0.0,7.127998352050781,79.56198840629816,86.07749938964844,105.8249969482422,88.24410511122163,-11.755894888778371,2.534468872052045,1.6855111376145397,0.09455124274516691,3023423540.0,1.0
2037,2021-02-04,GOOG,103.44450378417967,103.92749786376952,102.12950134277344,103.11849975585938,37046000.0,0.0,0.0,-0.38500213623046875,0.38500213623046875,0.0,77.66155470482724,86.07749938964844,105.8249969482422,86.29448017728704,-13.705519822712963,3.0175814666630885,1.9519252034242498,0.08485838955700209,2986377540.0,-1.0
2038,2021-02-05,GOOG,103.5,105.12550354003906,102.96649932861328,104.9000015258789,30702000.0,0.0,0.0,1.7815017700195312,0.0,1.7815017700195312,80.18818853660093,87.072998046875,105.8249969482422,95.06721695522361,-4.932783044776386,3.503814193762608,2.262303001491922,0.10455933639612369,3017079540.0,1.0
2039,2021-02-08,GOOG,105.29550170898438,106.17735290527344,103.5999984741211,104.64550018310548,24838000.0,0.0,0.0,-0.2545013427734233,0.2545013427734233,0.0,78.72051648359496,90.4499969482422,106.17735290527344,90.25994753121164,-9.740052468788363,3.8245341526790355,2.574749231729345,0.0916265122376565,2992241540.0,-1.0
2040,2021-02-09,GOOG,103.927001953125,105.25650024414062,103.927001953125,104.17549896240234,17798000.0,0.0,0.0,-0.4700012207031392,0.4700012207031392,0.0,75.76558498727607,90.4499969482422,106.17735290527344,87.27151627813113,-12.728483721868864,3.9947330641081322,2.8587459982051024,0.1380387914419292,2974443540.0,-1.0
2041,2021-02-10,GOOG,104.71050262451172,105.4185028076172,103.15450286865234,104.7689971923828,22710000.0,0.0,0.0,0.5934982299804545,0.0,0.5934982299804545,77.02229336860782,90.4499969482422,106.17735290527344,91.04518447513738,-8.954815524862621,4.129900354210747,3.1129768694062316,0.1246678358647666,2997153540.0,1.0
2042,2021-02-11,GOOG,104.97550201416016,105.10150146484376,103.86599731445312,104.79450225830078,18914000.0,0.0,0.0,0.02550506591798296,0.0,0.02550506591798296,77.0812249779261,90.4499969482422,106.17735290527344,91.20735455628557,-8.792645443714425,4.190770853376222,3.3285356662002297,0.14171396092631627,3016067540.0,1.0
2043,2021-02-12,GOOG,104.5124969482422,105.44100189208984,104.15650177001952,105.20549774169922,17114000.0,0.0,0.0,0.4109954833984375,0.0,0.4109954833984375,78.12440669555257,90.4499969482422,106.17735290527344,93.82060680619534,-6.1793931938046525,4.223489307484925,3.5075263944571695,0.10664002715099108,3033181540.0,1.0
2044,2021-02-16,GOOG,105.21800231933594,107.63400268554688,105.21800231933594,106.09500122070312,22676000.0,0.0,0.0,0.8895034790039062,0.0,0.8895034790039062,80.35711666458991,90.4499969482422,107.63400268554688,91.04398887913113,-8.956011120868864,4.271950034157484,3.660411122397232,0.10085029207267504,3055857540.0,1.0
2045,2021-02-17,GOOG,105.0,106.68299865722656,104.9459991455078,106.41549682617188,21418000.0,0.0,0.0,0.32049560546875,0.0,0.32049560546875,81.15667886611611,90.51000213623048,107.63400268554688,92.88422202588843,-7.11577797411157,4.286801249688665,3.785689147855519,0.02813426483983128,3077275540.0,1.0
2046,2021-02-18,GOOG,105.51950073242188,106.63674926757812,105.1855010986328,105.86000061035156,22432000.0,0.0,0.0,-0.5554962158203125,0.5554962158203125,0.0,75.04740453138925,90.51000213623048,107.63400268554688,89.64025917841883,-10.35974082158116,4.205271293077132,3.869605576899842,0.02658592649217062,3054843540.0,-1.0
2047,2021-02-19,GOOG,105.9635009765625,106.52649688720705,104.87049865722656,105.05699920654295,29148000.0,0.0,0.0,-0.803001403808608,0.803001403808608,0.0,66.67566301784188,92.54650115966795,107.63400268554688,82.91961412839825,-17.08038587160174,4.029414134823227,3.9015672884845194,0.0014966413572961024,3025695540.0,-1.0
2048,2021-02-22,GOOG,103.3499984741211,104.5709991455078,103.10700225830078,103.24400329589844,27350000.0,0.0,0.0,-1.812995910644517,1.812995910644517,0.0,51.662184514418065,95.72450256347656,107.63400268554688,63.138676311753606,-36.861323688246394,3.7010886061703445,3.8614715520216847,-0.013392806042827887,2998345540.0,-1.0
2049,2021-02-23,GOOG,101.25050354003906,104.10050201416016,100.10099792480467,103.54299926757812,33348000.0,0.0,0.0,0.2989959716796875,0.0,0.2989959716796875,53.648263042607084,100.10099792480467,107.63400268554688,45.692276217734964,-54.307723782265036,3.4255273879447117,3.7742827192062904,-0.006071482269093709,3031693540.0,1.0
2050,2021-02-24,GOOG,102.09149932861328,105.03900146484376,101.90650177001952,104.7584991455078,24966000.0,0.0,0.0,1.2154998779296733,0.0,1.2154998779296733,61.13807905989849,100.10099792480467,107.63400268554688,61.82793411966777,-38.172065880332234,3.2675574506746443,3.672937665499961,-0.00010020184554904166,3056659540.0,1.0
2051,2021-02-25,GOOG,103.37249755859376,104.74400329589844,101.0644989013672,101.56800079345705,36568000.0,0.0,0.0,-3.190498352050753,3.190498352050753,0.0,41.04902478513263,100.10099792480467,107.63400268554688,19.474338796353464,-80.52566120364654,2.852042019308854,3.50875853626174,-0.03078884288119388,3020091540.0,-1.0
2052,2021-02-26,GOOG,102.5260009765625,103.55049896240234,100.8030014038086,101.84300231933594,41670000.0,0.0,0.0,0.27500152587889204,0.0,0.27500152587889204,42.91453541674195,100.10099792480467,107.63400268554688,23.124960754168306,-76.87503924583169,2.515931281479169,3.3101930853052264,-0.031961213953085266,3061761540.0,1.0
2053,2021-03-01,GOOG,102.82599639892578,104.32599639892578,102.30500030517578,104.07550048828124,28090000.0,0.0,0.0,2.2324981689452983,0.0,2.2324981689452983,55.96691656247976,100.10099792480467,107.63400268554688,52.76118480887523,-47.238815191124765,2.4020160982922647,3.1285576879026347,-0.019034833961883324,3089851540.0,1.0
2054,2021-03-02,GOOG,103.80950164794922,105.21849822998048,103.56300354003906,103.79199981689452,22692000.0,0.0,0.0,-0.28350067138671875,0.28350067138671875,0.0,54.152675416263826,100.10099792480467,107.63400268554688,48.99773741449464,-51.00226258550536,2.2627774698922565,2.9554016443005593,-0.02465333609786924,3067159540.0,-1.0
2055,2021-03-03,GOOG,103.3604965209961,104.4259033203125,100.5,101.33550262451172,29684000.0,0.0,0.0,-2.4564971923827983,2.4564971923827983,0.0,40.89784574134112,100.10099792480467,107.63400268554688,16.387945300932135,-83.61205469906787,1.9319408485922906,2.750709485158906,-0.042740392591660514,3037475540.0,-1.0
2056,2021-03-04,GOOG,101.1685028076172,104.46199798583984,101.01349639892578,102.45449829101562,42360000.0,0.0,0.0,1.1189956665039062,0.0,1.1189956665039062,47.63470984954327,100.10099792480467,107.63400268554688,31.242517972059126,-68.75748202794088,1.7399865591628156,2.548564899959688,-0.0247722753855818,3079835540.0,1.0
2057,2021-03-05,GOOG,103.65599822998048,105.90550231933594,102.32074737548828,105.427001953125,43904000.0,0.0,0.0,2.972503662109375,0.0,2.972503662109375,61.193035245715166,100.10099792480467,107.63400268554688,70.70225225498959,-29.297747745010405,1.806888914459961,2.400229702859743,0.02114407217405212,3123739540.0,1.0
2058,2021-03-08,GOOG,105.05650329589844,106.44049835205078,101.08049774169922,101.20850372314452,32948000.0,0.0,0.0,-4.218498229980483,4.218498229980483,0.0,42.97322453725647,100.10099792480467,106.68299865722656,16.8262788681327,-83.17372113186731,1.502195585711874,2.2206228794301692,-0.022546145668436268,3090791540.0,-1.0
2059,2021-03-09,GOOG,103.5,103.9020004272461,102.3915023803711,102.63500213623048,33946000.0,0.0,0.0,1.426498413085966,0.0,1.426498413085966,48.90863428583287,100.10099792480467,106.63674926757812,38.77142930518074,-61.22857069481926,1.3601514484407602,2.0485285932322874,-0.02027040313290296,3124737540.0,1.0
2060,2021-03-10,GOOG,103.58799743652344,103.75,101.6685028076172,102.75150299072266,25372000.0,0.0,0.0,0.11650085449217329,0.0,0.11650085449217329,49.404868091944266,100.10099792480467,106.52649688720705,41.24979369581922,-58.750206304180786,1.2426565207554745,1.8873541787369248,0.011652313602906528,3150109540.0,1.0
2061,2021-03-11,GOOG,103.7030029296875,106.28500366210938,103.61900329589844,105.7385025024414,24782000.0,0.0,0.0,2.98699951171875,0.0,2.98699951171875,60.697859283118824,100.10099792480467,106.44049835205078,88.92663771119386,-11.073362288806146,1.3747199256889502,1.78482732812733,0.03825005247676083,3174891540.0,1.0
2062,2021-03-12,GOOG,104.25,104.51300048828124,102.37750244140624,103.09600067138672,34516000.0,0.0,0.0,-2.6425018310546875,2.6425018310546875,0.0,49.43470029723857,100.10099792480467,106.44049835205078,47.243513601009106,-52.7564863989909,1.251724214533425,1.678206705408549,-0.009411435086058573,3140375540.0,-1.0
2063,2021-03-15,GOOG,103.11499786376952,103.35299682617188,102.17549896240234,103.32450103759766,25962000.0,0.0,0.0,0.2285003662109375,0.0,0.2285003662109375,50.353861790977334,100.5,106.44049835205078,47.54653347597649,-52.45346652402352,1.159323339399549,1.574430032206749,-0.004504188956004351,3166337540.0,1.0
2064,2021-03-16,GOOG,103.94950103759766,106.1780014038086,103.5,104.6259994506836,29832000.0,0.0,0.0,1.3014984130859375,0.0,1.3014984130859375,55.651941604788185,100.5,106.44049835205078,69.45544306496129,-30.544556935038713,1.177541064604668,1.495052238686333,0.032471313024068804,3196169540.0,1.0
2065,2021-03-17,GOOG,103.80149841308594,105.48899841308594,102.6999969482422,104.5540008544922,25980000.0,0.0,0.0,-0.07199859619139204,0.07199859619139204,0.0,55.27541701430063,100.5,106.44049835205078,68.24344716959104,-31.756552830408953,1.1726514619824968,1.430572083345566,0.02049204865083687,3170189540.0,-1.0
2066,2021-03-18,GOOG,103.0500030517578,103.7750015258789,101.67749786376952,101.81099700927734,27228000.0,0.0,0.0,-2.743003845214858,2.743003845214858,0.0,42.60425837243363,100.5,106.44049835205078,22.0688052009098,-77.93119479909019,0.9366419057573268,1.3317860478279182,-0.034298660465137853,3142961540.0,-1.0
2067,2021-03-19,GOOG,102.10250091552734,102.65499877929688,100.88400268554688,102.16000366210938,46298000.0,0.0,0.0,0.34900665283203125,0.0,0.34900665283203125,44.47297688295468,100.5,106.44049835205078,27.943845174812783,-72.05615482518722,0.7689011385047451,1.2192090659632837,0.009401383322173107,3189259540.0,1.0
2068,2021-03-22,GOOG,102.09200286865234,102.89949798583984,101.30349731445312,101.92949676513672,39096000.0,0.0,0.0,-0.23050689697265625,0.23050689697265625,0.0,43.39622825766977,100.5,106.44049835205078,24.06358322855569,-75.93641677144431,0.6103298887505559,1.0974332305207382,-0.006873925623904875,3150163540.0,-1.0
2069,2021-03-23,GOOG,102.58499908447266,103.61509704589844,101.96099853515624,102.64800262451172,27340000.0,0.0,0.0,0.718505859375,0.0,0.718505859375,47.93038748698245,100.88400268554688,106.44049835205078,31.746626738120643,-68.25337326187936,0.5364545349759169,0.9852374914117739,-0.0010072880999150158,3177503540.0,1.0
2070,2021-03-24,GOOG,103.26850128173828,103.9104995727539,102.07775115966795,102.25299835205078,23080000.0,0.0,0.0,-0.3950042724609375,0.3950042724609375,0.0,45.612691433346114,100.88400268554688,106.44049835205078,24.63775279726377,-75.36224720273623,0.44095122997067904,0.876380239123555,-0.032963434017898474,3154423540.0,-1.0
2071,2021-03-25,GOOG,102.2405014038086,102.94349670410156,100.5364990234375,102.21800231933594,28378000.0,0.0,0.0,-0.03499603271484375,0.03499603271484375,0.0,45.388326675631674,100.5364990234375,106.44049835205078,28.480750120501547,-71.51924987949846,0.35830991170190885,0.7727661736392257,-0.00851631825030108,3126045540.0,-1.0
2072,2021-03-26,GOOG,101.94300079345705,102.54949951171876,100.70099639892578,101.77749633789062,29870000.0,0.0,0.0,-0.4405059814453125,0.4405059814453125,0.0,42.36193174633711,100.5364990234375,106.28500366210938,21.588176272914044,-78.41182372708595,0.2543390579948266,0.669080750510346,-0.014972292962190159,3096175540.0,-1.0
2073,2021-03-29,GOOG,101.3939971923828,102.92150115966795,100.78099822998048,102.79750061035156,24596000.0,0.0,0.0,1.0200042724609375,0.0,1.0200042724609375,51.07737139605411,100.5364990234375,106.28500366210938,39.33199551938503,-60.66800448061497,0.2513498233152518,0.5855345650713272,-0.017476524477014976,3120771540.0,1.0
2074,2021-03-30,GOOG,102.88150024414062,103.53900146484376,102.20149993896484,102.7770004272461,20732000.0,0.0,0.0,-0.02050018310546875,0.02050018310546875,0.0,50.898890452080494,100.5364990234375,106.28500366210938,38.97537785280861,-61.02462214719139,0.2445081026397844,0.5173292725850186,-0.016996006013382137,3100039540.0,-1.0
2075,2021-03-31,GOOG,102.95600128173828,104.66635131835938,102.83724975585938,103.43150329589844,29198000.0,0.0,0.0,0.6545028686523438,0.0,0.6545028686523438,56.49863163291158,100.5364990234375,106.1780014038086,51.316193405035946,-48.68380659496405,0.28857241809835443,0.47157790168768576,0.015916809914683583,3129237540.0,1.0
2076,2021-04-01,GOOG,104.89749908447266,107.14700317382812,104.84449768066406,106.8874969482422,33980000.0,0.0,0.0,3.455993652343764,0.0,3.455993652343764,74.33308031548222,100.5364990234375,107.14700317382812,96.0743353353679,-3.9256646646321016,0.5954989689369086,0.4963621151375303,0.0462753828961171,3163217540.0,1.0
2077,2021-04-05,GOOG,107.64700317382812,111.8655014038086,107.58100128173828,111.27749633789062,43298000.0,0.0,0.0,4.389999389648423,0.0,4.389999389648423,83.96711046505659,100.5364990234375,111.8655014038086,94.80973658424892,-5.19026341575107,1.1793815572987683,0.632966003569778,0.09171044564551645,3206515540.0,1.0
2078,2021-04-06,GOOG,111.125,111.88300323486328,110.73999786376952,111.2375030517578,27060000.0,0.0,0.0,-0.03999328613282671,0.03999328613282671,0.0,83.63711813430871,100.5364990234375,111.88300323486328,94.31102151748667,-5.688978482513344,1.6202088323944963,0.8304145693347217,0.08367917745722364,3179455540.0,-1.0
2079,2021-04-07,GOOG,111.30650329589844,112.75,111.2665023803711,112.48400115966795,25798000.0,0.0,0.0,1.2464981079101562,0.0,1.2464981079101562,85.66337297555161,100.5364990234375,112.75,97.82209179135046,-2.1779082086495323,2.0465581553096683,1.0736432865297112,0.10005577315583891,3205253540.0,1.0
2080,2021-04-08,GOOG,113.89800262451172,114.20024871826172,112.88400268554688,113.27200317382812,27166000.0,0.0,0.0,0.7880020141601705,0.0,0.7880020141601705,86.85107658704284,100.5364990234375,114.20024871826172,93.20650944897497,-6.793490551025023,2.4201304845886398,1.342940726141497,0.10814142913846769,3232419540.0,1.0
2081,2021-04-09,GOOG,112.83499908447266,114.4520034790039,112.68569946289062,114.29399871826172,20888000.0,0.0,0.0,1.0219955444335938,0.0,1.0219955444335938,88.30139912500611,100.5364990234375,114.4520034790039,98.86454162515838,-1.1354583748416196,2.7667622334704305,1.627705027607284,0.12297907524486185,3253307540.0,1.0
2082,2021-04-12,GOOG,113.3125,113.76599884033205,111.92324829101562,112.739501953125,31318000.0,0.0,0.0,-1.5544967651367188,1.5544967651367188,0.0,73.98022086259303,100.5364990234375,114.4520034790039,87.69357207748311,-12.30642792251689,2.882804320606553,1.878724886207138,0.09671442674912956,3221989540.0,-1.0
2083,2021-04-13,GOOG,113.07350158691406,113.8604965209961,112.80449676513672,113.3635025024414,23310000.0,0.0,0.0,0.6240005493164062,0.0,0.6240005493164062,75.79825059526114,100.5364990234375,114.4520034790039,92.17778284619007,-7.822217153809927,2.990645836449474,2.101109076255605,0.10300458304082638,3245299540.0,1.0
2084,2021-04-14,GOOG,113.75800323486328,113.89949798583984,112.45950317382812,112.74199676513672,20220000.0,0.0,0.0,-0.6215057373046875,0.6215057373046875,0.0,70.16419654595501,100.5364990234375,114.4520034790039,87.71150036761219,-12.288499632387813,2.991476813277046,2.2791826236598935,0.09001603160115224,3225079540.0,-1.0
2085,2021-04-15,GOOG,113.8489990234375,115.32984924316406,113.3000030517578,114.83300018310548,27472000.0,0.0,0.0,2.091003417968764,0.0,2.091003417968764,76.84542292232216,100.70099639892578,115.32984924316406,96.60363621571142,-3.3963637842885848,3.124840651104961,2.4483142291489073,0.0743351978642619,3252551540.0,1.0
2086,2021-04-16,GOOG,115.1500015258789,115.3219985961914,114.22250366210938,114.88800048828124,22596000.0,0.0,0.0,0.05500030517575283,0.0,0.05500030517575283,77.00172758252258,100.78099822998048,115.32984924316406,96.96299897165459,-3.0370010283454087,3.198104757495784,2.598272334818283,0.03244595061185973,3275147540.0,1.0
2087,2021-04-19,GOOG,114.5989990234375,115.92250061035156,114.39225006103516,115.12000274658205,24688000.0,0.0,0.0,0.23200225830080967,0.0,0.23200225830080967,77.73331407263152,102.20149993896484,115.92250061035156,94.15131678083058,-5.848683219169409,3.237567075045405,2.7261312828637076,0.03490279436619281,3299835540.0,1.0
2088,2021-04-20,GOOG,115.39450073242188,115.4800033569336,113.58550262451172,114.68150329589844,21774000.0,0.0,0.0,-0.43849945068360796,0.43849945068360796,0.0,72.69050096500041,102.83724975585938,115.92250061035156,90.51606019438987,-9.483939805610134,3.196609480762845,2.8202269224435352,0.01953613059257364,3278061540.0,-1.0
2089,2021-04-21,GOOG,114.2624969482422,114.76599884033205,112.92849731445312,114.66449737548828,23930000.0,0.0,0.0,-0.01700592041015625,0.01700592041015625,0.0,72.48009239593979,104.84449768066406,115.92250061035156,88.64413339797909,-11.355866602020914,3.1267350017820945,2.8815285383112474,0.012293366080259327,3254131540.0,-1.0
2090,2021-04-22,GOOG,114.6614990234375,115.18810272216795,112.82250213623048,113.39600372314452,21096000.0,0.0,0.0,-1.2684936523437642,1.2684936523437642,0.0,58.02457096905402,107.58100128173828,115.92250061035156,69.71171743021577,-30.288282569784236,2.935167355079926,2.8922563016649834,-0.00785688667110851,3233035540.0,-1.0
2091,2021-04-23,GOOG,114.17350006103516,116.29100036621094,113.9104995727539,115.76499938964844,28670000.0,0.0,0.0,2.3689956665039205,0.0,2.3689956665039205,70.64188811384827,110.73999786376952,116.29100036621094,90.52421654771086,-9.475783452289138,2.940609253651715,2.9019268920623302,0.026836178838020697,3261705540.0,1.0
2092,2021-04-26,GOOG,115.99649810791016,117.06300354003906,115.69200134277344,116.33699798583984,20834000.0,0.0,0.0,0.5719985961914062,0.0,0.5719985961914062,72.91045789808106,111.2665023803711,117.06300354003906,87.47510723795308,-12.524892762046914,2.9569911504779043,2.9129397437454454,0.026229742534061185,3282539540.0,1.0
2093,2021-04-27,GOOG,116.8000030517578,116.87249755859376,115.2135009765625,115.3560028076172,31972000.0,0.0,0.0,-0.980995178222642,0.980995178222642,0.0,63.24021898938445,111.92324829101562,117.06300354003906,66.7882875795264,-33.211712420473596,2.8578720394666703,2.901926202889691,0.023185734841347116,3250567540.0,-1.0
2094,2021-04-28,GOOG,120.35724639892578,122.618896484375,118.74250030517578,118.99549865722656,59728000.0,0.0,0.0,3.639495849609361,0.0,3.639495849609361,76.55276802705696,111.92324829101562,122.618896484375,66.12269063413937,-33.87730936586062,3.037976427224791,2.9291362477567113,0.03624827765088279,3310295540.0,1.0
2095,2021-04-29,GOOG,120.5165023803711,121.82599639892578,120.11399841308594,121.49449920654295,39554000.0,0.0,0.0,2.499000549316392,0.0,2.499000549316392,81.78035479994921,111.92324829101562,122.618896484375,89.48733861188374,-10.51266138811626,3.3438135107161173,3.012071700348593,0.057503818416054564,3349849540.0,1.0
2096,2021-04-30,GOOG,120.22450256347656,121.35700225830078,120.10800170898438,120.50599670410156,39142000.0,0.0,0.0,-0.988502502441392,0.988502502441392,0.0,74.22714172902727,112.45950317382812,122.618896484375,79.20250042805262,-20.797499571947384,3.4664684219665105,3.102951044672177,0.04678590886916423,3310707540.0,-1.0
2097,2021-05-03,GOOG,120.13600158691406,120.98500061035156,119.2249984741211,119.7584991455078,33788000.0,0.0,0.0,-0.7474975585937642,0.7474975585937642,0.0,68.69152732567535,112.45950317382812,122.618896484375,71.8448016389157,-28.1551983610843,3.463432226141336,3.1750472809660093,0.04427039848361436,3276919540.0,-1.0
2098,2021-05-04,GOOG,118.48699951171876,118.96299743652344,115.58499908447266,117.7125015258789,35120000.0,0.0,0.0,-2.045997619628892,2.045997619628892,0.0,55.59680777106755,112.82250213623048,122.618896484375,49.91631835007348,-50.08368164992652,3.2583706417934764,3.1917119531315032,0.02658193442744028,3241799540.0,-1.0
2099,2021-05-05,GOOG,118.4209976196289,119.11000061035156,117.57050323486328,117.83699798583984,21806000.0,0.0,0.0,0.1244964599609375,0.0,0.1244964599609375,56.18326031362294,112.82250213623048,122.618896484375,51.187157962451046,-48.81284203754895,3.0705087689048014,3.1674713162861634,0.039163587047899684,3263605540.0,1.0
2100,2021-05-06,GOOG,117.53199768066406,119.135498046875,117.1168975830078,119.06749725341795,20618000.0,0.0,0.0,1.2304992675781108,0.0,1.2304992675781108,61.91911312171532,112.82250213623048,122.618896484375,63.747894329818436,-36.25210567018157,2.986491473668849,3.131275347762701,0.028527602307963473,3284223540.0,1.0
2101,2021-05-07,GOOG,120.0,120.82050323486328,119.5,119.93450164794922,23272000.0,0.0,0.0,0.8670043945312642,0.0,0.8670043945312642,65.58206028467933,112.82250213623048,122.618896484375,72.59813416010333,-27.40186583989668,2.9557946103136032,3.0961792002728816,0.03092312612834691,3307495540.0,1.0
2102,2021-05-10,GOOG,118.74449920654295,118.9000015258789,116.73650360107422,117.08300018310548,26006000.0,0.0,0.0,-2.851501464843736,2.851501464843736,0.0,48.044550054489804,112.82250213623048,122.618896484375,43.490471039295784,-56.509528960704216,2.670589889858988,3.0110613381901032,0.014971023036993047,3281489540.0,-1.0
2103,2021-05-11,GOOG,114.59300231933594,116.0999984741211,114.1500015258789,115.43800354003906,32110000.0,0.0,0.0,-1.6449966430664205,1.6449966430664205,0.0,40.78481598736327,112.82250213623048,122.618896484375,26.698612886117306,-73.3013871138827,2.285480021795422,2.8659450749111675,-0.029896047811313164,3249379540.0,-1.0
2104,2021-05-12,GOOG,113.08550262451172,114.26850128173828,111.50250244140624,111.9540023803711,34934000.0,0.0,0.0,-3.4840011596679688,3.4840011596679688,0.0,29.785925789075733,111.50250244140624,122.618896484375,4.061568321702634,-95.93843167829736,1.6797843913812613,2.6287129382051866,-0.07852616281789704,3214445540.0,-1.0
2105,2021-05-13,GOOG,113.05449676513672,113.83004760742188,112.13600158691406,113.09850311279295,26670000.0,0.0,0.0,1.1445007324218608,0.0,1.1445007324218608,36.2975888572988,111.50250244140624,122.618896484375,14.357179722287785,-85.64282027771222,1.2773928944536266,2.3584489294548745,-0.061469916800053204,3241115540.0,1.0
2106,2021-05-14,GOOG,114.59149932861328,116.05699920654295,114.16600036621094,115.80799865722656,26624000.0,0.0,0.0,2.709495544433608,0.0,2.709495544433608,49.17350599486188,111.50250244140624,122.618896484375,38.731050727223895,-61.268949272776105,1.1637138118645112,2.1195019059368017,-0.03298722442639612,3267739540.0,1.0
2107,2021-05-17,GOOG,115.46600341796876,116.16699981689452,114.75,116.07050323486328,19842000.0,0.0,0.0,0.26250457763671875,0.0,0.26250457763671875,50.29657126743632,111.50250244140624,122.618896484375,41.092469156815774,-58.90753084318423,1.0823278438142836,1.912067093512298,-0.013949226035729345,3287581540.0,1.0
2108,2021-05-18,GOOG,116.84529876708984,117.15750122070312,115.15799713134766,115.17150115966795,17302000.0,0.0,0.0,-0.8990020751953267,0.8990020751953267,0.0,46.25760943047717,111.50250244140624,121.82599639892578,35.540280580967945,-64.45971941903204,0.9345144230321125,1.716556559416261,-0.022620203091835323,3270279540.0,-1.0
2109,2021-05-19,GOOG,113.22000122070312,115.83799743652344,113.1760025024414,115.4355010986328,19350000.0,0.0,0.0,0.26399993896484375,0.0,0.26399993896484375,47.68118430141278,111.50250244140624,121.35700225830078,39.910687810697745,-60.089312189302255,0.8291162745528737,1.5390685024435835,-0.03050367429034795,3289629540.0,1.0
2110,2021-05-20,GOOG,116.4020004272461,118.01699829101562,116.05449676513672,117.80449676513672,23832000.0,0.0,0.0,2.3689956665039205,0.0,2.3689956665039205,58.94199224187215,111.50250244140624,120.98500061035156,66.4592200436081,-33.54077995639191,0.9260704703708456,1.4164688960290361,-0.01775973430118405,3313461540.0,1.0
2111,2021-05-21,GOOG,118.29949951171876,118.4499969482422,117.11849975585938,117.25499725341795,22832000.0,0.0,0.0,-0.5494995117187642,0.5494995117187642,0.0,55.73155797667471,111.50250244140624,120.82050323486328,61.73528999966421,-38.264710000335796,0.9476435063831872,1.3227038180998665,0.001469018303626335,3290629540.0,-1.0
2112,2021-05-24,GOOG,118.3499984741211,120.92400360107422,118.00550079345705,120.33350372314452,21244000.0,0.0,0.0,3.0785064697265625,0.0,3.0785064697265625,67.2593657481818,111.50250244140624,120.92400360107422,93.73242259463342,-6.267577405366589,1.199324965158695,1.2980280475116324,0.04240804616312932,3311873540.0,1.0
2113,2021-05-25,GOOG,121.0,121.64450073242188,120.14949798583984,120.45349884033205,18838000.0,0.0,0.0,0.11999511718752842,0.0,0.11999511718752842,67.6383788024263,111.50250244140624,121.64450073242188,88.25673345710493,-11.743266542895071,1.3924160323492458,1.3169056444791551,0.07591954087611219,3330711540.0,1.0
2114,2021-05-26,GOOG,120.6417465209961,122.14720153808594,120.62574768066406,121.67649841308594,21856000.0,0.0,0.0,1.222999572753892,0.0,1.222999572753892,71.51610463464769,111.50250244140624,122.14720153808594,95.57805137820363,-4.421948621796382,1.62539143800484,1.3786028031842923,0.07584534776502005,3352567540.0,1.0
2115,2021-05-27,GOOG,121.84700012207033,122.0,120.0999984741211,120.12550354003906,38962000.0,0.0,0.0,-1.550994873046875,1.550994873046875,0.0,60.84720922995635,111.50250244140624,122.14720153808594,81.00746691207567,-18.992533087924336,1.665672960392186,1.4360168346258713,0.03728157754967887,3313605540.0,-1.0
2116,2021-05-28,GOOG,121.0979995727539,121.40699768066406,120.3844985961914,120.5780029296875,24108000.0,0.0,0.0,0.4524993896484375,0.0,0.4524993896484375,62.719416181386414,111.50250244140624,122.14720153808594,85.25840332219533,-14.741596677804658,1.7143473470734136,1.49168293711538,0.03883415311557248,3337713540.0,1.0
2117,2021-06-01,GOOG,121.0999984741211,121.89855194091795,120.24400329589844,121.4905014038086,19166000.0,0.0,0.0,0.9124984741210938,0.0,0.9124984741210938,66.45207928393981,111.50250244140624,122.14720153808594,93.83073088010367,-6.169269119896324,1.8057377294791905,1.5544938955881422,0.05486600574373246,3356879540.0,1.0
2118,2021-06-02,GOOG,121.7655029296875,122.0999984741211,120.20999908447266,121.06400299072266,17158000.0,0.0,0.0,-0.4264984130859375,0.4264984130859375,0.0,63.04769570699564,112.13600158691406,122.14720153808594,89.18013272488393,-10.819867275116065,1.82273900776201,1.608142918022916,0.0487588466158313,3339721540.0,-1.0
2119,2021-06-03,GOOG,119.7509994506836,120.48725128173828,119.1415023803711,120.23049926757812,18346000.0,0.0,0.0,-0.8335037231445312,0.8335037231445312,0.0,56.51851503716794,113.1760025024414,122.14720153808594,78.63493761656233,-21.365062383437667,1.7487968175873192,1.6362736979357968,0.02059346263562456,3321375540.0,-1.0
2120,2021-06-04,GOOG,121.1259994506836,122.69294738769533,120.88849639892578,122.58799743652344,25948000.0,0.0,0.0,2.3574981689453125,0.0,2.3574981689453125,67.50195594068387,113.1760025024414,122.69294738769533,98.89723065083098,-1.1027693491690223,1.8589981257413655,1.6808185834969107,0.045482071621898656,3347323540.0,1.0
2121,2021-06-07,GOOG,122.56600189208984,123.4000015258789,122.05364990234376,123.30449676513672,23850000.0,0.0,0.0,0.7164993286132812,0.0,0.7164993286132812,70.14644869652804,113.1760025024414,123.4000015258789,99.06587666407975,-0.9341233359202437,1.9813096597601003,1.7409167987495486,0.024689657909634732,3371173540.0,1.0
2122,2021-06-08,GOOG,123.99500274658205,124.72474670410156,123.41200256347656,124.14250183105467,25060000.0,0.0,0.0,0.8380050659179545,0.0,0.8380050659179545,73.10043929745541,113.1760025024414,124.72474670410156,94.95837068619815,-5.041629313801844,2.121408164209697,1.8170150718415783,0.030625951310991884,3396233540.0,1.0
2123,2021-06-09,GOOG,124.9749984741211,125.25,124.3665008544922,124.56999969482422,20126000.0,0.0,0.0,0.42749786376954546,0.0,0.42749786376954546,74.58093738437462,116.05449676513672,125.25,92.60507785373106,-7.394922146268937,2.2410987518232304,1.9018318078379088,0.02378028065793769,3416359540.0,1.0
2124,2021-06-10,GOOG,124.70050048828124,126.16300201416016,124.6999969482422,126.08000183105467,31234000.0,0.0,0.0,1.5100021362304545,0.0,1.5100021362304545,79.23809890385456,117.11849975585938,126.16300201416016,99.08231342383371,-0.9176865761662871,2.429789852680443,2.007423416806416,0.04956897674132055,3447593540.0,1.0
2125,2021-06-11,GOOG,126.24600219726562,126.34950256347656,124.91449737548828,125.69650268554688,25240000.0,0.0,0.0,-0.3834991455077983,0.3834991455077983,0.0,75.20055232596434,118.00550079345705,126.34950256347656,92.17402038101245,-7.825979618987546,2.51934232348043,2.1098071981412185,0.04244969755258032,3422353540.0,-1.0
2126,2021-06-14,GOOG,125.66950225830078,126.4114990234375,125.0469970703125,126.35199737548828,22550000.0,0.0,0.0,0.6554946899414062,0.0,0.6554946899414062,77.46514903748707,119.1415023803711,126.4114990234375,99.181545042308,-0.8184549576919969,2.613084236569975,2.21046260582697,0.04001544084109998,3444903540.0,1.0
2127,2021-06-15,GOOG,126.52200317382812,126.86199951171876,125.64849853515624,126.03299713134766,22182000.0,0.0,0.0,-0.319000244140625,0.319000244140625,0.0,73.68674844127037,119.1415023803711,126.86199951171876,89.26231865296478,-10.737681347035219,2.631302704710734,2.2946306256037228,0.04104435685152241,3422721540.0,-1.0
2128,2021-06-16,GOOG,126.24749755859376,126.52349853515624,124.1499481201172,125.69650268554688,26316000.0,0.0,0.0,-0.33649444580078125,0.33649444580078125,0.0,69.55741578836164,119.1415023803711,126.86199951171876,84.90386297224822,-15.096137027751775,2.588747215928521,2.3534539436686823,0.04546270248619644,3396405540.0,-1.0
2129,2021-06-17,GOOG,125.52300262451172,127.19650268554688,125.51499938964844,126.37100219726562,25756000.0,0.0,0.0,0.67449951171875,0.0,0.67449951171875,73.05038451131642,119.1415023803711,127.19650268554688,89.75170134070856,-10.248298659291427,2.5797108570946534,2.398705326353877,0.03085950370223678,3422161540.0,1.0
2130,2021-06-18,GOOG,125.70549774169922,126.38899993896484,124.60299682617188,125.56749725341795,53306000.0,0.0,0.0,-0.8035049438476705,0.8035049438476705,0.0,63.09886203670328,119.1415023803711,127.19650268554688,79.77646964107258,-20.22353035892742,2.479135413973765,2.4147913438778548,0.0183529437096821,3368855540.0,-1.0
2131,2021-06-21,GOOG,125.73999786376952,127.03675079345705,125.13424682617188,126.45500183105467,26256000.0,0.0,0.0,0.8875045776367188,0.0,0.8875045776367188,68.55781867998864,119.1415023803711,127.19650268554688,90.79452729485625,-9.205472705143743,2.4428828204116257,2.420409639184609,0.01862778634143436,3395111540.0,1.0
2132,2021-06-22,GOOG,126.4499969482422,127.2699966430664,126.02649688720705,126.99949645996094,20984000.0,0.0,0.0,0.5444946289062642,0.0,0.5444946289062642,71.53839457240329,119.1415023803711,127.2699966430664,96.67219814194992,-3.32780185805008,2.430076139779544,2.4223429393035962,0.019503064711315687,3416095540.0,1.0
2133,2021-06-23,GOOG,126.5500030517578,127.7959976196289,126.2519989013672,126.46150207519533,19694000.0,0.0,0.0,-0.5379943847656108,0.5379943847656108,0.0,64.56105028740271,120.88849639892578,127.7959976196289,80.68048775099979,-19.319512249000216,2.3494323092770344,2.407760813298284,0.003025858491435107,3396401540.0,-1.0
2134,2021-06-24,GOOG,127.05349731445312,127.5354995727539,126.95999908447266,127.28199768066406,18934000.0,0.0,0.0,0.8204956054687358,0.0,0.8204956054687358,69.75248184384725,122.05364990234376,127.7959976196289,91.04895829596589,-8.95104170403411,2.3249283045130227,2.391194311541232,0.012613676285676778,3415335540.0,1.0
2135,2021-06-25,GOOG,126.95700073242188,127.50499725341795,126.44400024414062,126.99500274658205,33484000.0,0.0,0.0,-0.28699493408201704,0.28699493408201704,0.0,65.85875327533196,123.41200256347656,127.7959976196289,81.7291109413371,-18.270889058662895,2.256340917953324,2.3642236328236503,0.005089000446766967,3381851540.0,-1.0
2136,2021-06-28,GOOG,127.0,127.33699798583984,125.97380065917967,126.81950378417967,28110000.0,0.0,0.0,-0.17549896240237217,0.17549896240237217,0.0,63.363064579650455,124.1499481201172,127.7959976196289,73.21775703867955,-26.782242961320453,2.162891157488957,2.323957137756712,0.006240482022436877,3353741540.0,-1.0
2137,2021-06-29,GOOG,126.77249908447266,127.0,125.43699645996094,126.01850128173828,20950000.0,0.0,0.0,-0.801002502441392,0.801002502441392,0.0,52.821706604481236,124.1499481201172,127.7959976196289,51.24870525952334,-48.75129474047665,2.0011295653920342,2.2593916232837765,0.002561714839409257,3332791540.0,-1.0
2138,2021-06-30,GOOG,125.65354919433594,125.8000030517578,124.75749969482422,125.31600189208984,24006000.0,0.0,0.0,-0.7024993896484375,0.7024993896484375,0.0,45.21040741547316,124.1499481201172,127.7959976196289,31.981292961842815,-68.01870703815717,1.7955485426046351,2.1666230071479484,-0.008348436641571588,3308785540.0,-1.0
2139,2021-07-01,GOOG,124.84974670410156,126.4625015258789,124.84974670410156,126.36849975585938,17120000.0,0.0,0.0,1.0524978637695312,0.0,1.0524978637695312,56.13666011893486,124.1499481201172,127.7959976196289,60.84809424664398,-39.15190575335601,1.69797864160347,2.0728941340390525,0.006379059230788409,3325905540.0,1.0
2140,2021-07-02,GOOG,126.8395004272461,128.84800720214844,126.7689971923828,128.718994140625,21160000.0,0.0,0.0,2.350494384765625,0.0,2.350494384765625,71.02582071974658,124.1499481201172,128.84800720214844,97.25390721421796,-2.7460927857820354,1.7896886285883795,2.016253032948918,0.017903540997097567,3347065540.0,1.0
2141,2021-07-06,GOOG,129.44949340820312,129.88450622558594,128.40899658203125,129.77099609375,21350000.0,0.0,0.0,1.052001953125,0.0,1.052001953125,75.34734917307873,124.1499481201172,129.88450622558594,98.02059496567506,-1.9794050343249479,1.9250662542122967,1.9980156772015938,0.02182291828741878,3368415540.0,1.0
2142,2021-07-07,GOOG,130.34100341796875,130.639892578125,129.75999450683594,130.07749938964844,16680000.0,0.0,0.0,0.3065032958984375,0.0,0.3065032958984375,76.52443671976177,124.60299682617188,130.639892578125,90.68406658679487,-9.315933413205133,2.0336436739128203,2.0051412765438394,0.028593660957016098,3385095540.0,1.0
2143,2021-07-08,GOOG,128.25,130.03250122070312,128.0399932861328,129.177001953125,19780000.0,0.0,0.0,-0.9004974365234375,0.9004974365234375,0.0,65.86371509940616,124.60299682617188,130.639892578125,75.76750228746772,-24.23249771253229,2.023701473056221,2.0088533158463155,0.014888234840682468,3365315540.0,-1.0
2144,2021-07-09,GOOG,128.9445037841797,129.84950256347656,128.94349670410156,129.57449340820312,15106000.0,0.0,0.0,0.397491455078125,0.0,0.397491455078125,68.1253626992798,124.75749969482422,130.639892578125,81.88833709243765,-18.111662907562348,2.0245585944647644,2.0119943715700055,0.02031174932740032,3380421540.0,1.0
2145,2021-07-12,GOOG,129.83349609375,130.77000427246094,129.60000610351562,130.56399536132812,16944000.0,0.0,0.0,0.989501953125,0.0,0.989501953125,73.22140706767003,124.75749969482422,130.77000427246094,96.57365897235147,-3.4263410276485238,2.0810928642567745,2.0258140701073595,0.02952614909707263,3397365540.0,1.0
2146,2021-07-13,GOOG,130.88150024414062,132.04200744628906,130.63699340820312,130.9945068359375,16618000.0,0.0,0.0,0.430511474609375,0.0,0.430511474609375,75.21099452577269,124.75749969482422,132.04200744628906,85.62015930121125,-14.379840698788746,2.136012733273404,2.047853802740568,0.03948630957826116,3413983540.0,1.0
2147,2021-07-14,GOOG,131.90150451660156,132.99600219726562,131.8979949951172,132.08250427246094,17912000.0,0.0,0.0,1.0879974365234375,0.0,1.0879974365234375,79.62525963162665,124.75749969482422,132.99600219726562,88.91184502846264,-11.08815497153737,2.2414909135273433,2.086581224897923,0.05399551755726906,3431895540.0,1.0
2148,2021-07-15,GOOG,132.5,132.59500122070312,130.59800720214844,131.26649475097656,16586000.0,0.0,0.0,-0.816009521484375,0.816009521484375,0.0,68.99312672698166,124.75749969482422,132.99600219726562,79.00701679975775,-20.99298320024226,2.233491680804164,2.1159633160791715,0.038759619719946015,3415309540.0,-1.0
2149,2021-07-16,GOOG,131.64100646972656,132.18299865722656,130.82150268554688,131.8455047607422,14856000.0,0.0,0.0,0.579010009765625,0.0,0.579010009765625,72.04881160515149,124.75749969482422,132.99600219726562,86.03511455895658,-13.964885441043418,2.2479604117196885,2.142362735207275,0.024289427065453006,3430165540.0,1.0
2150,2021-07-19,GOOG,131.15550231933594,131.2469940185547,128.53700256347656,129.25399780273438,25710000.0,0.0,0.0,-2.5915069580078125,2.5915069580078125,0.0,47.74802923589014,124.75749969482422,132.99600219726562,54.57907073011945,-45.420929269880546,2.026948629755779,2.1192799141169756,-0.003983927892809991,3404455540.0,-1.0
2151,2021-07-20,GOOG,130.00399780273438,132.0013427734375,129.1884002685547,131.10150146484375,19084000.0,0.0,0.0,1.847503662109375,0.0,1.847503662109375,59.09644676402106,124.75749969482422,132.99600219726562,77.00430713153929,-22.9956928684607,1.978071330553405,2.0910381974042616,0.007872246007189165,3423539540.0,1.0
2152,2021-07-21,GOOG,130.78700256347656,132.61724853515625,130.60150146484375,132.60049438476562,14742000.0,0.0,0.0,1.498992919921875,0.0,1.498992919921875,66.0079454016297,124.84974670410156,132.99600219726562,95.14491274141977,-4.855087258580224,2.036812809627321,2.0801931198488735,0.026502336947585414,3438281540.0,1.0
2153,2021-07-22,GOOG,132.64999389648438,133.50450134277344,132.39999389648438,133.32850646972656,13608000.0,0.0,0.0,0.7280120849609375,0.0,0.7280120849609375,68.9481996707045,126.7689971923828,133.50450134277344,97.38705716577032,-2.6129428342296817,2.1176988320937653,2.087694262297852,0.028971852119823005,3451889540.0,1.0
2154,2021-07-23,GOOG,135.25999450683594,138.80850219726562,134.70050048828125,137.8159942626953,26378000.0,0.0,0.0,4.48748779296875,0.0,4.48748779296875,80.77532296933029,128.0399932861328,138.80850219726562,90.78323709660279,-9.216762903397216,2.5149139860909884,2.1731382070564793,0.055543634991390256,3478267540.0,1.0
2155,2021-07-26,GOOG,138.25,139.71299743652344,137.6510009765625,139.64450073242188,23052000.0,0.0,0.0,1.8285064697265625,0.0,1.8285064697265625,83.69511094326799,128.0399932861328,139.71299743652344,99.41320414848589,-0.5867958515141136,2.9433262155987165,2.327175808764927,0.06603325670226745,3501319540.0,1.0
2156,2021-07-27,GOOG,140.01100158691406,140.01100158691406,135.10000610351562,136.79649353027344,42164000.0,0.0,0.0,-2.8480072021484375,2.8480072021484375,0.0,65.74888458971857,128.0399932861328,140.01100158691406,73.14755803459897,-26.85244196540103,3.018243185946517,2.4653892842012453,0.03568973259386765,3459155540.0,-1.0
2157,2021-07-28,GOOG,138.56199645996094,139.67599487304688,136.35000610351562,136.38150024414062,54688000.0,0.0,0.0,-0.4149932861328125,0.4149932861328125,0.0,63.461031809095644,128.53700256347656,140.01100158691406,68.36759934039046,-31.632400659609555,3.009438006716124,2.5741990287042213,0.038966573327547493,3404467540.0,-1.0
2158,2021-07-29,GOOG,136.38059997558594,137.15150451660156,136.13800048828125,136.54049682617188,19284000.0,0.0,0.0,0.15899658203125,0.0,0.15899658203125,64.01458684125647,128.53700256347656,140.01100158691406,69.75331134634821,-30.246688653651788,2.9809272602251156,2.6555446750084006,0.035609800075850906,3423751540.0,1.0
2159,2021-07-30,GOOG,135.51100158691406,135.77134704589844,134.81419372558594,135.2209930419922,23954000.0,0.0,0.0,-1.3195037841796875,1.3195037841796875,0.0,55.90455634060892,128.53700256347656,140.01100158691406,58.25336454066705,-41.74663545933294,2.8193595386212564,2.688307647730972,0.04616487954488302,3399797540.0,-1.0
2160,2021-08-02,GOOG,135.4844970703125,136.02049255371094,134.66949462890625,135.989501953125,20140000.0,0.0,0.0,0.7685089111328125,0.0,0.7685089111328125,59.36425256349658,128.53700256347656,140.01100158691406,64.9511942124581,-35.048805787541895,2.721951242086135,2.6950363666020047,0.037284092353374154,3419937540.0,1.0
2161,2021-08-03,GOOG,136.0,136.3354949951172,134.18350219726562,136.27999877929688,19064000.0,0.0,0.0,0.290496826171875,0.0,0.290496826171875,60.708811392380284,128.53700256347656,140.01100158691406,67.48297781796904,-32.517022182030956,2.63778834925796,2.683586763133196,0.027748798461146418,3439001540.0,1.0
2162,2021-08-04,GOOG,136.24949645996094,136.53799438476562,135.4149932861328,136.02850341796875,16528000.0,0.0,0.0,-0.251495361328125,0.251495361328125,0.0,58.766417660809516,128.53700256347656,140.01100158691406,65.29110590988883,-34.70889409011117,2.5217261867452123,2.6512146478556,0.02025071021743763,3422473540.0,-1.0
2163,2021-08-05,GOOG,136.02850341796875,136.9499969482422,135.60000610351562,136.94000244140625,11866000.0,0.0,0.0,0.9114990234375,0.0,0.9114990234375,63.63243741856733,128.53700256347656,140.01100158691406,73.23514548646205,-26.764854513537955,2.4747688454867216,2.6159254873818245,-0.006356242074626706,3434339540.0,1.0
2164,2021-08-06,GOOG,136.2949981689453,137.08004760742188,136.04649353027344,137.03599548339844,13560000.0,0.0,0.0,0.0959930419921875,0.0,0.0959930419921875,64.14658148096399,129.1884002685547,140.01100158691406,72.51117346003637,-27.488826539963622,2.417433976391976,2.576227185183855,-0.018679613127205674,3447899540.0,1.0
2165,2021-08-09,GOOG,136.94900512695312,138.32150268554688,136.4287567138672,138.0019989013672,12374000.0,0.0,0.0,0.96600341796875,0.0,0.96600341796875,69.20222843322396,130.60150146484375,140.01100158691406,78.64920920894949,-21.35079079105051,2.4220244914817215,2.5453866464434287,0.008812399645514057,3460273540.0,1.0
2166,2021-08-10,GOOG,138.07949829101562,138.55149841308594,137.22650146484375,138.09649658203125,16034000.0,0.0,0.0,0.0944976806640625,0.0,0.0944976806640625,69.684729205585,132.39999389648438,140.01100158691406,74.84557784260066,-25.15442215739933,2.4055579067021142,2.517420898495166,0.012574992464671197,3476307540.0,1.0
2167,2021-08-11,GOOG,138.2830047607422,138.84774780273438,137.35000610351562,137.6894989013672,15204000.0,0.0,0.0,-0.4069976806640625,0.4069976806640625,0.0,64.65118485292683,134.18350219726562,140.01100158691406,60.16296990660127,-39.837030093398724,2.3327759195231863,2.48049190270077,0.008415101027924976,3461103540.0,-1.0
2168,2021-08-12,GOOG,137.71299743652344,138.41799926757812,136.7790069580078,138.38949584960938,14646000.0,0.0,0.0,0.6999969482421875,0.0,0.6999969482421875,69.08303668747726,134.18350219726562,140.01100158691406,72.17493080848679,-27.825069191513208,2.30500886652743,2.4453952954661022,0.023432033268926178,3475749540.0,1.0
2169,2021-08-13,GOOG,138.3574981689453,138.6739959716797,138.0050048828125,138.406005859375,12580000.0,0.0,0.0,0.016510009765625,0.0,0.016510009765625,69.18816676875701,134.18350219726562,140.01100158691406,72.45824288905006,-27.541757110949934,2.258303183431991,2.40797687305928,0.01776978275192853,3488329540.0,1.0
2170,2021-08-16,GOOG,138.0,138.99049377441406,136.16575622558594,138.91600036621094,18040000.0,0.0,0.0,0.5099945068359375,0.0,0.5099945068359375,72.51883506516238,134.18350219726562,139.67599487304688,86.16303103712676,-13.83696896287324,2.2366580854445886,2.373713115536342,0.019342541902887866,3506369540.0,1.0
2171,2021-08-17,GOOG,138.1909942626953,138.718505859375,136.78750610351562,137.30050659179688,21272000.0,0.0,0.0,-1.6154937744140625,1.6154937744140625,0.0,51.98128778537966,134.18350219726562,138.99049377441406,64.84314242090461,-35.15685757909539,2.065339396065923,2.312038371642258,0.009351004692889298,3485097540.0,-1.0
2172,2021-08-18,GOOG,137.11549377441406,138.29400634765625,136.42100524902344,136.57000732421875,14934000.0,0.0,0.0,-0.730499267578125,0.730499267578125,0.0,45.28929155984947,134.18350219726562,138.99049377441406,49.64654272119252,-50.353457278807475,1.8493052745400576,2.2194917522218183,-0.0027018775419243024,3470163540.0,-1.0
2173,2021-08-19,GOOG,135.46749877929688,137.45199584960938,135.3560028076172,136.9134979248047,18296000.0,0.0,0.0,0.3434906005859375,0.0,0.3434906005859375,48.861214199012004,134.18350219726562,138.99049377441406,56.79218870523853,-43.20781129476147,1.68637402752762,2.1128682072829785,-0.0008939078974223857,3488459540.0,1.0
2174,2021-08-20,GOOG,137.08299255371094,138.614501953125,136.4669952392578,138.43699645996094,15564000.0,0.0,0.0,1.52349853515625,0.0,1.52349853515625,61.66857758016337,134.18350219726562,138.99049377441406,88.48557760982253,-11.514422390177474,1.6610360501653645,2.022501775859456,0.0031521105640264224,3504023540.0,1.0
2175,2021-08-23,GOOG,138.99850463867188,142.177001953125,138.74795532226562,141.09950256347656,21090000.0,0.0,0.0,2.662506103515625,0.0,2.662506103515625,74.5309000813992,135.3560028076172,142.177001953125,84.20320298151542,-15.79679701848459,1.8346488220261676,1.9849311850927982,0.021745707210330867,3525113540.0,1.0
2176,2021-08-24,GOOG,141.5435028076172,143.00750732421875,141.35350036621094,142.39849853515625,15126000.0,0.0,0.0,1.2989959716796875,0.0,1.2989959716796875,78.57757399259145,135.3560028076172,143.00750732421875,92.04066614949875,-7.959333850501247,2.0533861558741933,1.9986221792490775,0.03420013633111063,3540239540.0,1.0
2177,2021-08-25,GOOG,142.88299560546875,143.31300354003906,142.4394989013672,142.9499969482422,12838000.0,0.0,0.0,0.5514984130859375,0.0,0.5514984130859375,80.12455784583861,135.3560028076172,143.31300354003906,95.43789671505552,-4.562103284944484,2.245355323256291,2.0479688080505207,0.032954098652030694,3553077540.0,1.0
2178,2021-08-26,GOOG,142.61849975585938,143.13479614257812,142.0915069580078,142.1230010986328,14922000.0,0.0,0.0,-0.826995849609375,0.826995849609375,0.0,71.22521628310379,135.3560028076172,143.31300354003906,85.04458549868642,-14.955414501313594,2.304199243336029,2.0992148951076226,0.026855736614741943,3538155540.0,-1.0
2179,2021-08-27,GOOG,142.1125030517578,145.01100158691406,142.02000427246094,144.55050659179688,24562000.0,0.0,0.0,2.4275054931640625,0.0,2.4275054931640625,79.0908458865043,135.3560028076172,145.01100158691406,95.23050177795338,-4.7694982220466215,2.517690510735406,2.1829100182331795,0.04056052730234261,3562717540.0,1.0
2180,2021-08-30,GOOG,144.70449829101562,146.489501953125,144.60000610351562,145.46949768066406,16916000.0,0.0,0.0,0.9189910888671875,0.0,0.9189910888671875,81.32117962826632,135.3560028076172,146.489501953125,90.83842142411721,-9.161578575882793,2.729573949425344,2.2922428044716123,0.05949716640998348,3579633540.0,1.0
2181,2021-08-31,GOOG,145.88450622558594,146.11199951171875,145.0,145.46200561523438,26756000.0,0.0,0.0,-0.0074920654296875,0.0074920654296875,0.0,81.23966422548368,135.3560028076172,146.489501953125,90.77112842546718,-9.228871574532821,2.8638755790834693,2.406569359393984,0.0651094516668358,3552877540.0,-1.0
2182,2021-09-01,GOOG,145.64999389648438,146.82049560546875,145.614501953125,145.8419952392578,15824000.0,0.0,0.0,0.3799896240234375,0.0,0.3799896240234375,82.27919542513933,135.3560028076172,146.82049560546875,91.46494848516711,-8.53505151483289,2.966773457466104,2.5186101790084083,0.06521268866680185,3568701540.0,1.0
2183,2021-09-02,GOOG,145.94949340820312,146.3249969482422,144.10650634765625,144.218994140625,21844000.0,0.0,0.0,-1.6230010986328125,1.6230010986328125,0.0,64.62996335970217,135.3560028076172,146.82049560546875,77.30818527504968,-22.69181472495032,2.884111896108948,2.5917105224285164,0.04176627511805586,3546857540.0,-1.0
2184,2021-09-03,GOOG,144.14599609375,145.3769989013672,143.5050048828125,144.77499389648438,19104000.0,0.0,0.0,0.555999755859375,0.0,0.555999755859375,67.39454685823321,135.3560028076172,146.82049560546875,82.15793977935334,-17.842060220646662,2.830834449403568,2.639535307823527,0.02604893189722146,3565961540.0,1.0
2185,2021-09-07,GOOG,144.74949645996094,145.82400512695312,144.54100036621094,145.5189971923828,15170000.0,0.0,0.0,0.7440032958984375,0.0,0.7440032958984375,70.90570366285567,135.3560028076172,146.82049560546875,88.64757093022172,-11.352429069778275,2.8161833287299487,2.6748649120048116,0.021913845225384643,3581131540.0,1.0
2186,2021-09-08,GOOG,145.39349365234375,145.55099487304688,144.1999969482422,144.8834991455078,15486000.0,0.0,0.0,-0.635498046875,0.635498046875,0.0,64.10237612157498,135.3560028076172,146.82049560546875,83.10438591470938,-16.89561408529062,2.7219162722836074,2.684275184060571,0.013525723949233015,3565645540.0,-1.0
2187,2021-09-09,GOOG,144.8834991455078,145.66949462890625,144.4340057373047,144.9134979248047,14798000.0,0.0,0.0,0.029998779296875,0.0,0.029998779296875,64.28900524934139,136.4669952392578,146.82049560546875,81.5811308908857,-18.418869109114304,2.6194343925355668,2.6713070257555707,0.019634378704368016,3580443540.0,1.0
2188,2021-09-10,GOOG,145.44349670410156,146.0189971923828,141.7415008544922,141.92100524902344,32896000.0,0.0,0.0,-2.99249267578125,2.99249267578125,0.0,40.2208644335541,138.74795532226562,146.82049560546875,39.30670910816155,-60.69329089183846,2.27057385286966,2.5911603911783887,-0.018190882929238095,3547547540.0,-1.0
2189,2021-09-13,GOOG,143.2010040283203,144.1909942626953,142.28250122070312,143.46499633789062,20176000.0,0.0,0.0,1.5439910888671875,0.0,1.5439910888671875,51.115990458255546,141.35350036621094,146.82049560546875,38.62260490949942,-61.37739509050058,2.0945419630368463,2.4918367055500803,-0.013779530243334892,3567723540.0,1.0
2190,2021-09-14,GOOG,144.16099548339844,144.7274932861328,142.90550231933594,143.406005859375,18916000.0,0.0,0.0,-0.058990478515625,0.058990478515625,0.0,50.70856423523213,141.7415008544922,146.82049560546875,32.77233166194492,-67.22766833805508,1.9280500229952224,2.379079369039109,-0.014134273394371899,3548807540.0,-1.0
2191,2021-09-15,GOOG,143.75900268554688,145.5814971923828,142.25599670410156,145.20599365234375,20648000.0,0.0,0.0,1.79998779296875,0.0,1.79998779296875,61.50988675312679,141.7415008544922,146.82049560546875,68.21217519835845,-31.787824801641545,1.9192243096040613,2.2871083571520994,-0.004360894719457775,3569455540.0,1.0
2192,2021-09-16,GOOG,145.12100219726562,145.1999969482422,143.41635131835938,144.37350463867188,20292000.0,0.0,0.0,-0.832489013671875,0.832489013671875,0.0,55.07001102711153,141.7415008544922,146.82049560546875,51.82135271302691,-48.17864728697309,1.8240286947784057,2.1944924246773607,0.0010713602529790478,3549163540.0,-1.0
2193,2021-09-17,GOOG,143.79849243164062,144.24949645996094,141.06149291992188,141.4635009765625,60040000.0,0.0,0.0,-2.910003662109375,2.910003662109375,0.0,38.71966146429703,141.06149291992188,146.82049560546875,6.980515179295324,-93.01948482070468,1.4965215398062242,2.0548982477031332,-0.02287337633935338,3489123540.0,-1.0
2194,2021-09-20,GOOG,139.0001983642578,139.3625030517578,137.05299377441406,139.01699829101562,34918000.0,0.0,0.0,-2.446502685546875,2.446502685546875,0.0,30.061547778306903,137.05299377441406,146.82049560546875,20.107541831804202,-79.8924581681958,1.0277106310544468,1.8494607243733958,-0.044681443844553526,3454205540.0,-1.0
2195,2021-09-21,GOOG,140.11700439453125,140.8115997314453,138.90550231933594,139.64649963378906,18130000.0,0.0,0.0,0.6295013427734375,0.0,0.6295013427734375,34.41557667941524,137.05299377441406,146.82049560546875,26.55239696120902,-73.44760303879099,0.6989134662871948,1.6193512727561556,-0.036146279891122624,3472335540.0,1.0
2196,2021-09-22,GOOG,140.05050659179688,141.58349609375,139.4717559814453,140.93850708007812,22068000.0,0.0,0.0,1.2920074462890625,0.0,1.2920074462890625,42.842427894181775,137.05299377441406,146.3249969482422,41.90586686414877,-58.09413313585124,0.5364101452614136,1.4027630472572075,-0.027430093825967616,3494403540.0,1.0
2197,2021-09-23,GOOG,141.6094970703125,142.25245666503906,141.09649658203125,141.82650756835938,17272000.0,0.0,0.0,0.88800048828125,0.0,0.88800048828125,48.12801886343372,137.05299377441406,146.0189971923828,53.24015139653776,-46.759848603462245,0.47381743816382027,1.2169739254385301,-0.000665847035808742,3511675540.0,1.0
2198,2021-09-24,GOOG,140.9459991455078,142.90350341796875,140.85049438476562,142.63299560546875,14950000.0,0.0,0.0,0.806488037109375,0.0,0.806488037109375,52.7106582135535,137.05299377441406,146.0189971923828,62.235107114411946,-37.76489288558806,0.483713167037223,1.0703217737582686,-0.005799329130168673,3526625540.0,1.0
2199,2021-09-27,GOOG,141.5854949951172,142.5,140.5,141.50100708007812,18844000.0,0.0,0.0,-1.131988525390625,1.131988525390625,0.0,46.112888227728014,137.05299377441406,146.0189971923828,49.60976589357314,-50.39023410642687,0.3956527512569039,0.9353879692579957,-0.013283953959117523,3507781540.0,-1.0
2200,2021-09-28,GOOG,139.0885009765625,139.60650634765625,135.6999969482422,136.1840057373047,42190000.0,0.0,0.0,-5.3170013427734375,5.3170013427734375,0.0,27.474683397275243,135.6999969482422,146.0189971923828,4.690462037127403,-95.3095379628726,-0.10199757051597658,0.7279108613032013,-0.06213233826035969,3465591540.0,-1.0
2201,2021-09-29,GOOG,137.1096954345703,137.39849853515625,134.25,134.52099609375,26338000.0,0.0,0.0,-1.6630096435546875,1.6630096435546875,0.0,23.977196736639954,134.25,146.0189971923828,2.3026268875770945,-97.69737311242291,-0.6233939187353883,0.45764990529548333,-0.0682431902555809,3439253540.0,-1.0
2202,2021-09-30,GOOG,134.3249969482422,135.58999633789062,133.0,133.2655029296875,35294000.0,0.0,0.0,-1.2554931640625,1.2554931640625,0.0,21.583779782962125,133.0,145.5814971923828,2.110264983790982,-97.88973501620902,-1.1249444277927694,0.1411310386778327,-0.05795133013308662,3403959540.0,-1.0
2203,2021-10-01,GOOG,133.55450439453125,137.0709991455078,133.37750244140625,136.46249389648438,28388000.0,0.0,0.0,3.196990966796875,0.0,3.196990966796875,39.366796418400824,133.0,145.5814971923828,27.520523539763335,-72.47947646023667,-1.2500466078762429,-0.13710449063298252,-0.018375482321835945,3432347540.0,1.0
2204,2021-10-04,GOOG,135.69949340820312,135.6999969482422,131.16650390625,133.76499938964844,31530000.0,0.0,0.0,-2.6974945068359375,2.6974945068359375,0.0,32.247156601925184,131.16650390625,145.5814971923828,18.02633849228486,-81.97366150771514,-1.5490003380268433,-0.4194836601117548,-0.04211706172058982,3400817540.0,-1.0
2205,2021-10-05,GOOG,134.0,137.36199951171875,134.0,136.177001953125,24126000.0,0.0,0.0,2.4120025634765625,0.0,2.4120025634765625,42.90131518294856,131.16650390625,145.1999969482422,35.70385528308718,-64.29614471691282,-1.573160459570886,-0.6502190200035811,-0.03378427390498573,3424943540.0,1.0
2206,2021-10-06,GOOG,134.62550354003906,137.8520050048828,134.4864959716797,137.35400390625,19764000.0,0.0,0.0,1.177001953125,0.0,1.177001953125,47.54561998236971,131.16650390625,144.24949645996094,47.29422549617626,-52.70577450382375,-1.4802696815048648,-0.816229152303838,-0.031535033463005235,3444707540.0,1.0
2207,2021-10-07,GOOG,138.86300659179688,140.15444946289062,138.56300354003906,139.1855010986328,18250000.0,0.0,0.0,1.8314971923828125,0.0,1.8314971923828125,54.229884096918724,131.16650390625,142.90350341796875,68.32237817149334,-31.67762182850665,-1.2445204960892227,-0.9018874210609151,-0.024170385626422042,3462957540.0,1.0
2208,2021-10-08,GOOG,139.906005859375,140.31700134277344,139.42935180664062,140.05599975585938,18924000.0,0.0,0.0,0.8704986572265625,0.0,0.8704986572265625,57.2195775950328,131.16650390625,142.90350341796875,75.73908340656997,-24.260916593430025,-0.9761926602601534,-0.9167484689007629,-0.010211993215009318,3481881540.0,1.0
2209,2021-10-11,GOOG,139.8000030517578,140.76365661621094,138.80650329589844,138.84750366210938,16584000.0,0.0,0.0,-1.20849609375,1.20849609375,0.0,51.79961557086142,131.16650390625,142.90350341796875,65.44261800633389,-34.55738199366611,-0.8512438429694669,-0.9036475437145037,0.019558081805454375,3465297540.0,-1.0
2210,2021-10-12,GOOG,139.6374969482422,139.69500732421875,136.25,136.71299743652344,22536000.0,0.0,0.0,-2.1345062255859375,2.1345062255859375,0.0,43.41810103270007,131.16650390625,142.90350341796875,47.25648599316689,-52.74351400683312,-0.9139226868144306,-0.9057025723344893,0.016294864046693558,3442761540.0,-1.0
2211,2021-10-13,GOOG,137.75,138.5500030517578,136.97650146484375,137.89999389648438,16380000.0,0.0,0.0,1.1869964599609375,0.0,1.1869964599609375,48.740087114580184,131.16650390625,142.90350341796875,57.369773113744735,-42.63022688625526,-0.8579257934560474,-0.8961472165588009,0.03477637396710298,3459141540.0,1.0
2212,2021-10-14,GOOG,139.95199584960938,141.65150451660156,139.33900451660156,141.41200256347656,21426000.0,0.0,0.0,3.5120086669921875,0.0,3.5120086669921875,61.19928331794577,131.16650390625,142.5,90.40016048425315,-9.599839515746844,-0.5241164158971685,-0.8217410564264745,0.03627010269024322,3480567540.0,1.0
2213,2021-10-15,GOOG,142.1999969482422,142.1999969482422,141.0644989013672,141.6750030517578,21250000.0,0.0,0.0,0.26300048828125,0.0,0.26300048828125,61.997414338075735,131.16650390625,142.1999969482422,95.24181603698565,-4.7581839630143365,-0.23563191970299613,-0.7045192290817789,0.05913358276231939,3501817540.0,1.0
2214,2021-10-18,GOOG,141.2135009765625,142.99874877929688,141.2135009765625,142.9604949951172,16564000.0,0.0,0.0,1.285491943359375,0.0,1.285491943359375,65.94780679105835,131.16650390625,142.99874877929688,99.67669884632943,-0.32330115367057066,0.09562032686758926,-0.5444913178919053,0.04981379340637271,3518381540.0,1.0
2215,2021-10-19,GOOG,143.29150390625,144.10699462890625,143.0959930419922,143.82200622558594,15316000.0,0.0,0.0,0.86151123046875,0.0,0.86151123046875,68.48138174601166,131.16650390625,144.10699462890625,97.79770018441918,-2.202299815580826,0.42278329254440905,-0.35103639580464235,0.04709001656588496,3533697540.0,1.0
2216,2021-10-20,GOOG,144.22250366210938,144.2477569580078,141.91200256347656,142.4149932861328,17940000.0,0.0,0.0,-1.407012939453125,1.407012939453125,0.0,60.06041330401808,131.16650390625,144.2477569580078,85.98938752561843,-14.01061247438157,0.5620491617360415,-0.16841928429650557,0.023202791684540758,3515757540.0,-1.0
2217,2021-10-21,GOOG,142.19200134277344,142.84950256347656,141.63699340820312,142.78050231933594,14850000.0,0.0,0.0,0.365509033203125,0.0,0.365509033203125,61.48019488109513,131.16650390625,144.2477569580078,88.78353141807993,-11.216468581920067,0.6939128948141899,0.004047151525633575,0.019452951449604683,3530607540.0,1.0
2218,2021-10-22,GOOG,140.3509979248047,141.55850219726562,137.17050170898438,138.625,30182000.0,0.0,0.0,-4.1555023193359375,4.1555023193359375,0.0,41.928002433641964,134.0,144.2477569580078,45.13182756921189,-54.86817243078811,0.4578240346313578,0.09480252814677845,-0.0016025038710875128,3500425540.0,-1.0
2219,2021-10-25,GOOG,138.8105010986328,139.20579528808594,136.74850463867188,138.7729949951172,21082000.0,0.0,0.0,0.1479949951171875,0.0,0.1479949951171875,42.67713643936642,134.4864959716797,144.2477569580078,43.91337378891192,-56.086626211088074,0.2794426305700597,0.1317305486314347,0.015068044715720763,3521507540.0,1.0
2220,2021-10-26,GOOG,140.6060028076172,140.83949279785156,139.0054931640625,139.6719970703125,28258000.0,0.0,0.0,0.8990020751953125,0.0,0.8990020751953125,47.43037084505488,136.25,144.2477569580078,42.786959997405276,-57.21304000259472,0.20821585412085142,0.14702760972931805,0.01284991480970099,3549765540.0,1.0
2221,2021-10-27,GOOG,139.90249633789062,149.1179962158203,139.90249633789062,146.42750549316406,51850000.0,0.0,0.0,6.7555084228515625,0.0,6.7555084228515625,69.41782585835455,136.25,149.1179962158203,79.09161086519066,-20.90838913480933,0.6889395262001585,0.2554099930234862,0.03546730715050983,3601615540.0,1.0
2222,2021-10-28,GOOG,147.2989959716797,147.42449951171875,144.7635040283203,146.12899780273438,32418000.0,0.0,0.0,-0.2985076904296875,0.2985076904296875,0.0,67.96841149150197,136.25,149.1179962158203,76.77184261671471,-23.22815738328529,1.0339111398325826,0.41111022238530553,0.03143811297007271,3569197540.0,-1.0
2223,2021-10-29,GOOG,145.52000427246094,148.61300659179688,145.16650390625,148.27049255371094,28954000.0,0.0,0.0,2.1414947509765625,0.0,2.1414947509765625,72.6887442947239,136.25,149.1179962158203,93.41386453729737,-6.586135462702638,1.46323707207452,0.6215355923231485,0.03714311117050273,3598151540.0,1.0
2224,2021-11-01,GOOG,148.1649932861328,148.39950561523438,143.57949829101562,143.7740020751953,32272000.0,0.0,0.0,-4.496490478515625,4.496490478515625,0.0,53.56477628222135,136.74850463867188,149.1179962158203,56.796978216165606,-43.203021783834394,1.4242340797092652,0.7820752898003719,-0.0003337747237048827,3565879540.0,-1.0
2225,2021-11-02,GOOG,144.8094024658203,146.92050170898438,144.64100646972656,145.86300659179688,21150000.0,0.0,0.0,2.0890045166015625,0.0,2.0890045166015625,59.30426661987995,136.74850463867188,149.1179962158203,73.68534022823745,-26.314659771762557,1.544089826847653,0.9344781972098282,0.024211027407321506,3587029540.0,1.0
2226,2021-11-03,GOOG,146.27499389648438,146.91050720214844,145.05349731445312,146.7899932861328,17886000.0,0.0,0.0,0.9269866943359375,0.0,0.9269866943359375,61.726447595415266,136.74850463867188,149.1179962158203,81.17947762712994,-18.820522372870066,1.6943450935059445,1.0864515764690517,0.028081502037508255,3604915540.0,1.0
2227,2021-11-04,GOOG,147.1999969482422,149.9499969482422,146.63499450683594,148.68299865722656,24700000.0,0.0,0.0,1.89300537109375,0.0,1.89300537109375,66.43388962189198,136.74850463867188,149.9499969482422,90.40261311899471,-9.597386881005301,1.9437666557499256,1.2579145923252266,0.0725554456788211,3629615540.0,1.0
2228,2021-11-05,GOOG,149.35350036621094,150.5707550048828,148.65199279785156,149.24099731445312,20408000.0,0.0,0.0,0.5579986572265625,0.0,0.5579986572265625,67.78166796605558,136.74850463867188,150.5707550048828,90.37958613685413,-9.620413863145867,2.161543936081671,1.4386404610765156,0.07543256034579549,3650023540.0,1.0
2229,2021-11-08,GOOG,150.0,151.0345001220703,149.1199951171875,149.35150146484375,18388000.0,0.0,0.0,0.110504150390625,0.0,0.110504150390625,68.07458681911798,136.74850463867188,151.0345001220703,88.21924128995875,-11.78075871004126,2.316349327984341,1.6141822344580807,0.06930168249587254,3668411540.0,1.0
2230,2021-11-09,GOOG,149.74600219726562,150.3784942626953,147.5070037841797,149.24850463867188,16876000.0,0.0,0.0,-0.102996826171875,0.102996826171875,0.0,67.4154179891988,136.74850463867188,151.0345001220703,87.49827769808608,-12.501722301913917,2.4030221893190458,1.771950225430274,0.019265500262445556,3651535540.0,-1.0
2231,2021-11-10,GOOG,148.00975036621094,148.6999969482422,145.3249969482422,146.62600708007812,22708000.0,0.0,0.0,-2.62249755859375,2.62249755859375,0.0,52.48462419299264,136.74850463867188,151.0345001220703,69.14115612653498,-30.858843873465013,2.234341324558784,1.8644284452559758,0.0034011680420520385,3628827540.0,-1.0
2232,2021-11-11,GOOG,147.10699462890625,148.5022430419922,146.6945037841797,146.7480010986328,12464000.0,0.0,0.0,0.1219940185546875,0.0,0.1219940185546875,53.04283328054535,136.74850463867188,151.0345001220703,69.99509744757526,-30.004902552424735,2.0864530892659445,1.90883337405797,-0.010268337474677258,3641291540.0,1.0
2233,2021-11-12,GOOG,147.8314971923828,149.8594970703125,146.45399475097656,149.64549255371094,17048000.0,0.0,0.0,2.897491455078125,0.0,2.897491455078125,64.47897953853717,139.0054931640625,151.0345001220703,88.4528492401054,-11.547150759894613,2.17794791456393,1.962656282159162,0.040838332339422356,3658339540.0,1.0
2234,2021-11-15,GOOG,150.0,150.4770050048828,148.65249633789062,149.38800048828125,16248000.0,0.0,0.0,-0.2574920654296875,0.2574920654296875,0.0,62.907990261112836,139.90249633789062,151.0345001220703,85.20931482138916,-14.790685178610838,2.2042712976598295,2.0109792852592956,0.024166469476041952,3642091540.0,-1.0
2235,2021-11-16,GOOG,149.17050170898438,149.83250427246094,148.35000610351562,149.0760040283203,17254000.0,0.0,0.0,-0.3119964599609375,0.3119964599609375,0.0,60.83571517657656,143.57949829101562,151.0345001220703,73.72909976236821,-26.27090023763179,2.174886523533985,2.0437607329142335,0.015573341826724318,3624837540.0,-1.0
2236,2021-11-17,GOOG,149.22900390625,149.62600708007812,148.56300354003906,149.06199645996094,15290000.0,0.0,0.0,-0.014007568359375,0.014007568359375,0.0,60.73207677222482,143.57949829101562,151.0345001220703,73.54120486070602,-26.458795139293983,2.1259618201356716,2.0602009503585212,0.002549032546808716,3609547540.0,-1.0
2237,2021-11-18,GOOG,149.14599609375,151.61000061035156,148.99850463867188,150.70899963378906,26658000.0,0.0,0.0,1.647003173828125,0.0,1.647003173828125,68.10396016765016,143.57949829101562,151.61000061035156,88.78026628056554,-11.219733719434453,2.194787883247102,2.0871183369362374,0.009836454766131375,3636205540.0,1.0
2238,2021-11-19,GOOG,151.0,151.85000610351562,149.8874969482422,149.95249938964844,19766000.0,0.0,0.0,-0.756500244140625,0.756500244140625,0.0,61.94110429979005,144.64100646972656,151.85000610351562,73.67864044584707,-26.321359554152934,2.163352011414389,2.102365071831868,0.004024050102677812,3616439540.0,-1.0
2239,2021-11-22,GOOG,150.14175415039062,150.7445068359375,147.0054931640625,147.07850646972656,24608000.0,0.0,0.0,-2.873992919921875,2.873992919921875,0.0,44.34899381953861,145.05349731445312,151.85000610351562,29.794843472169834,-70.20515652783016,1.8848047904529324,2.058853015556081,-0.014539496889425019,3591831540.0,-1.0
2240,2021-11-23,GOOG,147.11300659179688,147.69400024414062,144.88949584960938,146.7570037841797,18126000.0,0.0,0.0,-0.321502685546875,0.321502685546875,0.0,42.78067814727086,144.88949584960938,151.85000610351562,26.830043580817424,-73.16995641918258,1.6194435935254887,1.9709711311499625,0.0008934070204205113,3573705540.0,-1.0
2241,2021-11-24,GOOG,146.35000610351562,147.0,145.19900512695312,146.71749877929688,16464000.0,0.0,0.0,-0.0395050048828125,0.0395050048828125,0.0,42.567255362830146,144.88949584960938,151.85000610351562,26.26248454503205,-73.73751545496795,1.3899329278107757,1.854763490482125,-0.00020785509245491163,3557241540.0,-1.0
2242,2021-11-26,GOOG,145.0155029296875,145.2969970703125,142.48550415039062,142.80599975585938,16992000.0,0.0,0.0,-3.9114990234375,3.9114990234375,0.0,27.1138698906084,142.48550415039062,151.85000610351562,3.4224522251479517,-96.57754777485205,0.8822487755628288,1.660260547498266,-0.04570463621145637,3540249540.0,-1.0
2243,2021-11-29,GOOG,144.29849243164062,146.86199951171875,144.29849243164062,146.11399841308594,26276000.0,0.0,0.0,3.3079986572265625,0.0,3.3079986572265625,46.179971969391865,142.48550415039062,151.85000610351562,38.74732773678859,-61.25267226321141,0.7383223522919025,1.4758729084569935,-0.021916098110250415,3566525540.0,1.0
2244,2021-11-30,GOOG,145.45025634765625,146.6284942626953,142.0659942626953,142.45199584960938,41590000.0,0.0,0.0,-3.6620025634765625,3.6620025634765625,0.0,34.61424149502214,142.0659942626953,151.85000610351562,3.945228125170577,-96.05477187482943,0.3250199944969552,1.245702325664986,-0.0444337653258573,3524935540.0,-1.0
2245,2021-12-01,GOOG,144.21249389648438,146.4991455078125,141.5,141.6179962158203,28476000.0,0.0,0.0,-0.8339996337890625,0.8339996337890625,0.0,32.47682992425483,141.5,151.85000610351562,1.1400593839285977,-98.85994061607141,-0.06902621096651274,0.9827566183386862,-0.04993895440103091,3496459540.0,-1.0
2246,2021-12-02,GOOG,141.82400512695312,144.6750030517578,140.98199462890625,143.77650451660156,21250000.0,0.0,0.0,2.15850830078125,0.0,2.15850830078125,42.98972321519879,140.98199462890625,151.85000610351562,25.713166518309684,-74.28683348169032,-0.2047765506722783,0.7452499845364933,-0.04599921128819717,3517709540.0,1.0
2247,2021-12-03,GOOG,144.49549865722656,145.21299743652344,141.14999389648438,142.52049255371094,26688000.0,0.0,0.0,-1.256011962890625,1.256011962890625,0.0,38.921142192249036,140.98199462890625,151.85000610351562,14.15620445744869,-85.8437955425513,-0.40899470502361623,0.5144010466244714,-0.04956240720353444,3491021540.0,-1.0
2248,2021-12-06,GOOG,143.57400512695312,144.35150146484375,140.64700317382812,143.79649353027344,22198000.0,0.0,0.0,1.2760009765625,0.0,1.2760009765625,45.0205016749702,140.64700317382812,151.85000610351562,28.11291201307546,-71.88708798692454,-0.462544523493051,0.31901193260096683,-0.02231470129953128,3513219540.0,1.0
2249,2021-12-07,GOOG,145.9499969482422,148.3000030517578,145.70249938964844,148.0364990234375,23258000.0,0.0,0.0,4.2400054931640625,0.0,4.2400054931640625,60.242602409044046,140.64700317382812,151.85000610351562,65.95995641514574,-34.04004358485426,-0.16099429037777213,0.22301068800521903,0.008718461172316117,3536477540.0,1.0
2250,2021-12-08,GOOG,148.3314971923828,149.156494140625,147.1999969482422,148.7205047607422,18964000.0,0.0,0.0,0.6840057373046875,0.0,0.6840057373046875,62.19113933961549,140.64700317382812,151.85000610351562,72.0655134840643,-27.934486515935713,0.13166226777818224,0.20474100395981168,0.01365212737478827,3555441540.0,1.0
2251,2021-12-09,GOOG,148.17599487304688,149.60499572753906,147.5290069580078,148.1060028076172,18580000.0,0.0,0.0,-0.614501953125,0.614501953125,0.0,59.18431044988251,140.64700317382812,151.85000610351562,66.58035957504768,-33.41964042495233,0.31043107043993245,0.2258790172558359,0.03711330798999124,3536861540.0,-1.0
2252,2021-12-10,GOOG,149.10000610351562,149.39999389648438,147.3574981689453,148.6750030517578,21634000.0,0.0,0.0,0.569000244140625,0.0,0.569000244140625,61.18910973157081,140.64700317382812,150.7445068359375,79.50479788439743,-20.495202115602567,0.4923447550158926,0.2791721648078473,0.017527442041737507,3558495540.0,1.0
2253,2021-12-13,GOOG,148.44400024414062,148.5625,146.36000061035156,146.70449829101562,24104000.0,0.0,0.0,-1.9705047607421875,1.9705047607421875,0.0,51.14986204376493,140.64700317382812,149.60499572753906,67.62112248773998,-32.37887751226002,0.4720676921598965,0.31775127027825717,0.029852178736026636,3534391540.0,-1.0
2254,2021-12-14,GOOG,144.77000427246094,145.44200134277344,142.24249267578125,144.9705047607422,24778000.0,0.0,0.0,-1.7339935302734375,1.7339935302734375,0.0,43.84567788034861,140.64700317382812,149.60499572753906,48.26417929006883,-51.73582070993117,0.3124771454314441,0.31669644530889457,0.0236728991689219,3509613540.0,-1.0
2255,2021-12-15,GOOG,144.36599731445312,147.51724243164062,142.70550537109375,147.36849975585938,27280000.0,0.0,0.0,2.3979949951171875,0.0,2.3979949951171875,54.26666436909699,140.64700317382812,149.60499572753906,75.0335138339315,-24.9664861660685,0.37517387173122074,0.32839193059335986,0.0249831865876462,3536893540.0,1.0
2256,2021-12-16,GOOG,148.07699584960938,148.55149841308594,144.09249877929688,144.8385009765625,27400000.0,0.0,0.0,-2.529998779296875,2.529998779296875,0.0,44.26624385945805,140.64700317382812,149.60499572753906,46.790592619972706,-53.20940738002729,0.21819648832723715,0.30635284214013536,0.016264386835303624,3509493540.0,-1.0
2257,2021-12-17,GOOG,142.71449279785156,144.46009826660156,141.78799438476562,142.80299377441406,43404000.0,0.0,0.0,-2.0355072021484375,2.0355072021484375,0.0,37.79968094503179,140.64700317382812,149.60499572753906,24.067787371544497,-75.9322126284555,-0.06965470269716434,0.23115133317267542,-0.0069090680271018945,3466089540.0,-1.0
2258,2021-12-20,GOOG,140.67959594726562,142.61050415039062,140.25,142.40150451660156,20264000.0,0.0,0.0,-0.4014892578125,0.4014892578125,0.0,36.583399482168055,140.25,149.60499572753906,22.99845536292447,-77.00154463707553,-0.32641298742558433,0.11963846905302344,-0.03806489983219474,3445825540.0,-1.0
2259,2021-12-21,GOOG,143.14999389648438,144.69204711914062,141.73500061035156,144.2205047607422,19548000.0,0.0,0.0,1.819000244140625,0.0,1.819000244140625,45.71474129129556,140.25,149.60499572753906,42.44261436757143,-57.55738563242857,-0.3787516470115406,0.019960445840110603,-0.03025810063810286,3465373540.0,1.0
2260,2021-12-22,GOOG,144.10000610351562,147.30299377441406,143.96299743652344,146.94900512695312,18438000.0,0.0,0.0,2.7285003662109375,0.0,2.7285003662109375,56.54443569791703,140.25,149.60499572753906,71.60885287454187,-28.391147125458133,-0.19778331237958469,-0.02358830580382847,-0.007811956698115408,3483811540.0,1.0
2261,2021-12-23,GOOG,147.08949279785156,148.57260131835938,146.9508514404297,147.1425018310547,13818000.0,0.0,0.0,0.1934967041015625,0.0,0.1934967041015625,57.24241875685797,140.25,149.60499572753906,73.6772312013427,-26.322768798657293,-0.038309429222465496,-0.026532530487555883,-0.01030772617619935,3497629540.0,1.0
2262,2021-12-27,GOOG,147.4635009765625,148.42649841308594,147.25,148.06399536132812,13256000.0,0.0,0.0,0.9214935302734375,0.0,0.9214935302734375,60.71015772286181,140.25,149.60499572753906,83.52751394985067,-16.472486050149328,0.16058052642640064,0.010890080895235433,0.009266907873647368,3510885540.0,1.0
2263,2021-12-28,GOOG,148.37449645996094,148.37449645996094,145.9355010986328,146.447998046875,18624000.0,0.0,0.0,-1.615997314453125,1.615997314453125,0.0,52.15165801608734,140.25,149.60499572753906,66.25334983990905,-33.74665016009095,0.18566454606468596,0.04584497392912555,0.01019168201539511,3492261540.0,-1.0
2264,2021-12-29,GOOG,146.42950439453125,147.18374633789062,145.50450134277344,146.50450134277344,17022000.0,0.0,0.0,0.0565032958984375,0.0,0.0565032958984375,52.42225390658221,140.25,149.60499572753906,66.85734045138634,-33.142659548613665,0.20770881814851805,0.07821774277300407,-0.005862843243415572,3509283540.0,1.0
2265,2021-12-30,GOOG,146.4499969482422,147.0625,145.7584991455078,146.00250244140625,12978000.0,0.0,0.0,-0.5019989013671875,0.5019989013671875,0.0,49.549674759516165,140.25,149.39999389648438,62.86892107782155,-37.13107892217845,0.1825674230265406,0.09908767882371139,0.008036547306106812,3496305540.0,-1.0
2266,2021-12-31,GOOG,145.54400634765625,146.36500549316406,144.67750549316406,144.67950439453125,17298000.0,0.0,0.0,-1.322998046875,1.322998046875,0.0,42.47238040208212,140.25,148.57260131835938,53.222595016775756,-46.777404983224244,0.05525090261869536,0.0903203235827082,0.01314055518388857,3479007540.0,-1.0
2267,2022-01-03,GOOG,144.47549438476562,145.5500030517578,143.50250244140625,145.07449340820312,25214000.0,0.0,0.0,0.394989013671875,0.0,0.394989013671875,45.17022325255297,140.25,148.57260131835938,57.96857525255304,-42.03142474744696,-0.013619052765392325,0.0695324483130881,0.01877079108591828,3504221540.0,1.0
2268,2022-01-04,GOOG,145.55050659179688,146.61000061035156,143.81614685058594,144.41650390625,22928000.0,0.0,0.0,-0.657989501953125,0.657989501953125,0.0,41.43521397052017,140.25,148.57260131835938,50.062519480043264,-49.937480519956736,-0.11991098317636784,0.0316437620151969,0.0013590241265135639,3481293540.0,-1.0
2269,2022-01-05,GOOG,144.18099975585938,144.29800415039062,137.52349853515625,137.65350341796875,49642000.0,0.0,0.0,-6.76300048828125,6.76300048828125,0.0,20.92015648919255,137.52349853515625,148.57260131835938,1.1766103127408116,-98.8233896872592,-0.7413202441512681,-0.12294903921809615,-0.06325664948159226,3431651540.0,-1.0
2270,2022-01-06,GOOG,137.49749755859375,139.68600463867188,136.7635040283203,137.55099487304688,29050000.0,0.0,0.0,-0.102508544921875,0.102508544921875,0.0,20.740562318575954,136.7635040283203,148.57260131835938,6.668510093407466,-93.33148990659254,-1.2279085776250724,-0.34394094689949145,-0.0651851561489728,3402601540.0,-1.0
2271,2022-01-07,GOOG,137.90499877929688,138.25474548339844,135.78900146484375,137.00450134277344,19408000.0,0.0,0.0,-0.5464935302734375,0.5464935302734375,0.0,19.70023141962325,135.78900146484375,148.57260131835938,9.508275382973695,-90.4917246170263,-1.6387404187716754,-0.6029008412739284,-0.07469401316346791,3383193540.0,-1.0
2272,2022-01-10,GOOG,135.0989990234375,138.63999938964844,133.1405029296875,138.57400512695312,34096000.0,0.0,0.0,1.5695037841796875,0.0,1.5695037841796875,31.145105913431763,133.1405029296875,148.57260131835938,35.2090950978783,-64.79090490212171,-1.8167395318291994,-0.8456685793849829,-0.05376647700845705,3417289540.0,1.0
2273,2022-01-11,GOOG,138.1804962158203,140.32949829101562,136.81350708007812,140.0175018310547,23502000.0,0.0,0.0,1.4434967041015625,0.0,1.4434967041015625,40.19123736969289,133.1405029296875,148.57260131835938,44.562953968822114,-55.437046031177886,-1.8203432077512787,-1.040603505058242,-0.044278499651974945,3440791540.0,1.0
2274,2022-01-12,GOOG,141.55450439453125,142.8142547607422,141.11199951171875,141.6479949951172,23642000.0,0.0,0.0,1.6304931640625,0.0,1.6304931640625,48.935071329413866,133.1405029296875,148.57260131835938,55.128549929896245,-44.87145007010376,-1.6723541178761252,-1.1669536276218186,-0.02982488226896396,3464433540.0,1.0
2275,2022-01-13,GOOG,141.8404998779297,143.1855010986328,138.91400146484375,139.13099670410156,26566000.0,0.0,0.0,-2.516998291015625,2.516998291015625,0.0,38.82488596089204,133.1405029296875,148.42649841308594,39.18942525477075,-60.81057474522925,-1.7381362716119213,-1.2811901564198394,-0.038350336584643485,3437867540.0,-1.0
2276,2022-01-14,GOOG,137.5,141.20050048828125,137.5,139.7864990234375,23826000.0,0.0,0.0,0.6555023193359375,0.0,0.6555023193359375,42.40085808748993,133.1405029296875,148.37449645996094,43.62609240015025,-56.37390759984976,-1.717576391980856,-1.3684674035320428,-0.03645020058685666,3461693540.0,1.0
2277,2022-01-18,GOOG,136.60000610351562,137.39149475097656,135.61700439453125,136.29049682617188,27382000.0,0.0,0.0,-3.496002197265625,3.496002197265625,0.0,31.18351932364716,133.1405029296875,147.18374633789062,22.43067220955779,-77.56932779044222,-1.9607780702058335,-1.4869295368668012,-0.05626785623721531,3434311540.0,-1.0
2278,2022-01-19,GOOG,136.93850708007812,138.39950561523438,135.5,135.65199279785156,20796000.0,0.0,0.0,-0.6385040283203125,0.6385040283203125,0.0,29.536803943631952,133.1405029296875,147.0625,18.039724153653257,-81.96027584634675,-2.1799104406446475,-1.6255257176223707,-0.014540208352270101,3413515540.0,-1.0
2279,2022-01-20,GOOG,136.51400756835938,137.91200256347656,133.14450073242188,133.50650024414062,21930000.0,0.0,0.0,-2.1454925537109375,2.1454925537109375,0.0,24.517141389988467,133.1405029296875,146.61000061035156,2.7172306134216644,-97.28276938657834,-2.497903465180258,-1.8000012671339483,-0.029403601425341375,3391585540.0,-1.0
2280,2022-01-21,GOOG,133.01199340820312,134.760498046875,130.00100708007812,130.0919952392578,41920000.0,0.0,0.0,-3.4145050048828125,3.4145050048828125,0.0,18.685770323959062,130.00100708007812,146.61000061035156,0.547824640992497,-99.4521753590075,-2.990959328494455,-2.0381928794060498,-0.050454591168659024,3349665540.0,-1.0
2281,2022-01-24,GOOG,126.02749633789062,130.77850341796875,124.64195251464844,130.3719940185547,55148000.0,0.0,0.0,0.279998779296875,0.0,0.279998779296875,20.475462296869907,124.64195251464844,146.61000061035156,26.083525850560324,-73.91647414943967,-3.320835565751196,-2.294721416675079,-0.05918867034898967,3404813540.0,1.0
2282,2022-01-25,GOOG,128.4355010986328,129.3385009765625,126.37799835205078,126.7354965209961,36008000.0,0.0,0.0,-3.6364974975585938,3.6364974975585938,0.0,15.397081977672187,124.64195251464844,144.29800415039062,10.650887803635985,-89.34911219636402,-3.8315322977005906,-2.6020835928801813,-0.09485960780877722,3368805540.0,-1.0
2283,2022-01-26,GOOG,130.59249877929688,132.8074951171875,127.15350341796876,129.24000549316406,39630000.0,0.0,0.0,2.5045089721679688,0.0,2.5045089721679688,29.326562677673508,124.64195251464844,143.1855010986328,24.795971265644674,-75.20402873435533,-3.988196744636724,-2.8793062232314903,-0.08759735358330234,3408435540.0,1.0
2284,2022-01-27,GOOG,131.36099243164062,132.60995483398438,128.94500732421875,129.12100219726562,30248000.0,0.0,0.0,-0.1190032958984375,0.1190032958984375,0.0,29.064205863184725,124.64195251464844,143.1855010986328,24.154220872727873,-75.84577912727212,-4.07498314980495,-3.1184416085461826,-0.07194654493940567,3378187540.0,-1.0
2285,2022-01-28,GOOG,130.0,133.37049865722656,128.6945037841797,133.2895050048828,30518000.0,0.0,0.0,4.1685028076171875,0.0,4.1685028076171875,47.901719865614766,124.64195251464844,143.1855010986328,46.6337521702996,-53.3662478297004,-3.76400950367605,-3.247555187572156,-0.046477979375285416,3408705540.0,1.0
2286,2022-01-31,GOOG,134.197998046875,135.843505859375,132.2740020751953,135.69850158691406,34056000.0,0.0,0.0,2.40899658203125,0.0,2.40899658203125,55.73927591678183,124.64195251464844,143.1855010986328,59.624774741415486,-40.375225258584514,-3.2853038199238256,-3.2551049140424904,-0.004343628154887869,3442761540.0,1.0
2287,2022-02-01,GOOG,137.8350067138672,138.1999969482422,134.56825256347656,137.8784942626953,51204000.0,0.0,0.0,2.17999267578125,0.0,2.17999267578125,61.74795116310136,124.64195251464844,143.1855010986328,71.38084540883919,-28.61915459116081,-2.6989075998855583,-3.1438654512111044,0.016413333994744095,3493965540.0,1.0
2288,2022-02-02,GOOG,151.86349487304688,152.10000610351562,145.5574951171875,148.0364990234375,89750000.0,0.0,0.0,10.158004760742188,0.0,10.158004760742188,77.88767094969334,124.64195251464844,152.10000610351562,85.20103740446604,-14.79896259553396,-1.3983984140996597,-2.7947720437888157,0.10883364295166276,3583715540.0,1.0
2289,2022-02-03,GOOG,145.2949981689453,149.11770629882812,142.2050018310547,142.65049743652344,56930000.0,0.0,0.0,-5.3860015869140625,5.3860015869140625,0.0,61.90723368298699,124.64195251464844,152.10000610351562,65.58565727753015,-34.414342722469854,-0.793197344829224,-2.3944571039968974,0.0965355491255917,3526785540.0,-1.0
2290,2022-02-04,GOOG,143.01699829101562,144.53524780273438,139.8175048828125,143.01600646972656,49224000.0,0.0,0.0,0.365509033203125,0.0,0.365509033203125,62.509543871626725,124.64195251464844,152.10000610351562,66.91681147613409,-33.083188523865914,-0.28084026118713723,-1.9717337354349453,0.0969841149271089,3576009540.0,1.0
2291,2022-02-07,GOOG,143.70899963378906,143.84649658203125,138.69900512695312,138.93800354003906,44610000.0,0.0,0.0,-4.0780029296875,4.0780029296875,0.0,51.93755850826311,124.64195251464844,152.10000610351562,52.06505617421815,-47.93494382578184,-0.20153120986213935,-1.617693230320384,0.09628326202218651,3531399540.0,-1.0
2292,2022-02-08,GOOG,138.9912567138672,139.83709716796875,136.8730010986328,139.21299743652344,34256000.0,0.0,0.0,0.274993896484375,0.0,0.274993896484375,52.56181308247079,124.64195251464844,152.10000610351562,53.06656159991909,-46.93343840008091,-0.11516100172715937,-1.317186784601739,0.07716644629736469,3565655540.0,1.0
2293,2022-02-09,GOOG,140.84974670410156,142.17550659179688,140.3769989013672,141.4530029296875,28628000.0,0.0,0.0,2.2400054931640625,0.0,2.2400054931640625,57.72283493366719,124.64195251464844,152.10000610351562,61.22447958895043,-38.77552041104957,0.13251023773901238,-1.0272473801335888,0.09550731889132624,3594283540.0,1.0
2294,2022-02-10,GOOG,139.5,141.43099975585938,138.0500030517578,138.6024932861328,33018000.0,0.0,0.0,-2.8505096435546875,2.8505096435546875,0.0,49.77197933517176,124.64195251464844,152.10000610351562,50.84315509218996,-49.15684490781004,0.09765348526809703,-0.8022672070532516,0.03986051475737251,3561265540.0,-1.0
2295,2022-02-11,GOOG,138.75,139.2832489013672,133.2884979248047,134.1300048828125,38808000.0,0.0,0.0,-4.4724884033203125,4.4724884033203125,0.0,39.837723467494605,126.37799835205078,152.10000610351562,30.137641686700174,-69.86235831329982,-0.2875484981038312,-0.6993234652633676,-0.011558688458302213,3522457540.0,-1.0
2296,2022-02-14,GOOG,133.36549377441406,136.16650390625,133.302001953125,135.3000030517578,26792000.0,0.0,0.0,1.1699981689453125,0.0,1.1699981689453125,43.25634928878058,127.15350341796876,152.10000610351562,32.65587860742038,-67.34412139257961,-0.49273483059496925,-0.658005738329688,-0.018701184870968945,3549249540.0,1.0
2297,2022-02-15,GOOG,137.47149658203125,137.89999389648438,135.5395050048828,136.42550659179688,26578000.0,0.0,0.0,1.1255035400390625,0.0,1.1255035400390625,46.62294893595934,128.6945037841797,152.10000610351562,33.030706635295715,-66.96929336470428,-0.5580943832775631,-0.6380234673192631,-0.07843330873288445,3575827540.0,1.0
2298,2022-02-16,GOOG,136.4304962158203,137.9459991455078,134.8236541748047,137.4875030517578,25610000.0,0.0,0.0,1.0619964599609375,0.0,1.0619964599609375,49.86163237765275,128.6945037841797,152.10000610351562,37.56808611757067,-62.431913882429335,-0.5182242937496255,-0.6140636326053356,-0.036193314972932766,3601437540.0,1.0
2299,2022-02-17,GOOG,136.14999389648438,136.83949279785156,132.20199584960938,132.30850219726562,30968000.0,0.0,0.0,-5.1790008544921875,5.1790008544921875,0.0,37.17087526486384,132.20199584960938,152.10000610351562,0.5352612964672755,-99.46473870353273,-0.8942210234664572,-0.67009511077756,-0.07486927188620307,3570469540.0,-1.0
2300,2022-02-18,GOOG,133.03750610351562,133.82400512695312,130.3070526123047,130.46749877929688,31858000.0,0.0,0.0,-1.84100341796875,1.84100341796875,0.0,33.6572445342471,130.3070526123047,152.10000610351562,0.7362295663912428,-99.26377043360876,-1.3254754744105526,-0.8011711835041587,-0.06096607511926111,3538611540.0,-1.0
2301,2022-02-22,GOOG,129.98500061035156,131.9007568359375,127.74099731445312,129.40249633789062,38906000.0,0.0,0.0,-1.06500244140625,1.06500244140625,0.0,31.65966725063892,127.74099731445312,152.10000610351562,6.820881086850848,-93.17911891314915,-1.7332052193432332,-0.9875779906719739,-0.07047115771719581,3499705540.0,-1.0
2302,2022-02-23,GOOG,131.07850646972656,131.74899291992188,127.50350189208984,127.58499908447266,26432000.0,0.0,0.0,-1.8174972534179688,1.8174972534179688,0.0,28.346826602495696,127.50350189208984,149.11770629882812,0.3770538616605548,-99.62294613833944,-2.1778855101546526,-1.2256394945685098,-0.09803965669154624,3473273540.0,-1.0
2303,2022-02-24,GOOG,125.0,133.03700256347656,124.7645034790039,132.67349243164062,43166000.0,0.0,0.0,5.088493347167969,0.0,5.088493347167969,46.44882615537625,124.7645034790039,144.53524780273438,40.00349619181359,-59.99650380818642,-2.095542844091483,-1.3996201644731046,-0.04277701442392001,3516439540.0,1.0
2304,2022-02-25,GOOG,133.52549743652344,135.38900756835938,131.76499938964844,134.51950073242188,26236000.0,0.0,0.0,1.84600830078125,0.0,1.84600830078125,51.57030304415541,124.7645034790039,143.84649658203125,51.12147982000028,-48.87852017999972,-1.8598886077222119,-1.491673853122926,0.0029038681535102917,3542675540.0,1.0
2305,2022-02-28,GOOG,133.2845001220703,135.6405029296875,132.82525634765625,134.89100646972656,29676000.0,0.0,0.0,0.3715057373046875,0.0,0.3715057373046875,52.622455214500334,124.7645034790039,142.17550659179688,58.16151387212189,-41.83848612787811,-1.6244281231724358,-1.5182247071328283,-0.0030228867169707074,3572351540.0,1.0
2306,2022-03-01,GOOG,134.47999572753906,136.11099243164062,133.3784942626953,134.16799926757812,24640000.0,0.0,0.0,-0.7230072021484375,0.7230072021484375,0.0,50.17465373468205,124.7645034790039,142.17550659179688,54.008926008777024,-45.991073991222976,-1.4791143223640972,-1.5104026301790823,-0.016547545841068434,3547711540.0,-1.0
2307,2022-03-02,GOOG,134.60824584960938,135.61549377441406,133.4324951171875,134.75149536132812,23966000.0,0.0,0.0,0.58349609375,0.0,0.58349609375,52.243283554812265,124.7645034790039,141.43099975585938,59.92256390560633,-40.07743609439366,-1.3018617778149633,-1.4686944597062586,-0.019900046402033356,3571677540.0,1.0
2308,2022-03-03,GOOG,135.97850036621094,136.71380615234375,133.43099975585938,134.30799865722656,19780000.0,0.0,0.0,-0.4434967041015625,0.4434967041015625,0.0,50.407881345493834,124.7645034790039,139.2832489013672,65.73223030360992,-34.26776969639007,-1.1835313244035035,-1.4116618326457078,0.015112380737103193,3551897540.0,-1.0
2309,2022-03-04,GOOG,133.38250732421875,134.19900512695312,130.4084930419922,132.1219940185547,24446000.0,0.0,0.0,-2.186004638671875,2.186004638671875,0.0,42.013346274045105,124.7645034790039,137.9459991455078,55.81681112445557,-44.18318887554443,-1.2517168796657359,-1.3796728420497135,0.012681282731238808,3527451540.0,-1.0
2310,2022-03-07,GOOG,131.9040069580078,131.9040069580078,126.41000366210938,126.4645004272461,39178000.0,0.0,0.0,-5.657493591308594,5.657493591308594,0.0,28.05939065554807,124.7645034790039,137.9459991455078,12.896844115817045,-87.10315588418295,-1.742184061247201,-1.4521750858892113,-0.022704321738685418,3488273540.0,-1.0
2311,2022-03-08,GOOG,126.25050354003906,131.2465057373047,125.86074829101562,127.27850341796876,35250000.0,0.0,0.0,0.8140029907226705,0.0,0.8140029907226705,31.81884040030775,124.7645034790039,137.9459991455078,19.07219030806418,-80.92780969193582,-2.041664559679333,-1.5700729806472358,-0.002402286073623472,3523523540.0,1.0
2312,2022-03-09,GOOG,131.39999389648438,134.19850158691406,130.08799743652344,133.86599731445312,32258000.0,0.0,0.0,6.587493896484361,0.0,6.587493896484361,54.17837606420058,124.7645034790039,136.83949279785156,75.37475682270662,-24.625243177293385,-1.7275353566267881,-1.6015654558431462,0.008988267821674611,3555781540.0,1.0
2313,2022-03-10,GOOG,131.46249389648438,133.5384979248047,131.4010009765625,132.6820068359375,24266000.0,0.0,0.0,-1.183990478515625,1.183990478515625,0.0,50.728330300683425,124.7645034790039,136.71380615234375,66.25912468179737,-33.740875318202626,-1.5561851034429708,-1.5924893853631115,-0.013659684183183307,3531515540.0,-1.0
2314,2022-03-11,GOOG,133.99949645996094,134.1999969482422,130.29649353027344,130.47549438476562,26600000.0,0.0,0.0,-2.206512451171875,2.206512451171875,0.0,44.618614213568996,124.7645034790039,136.71380615234375,47.79350780446413,-52.20649219553587,-1.5802201136808378,-1.590035531026657,-0.032733924970393846,3504915540.0,-1.0
2315,2022-03-14,GOOG,130.572998046875,131.0260009765625,126.41300201416016,126.74099731445312,30254000.0,0.0,0.0,-3.7344970703125,3.7344970703125,0.0,36.12247518881744,124.7645034790039,136.71380615234375,16.540662576561772,-83.45933742343823,-1.8789513539356335,-1.6478186956084526,-0.05535598647716988,3474661540.0,-1.0
2316,2022-03-15,GOOG,127.7415008544922,130.51724243164062,126.56800079345705,129.66050720214844,30292000.0,0.0,0.0,2.9195098876953125,0.0,2.9195098876953125,45.48599909837492,124.7645034790039,136.71380615234375,40.973133386837986,-59.02686661316202,-1.8586921197443473,-1.6899933804356317,-0.03778056893193282,3504953540.0,1.0
2317,2022-03-16,GOOG,131.0,133.77099609375,129.2010040283203,133.6905059814453,32058000.0,0.0,0.0,4.029998779296875,0.0,4.029998779296875,55.80441448647995,125.86074829101562,136.71380615234375,72.14333315524712,-27.856666844752876,-1.5001564396820015,-1.6520259922849057,-0.004597586755478167,3537011540.0,1.0
2318,2022-03-17,GOOG,133.3209991455078,134.739501953125,132.718994140625,134.60049438476562,23994000.0,0.0,0.0,0.9099884033203125,0.0,0.9099884033203125,57.881510571318486,125.86074829101562,136.71380615234375,80.5279600037117,-19.47203999628831,-1.1295649494573468,-1.547533783719394,0.018759180745204773,3561005540.0,1.0
2319,2022-03-18,GOOG,133.88400268554688,136.9134979248047,132.9320068359375,136.80149841308594,45900000.0,0.0,0.0,2.2010040283203125,0.0,2.2010040283203125,62.76531501326624,125.86074829101562,136.9134979248047,98.98668190785432,-1.0133180921456804,-0.6507642873417581,-1.368179884443867,0.08173833724814039,3606905540.0,1.0
2320,2022-03-21,GOOG,136.84750366210938,137.58250427246094,134.6114959716797,136.47850036621094,26632000.0,0.0,0.0,-0.322998046875,0.322998046875,0.0,61.55670057553363,125.86074829101562,137.58250427246094,90.58158258884114,-9.418417411158856,-0.29398567218891003,-1.1533410419928758,0.07228240984284984,3580273540.0,-1.0
2321,2022-03-22,GOOG,136.5,141.5,136.5,140.27749633789062,29776000.0,0.0,0.0,3.7989959716796875,0.0,3.7989959716796875,69.52155313570991,125.86074829101562,141.5,92.18310642441368,-7.81689357558633,0.29194580662257863,-0.8642836722697849,0.04789490350097503,3610049540.0,1.0
2322,2022-03-23,GOOG,139.1385040283203,140.02499389648438,138.16650390625,138.5034942626953,25302000.0,0.0,0.0,-1.7740020751953125,1.7740020751953125,0.0,62.540056210395576,125.86074829101562,141.5,80.83983944332024,-19.16016055667975,0.6061660782499132,-0.5701937221658452,0.043875485196392505,3584747540.0,-1.0
2323,2022-03-24,GOOG,139.2725067138672,141.39649963378906,138.03939819335938,141.31199645996094,20544000.0,0.0,0.0,2.808502197265625,0.0,2.808502197265625,68.34660335304497,125.86074829101562,141.5,98.7978738143139,-1.2021261856861027,1.0694822375318438,-0.2422585302263073,0.08305392615136609,3605291540.0,1.0
2324,2022-03-25,GOOG,141.75399780273438,141.95950317382812,139.69949340820312,141.52149963378906,19270000.0,0.0,0.0,0.209503173828125,0.0,0.209503173828125,68.7633565506889,125.86074829101562,141.95950317382812,97.27927070616693,-2.720729293833077,1.437003900550593,0.09359395592907285,0.1166197413033172,3624561540.0,1.0
2325,2022-03-28,GOOG,140.6844940185547,141.97650146484375,139.82815551757812,141.9499969482422,23774000.0,0.0,0.0,0.428497314453125,0.0,0.428497314453125,69.70468145469547,126.41300201416016,141.97650146484375,99.82970079007264,-0.17029920992735567,1.7427542325524428,0.42342601125374696,0.09478205824795749,3648335540.0,1.0
2326,2022-03-29,GOOG,143.16050720214844,144.16250610351562,142.48399353027344,143.25,28678000.0,0.0,0.0,1.3000030517578125,0.0,1.3000030517578125,72.59562291325939,126.41300201416016,144.16250610351562,94.85897691044302,-5.14102308955698,2.0661457135197168,0.751969951706941,0.07150465882656953,3677013540.0,1.0
2327,2022-03-30,GOOG,142.8699951171875,143.48049926757812,142.16799926757812,142.64450073242188,21046000.0,0.0,0.0,-0.605499267578125,0.605499267578125,0.0,69.0542524617012,126.41300201416016,144.16250610351562,91.44761812244596,-8.552381877554039,2.247667351467669,1.0511094316590868,0.05976208619755785,3655967540.0,-1.0
2328,2022-03-31,GOOG,142.44850158691406,142.64450073242188,139.61900329589844,139.64950561523438,29516000.0,0.0,0.0,-2.9949951171875,2.9949951171875,0.0,54.01555644487108,126.41300201416016,144.16250610351562,74.57393476706915,-25.42606523293085,2.125353726819725,1.2659582906912146,0.02081853806563272,3626451540.0,-1.0
2329,2022-04-01,GOOG,140.00999450683594,140.9499969482422,138.7969970703125,140.6999969482422,23480000.0,0.0,0.0,1.0504913330078125,0.0,1.0504913330078125,57.74025307693598,126.56800079345705,144.16250610351562,80.32050862325774,-19.679491376742263,2.0891032870440824,1.4305872899617882,0.030931586811869805,3649931540.0,1.0
2330,2022-04-04,GOOG,140.82449340820312,144.0437469482422,140.82449340820312,143.6425018310547,19076000.0,0.0,0.0,2.9425048828125,0.0,2.9425048828125,66.50809076597594,129.2010040283203,144.16250610351562,96.52438458486697,-3.4756154151330367,2.2716242347143805,1.5987946789123069,0.023988206098707998,3669007540.0,1.0
2331,2022-04-05,GOOG,143.39950561523438,143.58999633789062,140.94349670410156,141.06300354003906,19256000.0,0.0,0.0,-2.579498291015625,2.579498291015625,0.0,54.97168291537057,132.718994140625,144.16250610351562,72.91476101455807,-27.08523898544193,2.1829655780819905,1.715628858746244,0.018479745157109262,3649751540.0,-1.0
2332,2022-04-06,GOOG,139.1614990234375,139.84849548339844,136.41810607910156,137.17599487304688,23574000.0,0.0,0.0,-3.8870086669921875,3.8870086669921875,0.0,42.234088469942414,132.9320068359375,144.16250610351562,37.789842962383254,-62.21015703761674,1.7785518015520552,1.7282134473074064,-0.029268580803654243,3626177540.0,-1.0
2333,2022-04-07,GOOG,136.6179962158203,137.70150756835938,134.8572540283203,136.46499633789062,19448000.0,0.0,0.0,-0.71099853515625,0.71099853515625,0.0,40.264948290528864,134.6114959716797,144.16250610351562,19.40632813311286,-80.59367186688714,1.3847171726736462,1.6595141923806542,-0.035729576841561195,3606729540.0,-1.0
2334,2022-04-08,GOOG,136.25,136.25,133.75250244140625,134.010498046875,16434000.0,0.0,0.0,-2.454498291015625,2.454498291015625,0.0,33.95826604890274,133.75250244140625,144.16250610351562,2.4783430807792093,-97.52165691922079,0.8645765921018551,1.5005266723248947,-0.05593165954249435,3590295540.0,-1.0
2335,2022-04-11,GOOG,132.89999389648438,132.93919372558594,129.61749267578125,129.79649353027344,24188000.0,0.0,0.0,-4.2140045166015625,4.2140045166015625,0.0,25.9167983292583,129.61749267578125,144.16250610351562,1.2306681969153042,-98.7693318030847,0.11104641406629412,1.2226306206731747,-0.0939162755303774,3566107540.0,-1.0
2336,2022-04-12,GOOG,132.42349243164062,132.42349243164062,127.57599639892578,128.37449645996094,23004000.0,0.0,0.0,-1.4219970703125,1.4219970703125,0.0,23.728937372758196,127.57599639892578,144.16250610351562,4.814153642066083,-95.18584635793391,-0.5940273824715803,0.8592990200442236,-0.10003893735258096,3543103540.0,-1.0
2337,2022-04-13,GOOG,128.62649536132812,130.65574645996094,128.4385986328125,130.28599548339844,19542000.0,0.0,0.0,1.9114990234375,0.0,1.9114990234375,32.55939322291938,127.57599639892578,144.16250610351562,16.338573531975452,-83.66142646802454,-0.9871818322202444,0.49000284959132995,-0.06705007719565081,3562645540.0,1.0
2338,2022-04-14,GOOG,130.64950561523438,130.7102508544922,127.11150360107422,127.25299835205078,23484000.0,0.0,0.0,-3.0329971313476562,3.0329971313476562,0.0,26.86490757205317,127.11150360107422,144.16250610351562,0.8298324450794193,-99.17016755492058,-1.5259073764645166,0.08682080438016054,-0.09557213139910736,3539161540.0,-1.0
2339,2022-04-18,GOOG,127.41000366210938,128.71200561523438,126.57845306396484,127.96099853515624,14918000.0,0.0,0.0,0.7080001831054545,0.0,0.7080001831054545,30.155106357629705,126.57845306396484,144.16250610351562,7.86249602456108,-92.13750397543892,-1.8741178893829158,-0.3053669343724549,-0.10917035763093486,3554079540.0,1.0
2340,2022-04-19,GOOG,128.07699584960938,130.90374755859375,127.45149993896484,130.531005859375,22720000.0,0.0,0.0,2.570007324218764,0.0,2.570007324218764,41.22917064338576,126.57845306396484,144.0437469482422,22.630897719782055,-77.36910228021794,-1.920560095698903,-0.6284055666377446,-0.0746616576732303,3576799540.0,1.0
2341,2022-04-20,GOOG,131.28399658203125,131.92349243164062,127.89405059814452,128.24549865722656,22610000.0,0.0,0.0,-2.2855072021484375,2.2855072021484375,0.0,35.46007007952953,126.57845306396484,144.0437469482422,9.544904336035428,-90.45509566396457,-2.1173793777907974,-0.9262003288683553,-0.06510247091034604,3554189540.0,-1.0
2342,2022-04-21,GOOG,129.35000610351562,130.3074951171875,124.6500015258789,124.9375,30158000.0,0.0,0.0,-3.3079986572265625,3.3079986572265625,0.0,28.743170958287706,124.6500015258789,144.0437469482422,1.4824288339351614,-98.51757116606484,-2.51133877228213,-1.2432280175511103,-0.08447218442265048,3524031540.0,-1.0
2343,2022-04-22,GOOG,125.0,125.4520034790039,119.1405029296875,119.61399841308594,46410000.0,0.0,0.0,-5.3235015869140625,5.3235015869140625,0.0,21.263990960943943,119.1405029296875,144.0437469482422,1.9013405765355298,-98.09865942346447,-3.216043965528769,-1.6377912071466425,-0.10742814811980905,3477621540.0,-1.0
2344,2022-04-25,GOOG,119.42949676513672,123.27799987792967,118.76924896240234,123.25,34522000.0,0.0,0.0,3.6360015869140625,0.0,3.6360015869140625,34.66249820278604,118.76924896240234,143.58999633789062,18.052442055079375,-81.94755794492062,-3.44146193660319,-1.9985253530379523,-0.05043659772478015,3512143540.0,1.0
2345,2022-04-26,GOOG,122.75,122.75,119.16184997558594,119.50599670410156,49394000.0,0.0,0.0,-3.7440032958984375,3.7440032958984375,0.0,28.832980549322343,118.76924896240234,139.84849548339844,3.495133191622278,-96.50486680837773,-3.877519448239127,-2.3743241720781874,-0.06908303440649055,3462749540.0,-1.0
2346,2022-04-27,GOOG,114.3730010986328,117.5,113.12425231933594,115.02050018310548,62238000.0,0.0,0.0,-4.4854965209960795,4.4854965209960795,0.0,23.394183407231736,113.12425231933594,137.70150756835938,7.715458233868046,-92.28454176613195,-4.532789079278459,-2.806017153518242,-0.11716911893449167,3400511540.0,-1.0
2347,2022-04-28,GOOG,117.11499786376952,120.4384994506836,115.1438980102539,119.4114990234375,36790000.0,0.0,0.0,4.390998840332017,0.0,4.390998840332017,36.84942080796177,113.12425231933594,136.25,27.187214834824413,-72.81278516517558,-4.644242141071658,-3.1736621510289256,-0.06162133254353219,3437301540.0,1.0
2348,2022-04-29,GOOG,117.5780029296875,118.95999908447266,114.69400024414062,114.96649932861328,33694000.0,0.0,0.0,-4.444999694824219,4.444999694824219,0.0,30.576453199239452,113.12425231933594,132.93919372558594,9.297261957566349,-90.70273804243365,-5.033223949857771,-3.545574510794695,-0.10155046737129692,3403607540.0,-1.0
2349,2022-05-02,GOOG,113.90650177001952,117.3395004272461,113.39949798583984,117.15699768066406,30280000.0,0.0,0.0,2.1904983520507812,0.0,2.1904983520507812,36.70337110875794,113.12425231933594,132.42349243164062,20.89587640684854,-79.10412359315146,-5.105882490482628,-3.857636106732282,-0.10245847789696161,3433887540.0,1.0
2350,2022-05-03,GOOG,116.76499938964844,119.3000030517578,116.6269989013672,118.12950134277344,21216000.0,0.0,0.0,0.972503662109375,0.0,0.972503662109375,39.441214740329904,113.12425231933594,131.92349243164062,26.624741178561834,-73.37525882143817,-5.027043362764232,-4.091517557938673,-0.07887994058560355,3455103540.0,1.0
2351,2022-05-04,GOOG,118.00350189208984,123.14299774169922,115.7385025024414,122.5749969482422,33232000.0,0.0,0.0,4.445495605468764,0.0,4.445495605468764,50.690723045531016,113.12425231933594,131.92349243164062,50.27195020888349,-49.72804979111651,-4.553360141890323,-4.183886074729003,-0.018909479153639164,3488335540.0,1.0
2352,2022-05-05,GOOG,120.22049713134766,121.2332534790039,115.18250274658205,116.74649810791016,43090000.0,0.0,0.0,-5.8284988403320455,5.8284988403320455,0.0,39.57052276510581,113.12425231933594,131.92349243164062,19.268043638654024,-80.73195636134598,-4.595302139672114,-4.266169287717625,-0.02397294918001902,3445245540.0,-1.0
2353,2022-05-06,GOOG,115.5189971923828,117.49849700927734,114.14299774169922,115.66000366210938,35310000.0,0.0,0.0,-1.0864944458007812,1.0864944458007812,0.0,37.787523138610005,113.12425231933594,131.92349243164062,13.488584259922876,-86.51141574007713,-4.662466485295269,-4.345428727233155,-0.06158212038856492,3409935540.0,-1.0
2354,2022-05-09,GOOG,113.30349731445312,115.56289672851562,112.55149841308594,113.08399963378906,34520000.0,0.0,0.0,-2.5760040283203125,2.5760040283203125,0.0,33.64073477226991,112.55149841308594,131.92349243164062,2.748819869514156,-97.25118013048585,-4.867447801244438,-4.449832542035412,-0.05373786460451391,3375415540.0,-1.0
2355,2022-05-10,GOOG,116.04049682617188,116.69100189208984,113.38330078125,114.58450317382812,31158000.0,0.0,0.0,1.5005035400390625,0.0,1.5005035400390625,38.198978002710106,112.55149841308594,130.3074951171875,11.449679759585514,-88.55032024041448,-4.852877919648861,-4.530441617558102,-0.003790602619387684,3406573540.0,1.0
2356,2022-05-11,GOOG,113.71050262451172,116.6709976196289,113.6500015258789,113.96099853515624,36502000.0,0.0,0.0,-0.6235046386718892,0.6235046386718892,0.0,36.981038813592676,112.55149841308594,125.4520034790039,10.925929759091968,-89.07407024090803,-4.835897579949233,-4.591532810036329,-0.04564468692593393,3370071540.0,-1.0
2357,2022-05-12,GOOG,111.93800354003906,114.85649871826172,110.1135025024414,113.16100311279295,41464000.0,0.0,0.0,-0.7999954223632812,0.7999954223632812,0.0,35.314107094233606,110.1135025024414,123.27799987792967,23.14938826320756,-76.85061173679244,-4.831301249718408,-4.639486497972745,-0.015704541987136666,3328607540.0,-1.0
2358,2022-05-13,GOOG,114.84549713134766,118.08499908447266,114.0,116.5155029296875,29738000.0,0.0,0.0,3.3544998168945455,0.0,3.3544998168945455,46.89544329939785,110.1135025024414,123.14299774169922,49.134677204968725,-50.865322795031275,-4.505047145201601,-4.6125986274185165,-0.005475513743746552,3358345540.0,1.0
2359,2022-05-16,GOOG,115.38400268554688,116.60749816894533,114.33499908447266,114.7925033569336,23282000.0,0.0,0.0,-1.7229995727539062,1.7229995727539062,0.0,42.39674460373856,110.1135025024414,123.14299774169922,35.910837439000545,-64.08916256099945,-4.335542645811799,-4.557187431097173,-0.028248641938790175,3335063540.0,-1.0
2360,2022-05-17,GOOG,117.22750091552734,117.22750091552734,115.3375015258789,116.70149993896484,21576000.0,0.0,0.0,1.90899658203125,0.0,1.90899658203125,48.68936506234768,110.1135025024414,123.14299774169922,50.56218460922285,-49.43781539077715,-4.001047454323697,-4.445959435742478,-0.04791757826237164,3356639540.0,1.0
2361,2022-05-18,GOOG,115.2375030517578,115.69564819335938,112.14199829101562,112.4010009765625,27982000.0,0.0,0.0,-4.300498962402344,4.300498962402344,0.0,37.921461062828605,110.1135025024414,123.14299774169922,17.556309220858154,-82.44369077914185,-4.036442336006743,-4.364056015795331,-0.03722164862993205,3328657540.0,-1.0
2362,2022-05-19,GOOG,111.84100341796876,113.5875015258789,110.46800231933594,110.74549865722656,29192000.0,0.0,0.0,-1.6555023193359375,1.6555023193359375,0.0,34.529533081105726,110.1135025024414,123.14299774169922,4.850503746921482,-95.14949625307851,-4.150236888884834,-4.3212921904132315,-0.04249096359394999,3299465540.0,-1.0
2363,2022-05-20,GOOG,112.08550262451172,112.5500030517578,106.3730010986328,109.31300354003906,37586000.0,0.0,0.0,-1.4324951171875,1.4324951171875,0.0,31.698699916666286,106.3730010986328,123.14299774169922,17.531323970907366,-82.46867602909263,-4.306369133235819,-4.318307578977749,-0.03334685814051486,3261879540.0,-1.0
2364,2022-05-23,GOOG,110.10399627685548,112.00550079345705,109.1542510986328,111.66649627685548,31558000.0,0.0,0.0,2.3534927368164205,0.0,2.3534927368164205,40.885883433406036,106.3730010986328,123.14299774169922,31.565272736123585,-68.43472726387641,-4.1918765236424065,-4.293021367910681,-0.025465982014565625,3293437540.0,1.0
2365,2022-05-24,GOOG,106.37750244140624,106.3949966430664,102.20800018310548,105.9260025024414,60386000.0,0.0,0.0,-5.740493774414077,5.740493774414077,0.0,29.658343530536627,102.20800018310548,121.2332534790039,19.542458970243892,-80.4575410297561,-4.512334791308604,-4.336884052590266,-0.07050654290499292,3233051540.0,-1.0
2366,2022-05-25,GOOG,105.14199829101562,106.5447006225586,104.21125030517578,105.8395004272461,37900000.0,0.0,0.0,-0.0865020751953125,0.0865020751953125,0.0,29.517409896631037,102.20800018310548,118.08499908447266,22.872712070465038,-77.12728792953496,-4.718883915378228,-4.413284025147859,-0.06469987437500158,3195151540.0,-1.0
2367,2022-05-26,GOOG,106.05049896240234,108.95525360107422,105.48799896240234,108.2959976196289,30288000.0,0.0,0.0,2.4564971923828125,0.0,2.4564971923828125,39.0133920568425,102.20800018310548,118.08499908447266,38.344761968832685,-61.655238031167315,-4.630973807318156,-4.456821981581919,-0.07054430615142038,3225439540.0,1.0
2368,2022-05-27,GOOG,109.78849792480467,112.86799621582033,109.5500030517578,112.79900360107422,29924000.0,0.0,0.0,4.5030059814453125,0.0,4.5030059814453125,52.538328245395704,102.20800018310548,118.08499908447266,66.70658279794137,-33.29341720205863,-4.15010958388153,-4.395479502041841,-0.017366114489731355,3255363540.0,1.0
2369,2022-05-31,GOOG,113.0790023803711,116.43350219726562,112.57250213623048,114.03900146484376,51302000.0,0.0,0.0,1.2399978637695455,0.0,1.2399978637695455,55.662522618460955,102.20800018310548,118.08499908447266,74.5166095635335,-25.48339043646649,-3.6271522050605967,-4.241814042645592,-0.02281460371557842,3306665540.0,1.0
2370,2022-06-01,GOOG,114.93150329589844,117.39900207519533,113.55049896240234,114.13700103759766,28630000.0,0.0,0.0,0.09799957275389204,0.0,0.09799957275389204,55.927078854447345,102.20800018310548,118.08499908447266,75.13385198675654,-24.866148013243464,-3.168275065365137,-4.027106247189501,0.015444702858092407,3335295540.0,1.0
2371,2022-06-02,GOOG,114.18800354003906,117.89800262451172,113.30799865722656,117.74600219726562,27472000.0,0.0,0.0,3.6090011596679688,0.0,3.6090011596679688,64.84141746436258,102.20800018310548,118.08499908447266,97.86485538411267,-2.135144615887327,-2.484752711665948,-3.71863554008479,0.06321253346564126,3362767540.0,1.0
2372,2022-06-03,GOOG,115.99250030517578,116.364501953125,113.66799926757812,114.56400299072266,25052000.0,0.0,0.0,-3.1819992065429688,3.1819992065429688,0.0,53.77602251804425,102.20800018310548,117.89800262451172,78.75080232625987,-21.249197673740124,-2.174747924398872,-3.4098580169476063,0.04803636603727801,3337715540.0,-1.0
2373,2022-06-06,GOOG,116.74250030517578,119.39849853515624,116.5282974243164,117.010498046875,23786000.0,0.0,0.0,2.4464950561523438,0.0,2.4464950561523438,59.853875960199964,102.20800018310548,119.39849853515624,86.10860232567744,-13.891397674322556,-1.7119212299022735,-3.0702706595385396,0.04785680529252123,3361501540.0,1.0
2374,2022-06-07,GOOG,115.64800262451172,117.74864959716795,115.12550354003906,117.22949981689452,26414000.0,0.0,0.0,0.21900177001951704,0.0,0.21900177001951704,60.391797864844854,102.20800018310548,119.39849853515624,87.38257219865318,-12.61742780134682,-1.3123284223047733,-2.7186822120917866,0.10671126113904461,3387915540.0,1.0
2375,2022-06-08,GOOG,116.87650299072266,118.64600372314452,116.69674682617188,117.23799896240234,22544000.0,0.0,0.0,0.00849914550782671,0.0,0.00849914550782671,60.41554853044265,102.20800018310548,119.39849853515624,87.43201314756442,-12.56798685243557,-0.9836238301317053,-2.3716705356997703,0.10769607272467763,3410459540.0,1.0
2376,2022-06-09,GOOG,116.34149932861328,118.3499984741211,114.86699676513672,114.91799926757812,23142000.0,0.0,0.0,-2.3199996948242188,2.3199996948242188,0.0,50.81784241829045,102.20800018310548,119.39849853515624,73.93618744599335,-26.063812554006656,-0.8999535545959674,-2.0773271394790096,0.06114724268211513,3387317540.0,-1.0
2377,2022-06-10,GOOG,112.78125,113.49700164794922,110.86100006103516,111.42749786376952,31324000.0,0.0,0.0,-3.490501403808608,3.490501403808608,0.0,39.8326886167571,102.20800018310548,119.39849853515624,53.63135781089318,-46.36864218910682,-1.1025885953820875,-1.882379430659625,-0.012158846208918495,3355993540.0,-1.0
2378,2022-06-13,GOOG,107.4459991455078,109.21849822998048,106.58805084228516,106.87650299072266,36756000.0,0.0,0.0,-4.550994873046861,4.550994873046861,0.0,30.057770640992928,102.20800018310548,119.39849853515624,27.157460545989586,-72.8425394540104,-1.6118254565786003,-1.8282686358434204,-0.06280744641848857,3319237540.0,-1.0
2379,2022-06-14,GOOG,106.88999938964844,108.4574966430664,106.35199737548828,107.19400024414062,25480000.0,0.0,0.0,0.31749725341796875,0.0,0.31749725341796875,31.41264519857245,104.21125030517578,119.39849853515624,19.639831349281124,-80.36016865071888,-1.9671044078806261,-1.8560357902508617,-0.060830411964039155,3344717540.0,1.0
2380,2022-06-15,GOOG,108.89949798583984,112.06300354003906,108.1187515258789,110.3905029296875,33192000.0,0.0,0.0,3.196502685546875,0.0,3.196502685546875,44.01174594677885,105.48799896240234,119.39849853515624,35.24319124302016,-64.75680875697985,-1.968048051131987,-1.878438242427087,-0.06246920600544126,3377909540.0,1.0
2381,2022-06-16,GOOG,108.14949798583984,109.29049682617188,105.7925033569336,106.63600158691406,35314000.0,0.0,0.0,-3.7545013427734375,3.7545013427734375,0.0,35.238860662747825,105.7925033569336,119.39849853515624,6.199460009588622,-93.80053999041138,-2.2458638553691657,-1.951923365015503,-0.06920150480819531,3342595540.0,-1.0
2382,2022-06-17,GOOG,106.53500366210938,109.24949645996094,105.62854766845705,107.8655014038086,43516000.0,0.0,0.0,1.2294998168945312,0.0,1.2294998168945312,39.77488719703278,105.62854766845705,119.39849853515624,16.24518313105478,-83.75481686894523,-2.3398521626931057,-2.0295091245510237,-0.07815535183349853,3386111540.0,1.0
2383,2022-06-21,GOOG,109.7020034790039,112.6729965209961,109.2935028076172,112.01499938964844,39010000.0,0.0,0.0,4.149497985839844,0.0,4.149497985839844,52.6813783422731,105.62854766845705,119.39849853515624,46.37962606414365,-53.62037393585635,-2.055810659159775,-2.034769431472774,-0.04448112834560258,3425121540.0,1.0
2384,2022-06-22,GOOG,111.16300201416016,113.76950073242188,110.72429656982422,112.03399658203124,23922000.0,0.0,0.0,0.01899719238279829,0.0,0.01899719238279829,52.73488564365879,105.62854766845705,119.39849853515624,46.517587285405085,-53.48241271459491,-1.8083275323933208,-1.9894810516568833,-0.04438835894870574,3449043540.0,1.0
2385,2022-06-23,GOOG,112.9499969482422,113.19650268554688,111.02899932861328,112.68450164794922,24710000.0,0.0,0.0,0.650505065917983,0.0,0.650505065917983,54.75626836557401,105.62854766845705,119.39849853515624,51.24167869441035,-48.75832130558964,-1.5419306325755002,-1.899970967840607,-0.01943557696674103,3473753540.0,1.0
2386,2022-06-24,GOOG,113.60299682617188,118.6374969482422,113.60299682617188,118.53800201416016,39122000.0,0.0,0.0,5.8535003662109375,0.0,5.8535003662109375,68.66861307334214,105.62854766845705,119.39849853515624,93.75091073798181,-6.249089262018188,-0.8486973555552595,-1.6897162453835377,0.06381283154256856,3512875540.0,1.0
2387,2022-06-27,GOOG,118.93499755859376,119.25,116.00074768066406,116.62249755859376,32840000.0,0.0,0.0,-1.915504455566392,1.915504455566392,0.0,61.52513213047966,105.62854766845705,119.25,80.71055583902918,-19.289444160970817,-0.4486978802078738,-1.441512572348405,0.09118931004616715,3480035540.0,-1.0
2388,2022-06-28,GOOG,116.35099792480467,117.85649871826172,112.44400024414062,112.57150268554688,28232000.0,0.0,0.0,-4.050994873046889,4.050994873046889,0.0,49.068953122427466,105.62854766845705,119.25,50.97073974272297,-49.02926025727703,-0.4533508978829417,-1.2438802374553124,0.05016607673152107,3451803540.0,-1.0
2389,2022-06-29,GOOG,112.14849853515624,113.66449737548828,111.5540008544922,112.25650024414062,18628000.0,0.0,0.0,-0.31500244140625,0.31500244140625,0.0,48.193523776859664,105.62854766845705,119.25,48.65819307927502,-51.341806920724984,-0.47695843243704417,-1.0904958764516588,0.016903603706214243,3433175540.0,-1.0
2390,2022-06-30,GOOG,110.49949645996094,111.32980346679688,107.30999755859376,109.37249755859376,38046000.0,0.0,0.0,-2.884002685546861,2.884002685546861,0.0,40.550870800065184,105.62854766845705,119.25,27.485688008957172,-72.51431199104283,-0.720081832630612,-1.0164130676874494,0.02566202718553079,3395129540.0,-1.0
2391,2022-07-01,GOOG,108.33699798583984,109.8063507080078,107.1050033569336,109.08100128173828,31028000.0,0.0,0.0,-0.29149627685548296,0.29149627685548296,0.0,39.814524264719985,105.62854766845705,119.25,25.345708587082527,-74.65429141291747,-0.9256103325584348,-0.9982525206616465,0.011268662010658126,3364101540.0,-1.0
2392,2022-07-05,GOOG,107.5145034790039,114.05259704589844,106.24949645996094,113.88700103759766,36398000.0,0.0,0.0,4.805999755859375,0.0,4.805999755859375,55.267281819936784,105.62854766845705,119.25,60.62828814528578,-39.37171185471422,-0.6927040732588665,-0.9371428311810905,0.016712062296562635,3400499540.0,1.0
2393,2022-07-06,GOOG,114.09200286865234,116.35199737548828,112.25050354003906,115.2135009765625,28852000.0,0.0,0.0,1.3264999389648438,0.0,1.3264999389648438,58.648527077396146,105.62854766845705,119.25,70.36660316983784,-29.633396830162162,-0.39651593681604425,-0.8290174523080814,0.028379817658323425,3429351540.0,1.0
2394,2022-07-07,GOOG,116.00800323486328,119.86199951171876,115.53399658203124,119.30599975585938,32184000.0,0.0,0.0,4.092498779296875,0.0,4.092498779296875,67.41616829067335,105.62854766845705,119.86199951171876,96.09371105490054,-3.90628894509947,0.16652613466359867,-0.6299087349137454,0.05876139141651571,3461535540.0,1.0
2395,2022-07-08,GOOG,117.5500030517578,120.43499755859376,117.51399993896484,120.1685028076172,29082000.0,0.0,0.0,0.8625030517578267,0.0,0.8625030517578267,69.01381197294828,105.62854766845705,120.43499755859376,98.20014417396511,-1.7998558260348914,0.674561891266066,-0.3690146096777831,0.013755089218242977,3490617540.0,1.0
2396,2022-07-11,GOOG,118.6500015258789,118.79450225830078,116.2344970703125,116.52249908447266,26718000.0,0.0,0.0,-3.6460037231445455,3.6460037231445455,0.0,55.69418655026133,106.24949645996094,120.43499755859376,72.4190323139294,-27.580967686070583,0.7740589888517349,-0.14039988997187947,-0.0008574544038628673,3463899540.0,-1.0
2397,2022-07-12,GOOG,116.8385009765625,117.84950256347656,114.61499786376952,114.84950256347656,24970000.0,0.0,0.0,-1.6729965209960938,1.6729965209960938,0.0,50.53076367999699,106.24949645996094,120.43499755859376,60.62532471513804,-39.37467528486196,0.7097329583467911,0.029626679691854695,0.020236026201879698,3438929540.0,-1.0
2398,2022-07-13,GOOG,112.63899993896484,115.15699768066406,111.822998046875,112.18699645996094,38958000.0,0.0,0.0,-2.662506103515625,2.662506103515625,0.0,43.179689216757914,106.24949645996094,120.43499755859376,41.85611744496108,-58.143882555038914,0.4388532970342851,0.1114720031603408,-0.0006191515326821051,3399971540.0,-1.0
2399,2022-07-14,GOOG,110.82599639892578,111.9875030517578,109.32550048828124,111.44000244140624,32366000.0,0.0,0.0,-0.7469940185547017,0.7469940185547017,0.0,41.237627400777754,106.24949645996094,120.43499755859376,36.59021944558272,-63.40978055441728,0.16203519854823867,0.12158464223792038,0.018903334283875584,3367605540.0,-1.0
2400,2022-07-15,GOOG,112.96299743652344,114.00050354003906,111.82250213623048,112.76699829101562,34330000.0,0.0,0.0,1.3269958496093892,0.0,1.3269958496093892,46.19766541692543,106.24949645996094,120.43499755859376,45.94481214119981,-54.05518785880019,0.049165585759652686,0.10710083094226686,0.03379137490457218,3401935540.0,1.0
2401,2022-07-18,GOOG,113.44000244140624,114.8000030517578,109.3000030517578,109.91000366210938,33354000.0,0.0,20.0,-2.85699462890625,2.85699462890625,0.0,38.18973800787245,106.24949645996094,120.43499755859376,25.80456747136857,-74.19543252863143,-0.26773371757163034,0.0321339212394874,-0.034920555807553044,3368581540.0,-1.0
2402,2022-07-19,GOOG,111.7300033569336,114.80999755859376,110.5,114.62000274658205,30992300.0,0.0,0.0,4.7099990844726705,0.0,4.7099990844726705,53.51670732575753,106.24949645996094,120.43499755859376,59.007476919005995,-40.992523080994,-0.1372391283425145,-0.0017406886769129942,-0.005151290646928541,3399573840.0,1.0
2403,2022-07-20,GOOG,114.05999755859376,116.33000183105467,113.26000213623048,114.6999969482422,26780100.0,0.0,0.0,0.07999420166015625,0.0,0.07999420166015625,53.741495203556575,106.24949645996094,120.43499755859376,59.57139215262342,-40.42860784737658,-0.02705449530017745,-0.006803450001565887,-0.038606631829435356,3426353940.0,1.0
2404,2022-07-21,GOOG,115.08999633789062,115.20999908447266,111.91000366210938,115.04000091552734,27267800.0,0.0,0.0,0.34000396728514204,0.0,0.34000396728514204,54.813165767573665,106.24949645996094,120.43499755859376,61.96823358191851,-38.03176641808149,0.08670363333752107,0.01189796666625151,-0.04267758832196067,3453621740.0,1.0
2405,2022-07-22,GOOG,111.80999755859376,113.18000030517578,107.5999984741211,108.36000061035156,44455300.0,0.0,0.0,-6.680000305175781,6.680000305175781,0.0,35.938762379696385,106.24949645996094,120.43499755859376,14.877896351465733,-85.12210364853426,-0.3580352205168964,-0.06208867077037809,-0.07005083600381512,3409166440.0,-1.0
2406,2022-07-25,GOOG,108.87999725341795,110.58000183105467,107.01000213623048,108.20999908447266,28289900.0,0.0,0.0,-0.15000152587890625,0.15000152587890625,0.0,35.62095715458952,107.01000213623048,120.43499755859376,8.938527801977685,-91.06147219802232,-0.7143631027177975,-0.19254355715986202,-0.057810467880209604,3380876540.0,-1.0
2407,2022-07-26,GOOG,107.43000030517578,107.73999786376952,104.76000213623048,105.44000244140624,36626600.0,0.0,0.0,-2.7699966430664205,2.7699966430664205,0.0,29.97334787885552,104.76000213623048,120.43499755859376,4.338121236103244,-95.66187876389675,-1.206364872519032,-0.3953078202316961,-0.06014060658948717,3344249940.0,-1.0
2408,2022-07-27,GOOG,109.5999984741211,114.4000015258789,108.41999816894533,113.5999984741211,41474600.0,0.0,0.0,8.159996032714858,0.0,8.159996032714858,54.495992914287,104.76000213623048,120.43499755859376,56.395527396956815,-43.604472603043185,-0.9271487422889635,-0.5016760046431497,0.019382591398008575,3385724540.0,1.0
2409,2022-07-28,GOOG,112.8000030517578,114.6999969482422,111.85099792480467,114.58999633789062,23303800.0,0.0,0.0,0.9899978637695312,0.0,0.9899978637695312,56.622471288966686,104.76000213623048,118.79450225830078,70.0416410713606,-29.958358928639413,-0.6188496797021372,-0.5251107396549471,0.016166059880129424,3409028340.0,1.0
2410,2022-07-29,GOOG,113.4000015258789,116.9000015258789,113.2300033569336,116.63999938964844,31336200.0,0.0,0.0,2.0500030517578125,0.0,2.0500030517578125,60.979336594523126,104.76000213623048,117.84950256347656,90.75974533519616,-9.240254664803844,-0.20671940511697073,-0.46143247274735183,0.06123187611046532,3440364540.0,1.0
2411,2022-08-01,GOOG,115.52999877929688,117.12000274658205,114.69000244140624,115.4800033569336,22856200.0,0.0,0.0,-1.1599960327148438,1.1599960327148438,0.0,57.226526265282445,104.76000213623048,117.12000274658205,86.7313971790993,-13.268602820900705,0.02599516529721768,-0.36394694513843795,0.007503058713520971,3417508340.0,-1.0
2412,2022-08-02,GOOG,114.43000030517578,117.08000183105467,114.26000213623048,115.9000015258789,17911000.0,0.0,0.0,0.4199981689453125,0.0,0.4199981689453125,58.298693139864596,104.76000213623048,117.12000274658205,90.12944044936873,-9.870559550631269,0.24152928191597312,-0.24285169972755574,0.010462115166212316,3435419340.0,1.0
2413,2022-08-03,GOOG,116.33999633789062,119.41999816894533,116.1500015258789,118.77999877929688,25302800.0,0.0,0.0,2.8799972534179688,0.0,2.8799972534179688,65.20037598959007,104.76000213623048,119.41999816894533,95.6343822452595,-4.365617754740497,0.637385942993447,-0.06680417118335516,0.032510412326194116,3460722140.0,1.0
2414,2022-08-04,GOOG,118.3000030517578,119.5,117.70999908447266,118.87000274658205,15757700.0,0.0,0.0,0.09000396728517046,0.0,0.09000396728517046,65.40682520687302,104.76000213623048,119.5,95.72593388926826,-4.274066110731734,0.9474461968632966,0.13604590242597525,0.09699152895008822,3476479840.0,1.0
2415,2022-08-05,GOOG,116.93000030517578,118.86000061035156,116.70999908447266,118.22000122070312,15615700.0,0.0,0.0,-0.6500015258789205,0.6500015258789205,0.0,62.32571935701948,104.76000213623048,119.5,91.3161535630675,-8.683846436932495,1.1277218159577416,0.3343810851323286,0.0925053342659794,3460864140.0,-1.0
2416,2022-08-08,GOOG,119.12000274658205,120.86000061035156,117.83000183105467,118.13999938964844,17061100.0,0.0,0.0,-0.0800018310546875,0.0800018310546875,0.0,61.91153984445279,104.76000213623048,120.86000061035156,83.10558087893475,-16.894419121065248,1.2497299547543435,0.5174508590567317,0.12044761621946742,3443803040.0,-1.0
2417,2022-08-09,GOOG,117.98999786376952,118.1999969482422,116.55999755859376,117.5,15424300.0,0.0,0.0,-0.6399993896484375,0.6399993896484375,0.0,58.333331433991624,104.76000213623048,120.86000061035156,79.13042901368978,-20.86957098631023,1.2800243577169965,0.6699655587887847,0.03433099980866072,3428378740.0,-1.0
2418,2022-08-10,GOOG,119.58999633789062,121.77999877929688,119.36000061035156,120.6500015258789,20497000.0,0.0,0.0,3.1500015258789062,0.0,3.1500015258789062,68.62983796748509,104.76000213623048,121.77999877929688,93.36076688429719,-6.6392331157028,1.540454289649972,0.8440633049610223,0.052884242793054925,3448875740.0,1.0
2419,2022-08-11,GOOG,122.08000183105467,122.33999633789062,119.5500030517578,119.81999969482422,16671600.0,0.0,0.0,-0.8300018310546875,0.8300018310546875,0.0,63.83394995791351,104.76000213623048,122.33999633789062,85.66554337754881,-14.334456622451183,1.66072882769393,1.007396409507604,0.027263377244650444,3432204140.0,-1.0
2420,2022-08-12,GOOG,121.16000366210938,122.6500015258789,120.4000015258789,122.6500015258789,16121100.0,0.0,0.0,2.8300018310546875,0.0,2.8300018310546875,71.63276525715605,104.76000213623048,122.6500015258789,100.0,-0.0,1.9617904627960456,1.1982752201652924,0.06208865570244049,3448325240.0,1.0
2421,2022-08-15,GOOG,122.20999908447266,123.26000213623048,121.56999969482422,122.87999725341795,15525000.0,0.0,0.0,0.2299957275390483,0.0,0.2299957275390483,72.19501742944986,108.41999816894533,123.26000213623048,97.43932088124605,-2.560679118753948,2.1936556142860724,1.3973512989894485,0.060224293663883266,3463850240.0,1.0
2422,2022-08-16,GOOG,122.31999969482422,123.22799682617188,121.53500366210938,122.51000213623048,15626200.0,0.0,0.0,-0.3699951171874716,0.3699951171874716,0.0,69.63316331360417,111.85099792480467,123.26000213623048,93.42624486676151,-6.573755133238493,2.320802141127558,1.5820414674170706,0.03140262161362939,3448224040.0,-1.0
2423,2022-08-17,GOOG,120.93000030517578,122.1500015258789,120.1999969482422,120.31999969482422,17589200.0,0.0,0.0,-2.190002441406264,2.190002441406264,0.0,56.04953733785488,113.2300033569336,123.26000213623048,70.68790828295235,-29.312091717047657,2.2192694287558368,1.7094870596848242,0.012198173759055075,3430634840.0,-1.0
2424,2022-08-18,GOOG,120.2300033569336,121.69000244140624,119.5500030517578,120.86000061035156,15652000.0,0.0,0.0,0.5400009155273438,0.0,0.5400009155273438,58.36055026849547,114.26000213623048,123.26000213623048,73.3333163791231,-26.666683620876896,2.157507183791509,1.7990910845061612,0.022331241434517146,3446286840.0,1.0
2425,2022-08-19,GOOG,119.87000274658205,120.0,117.66999816894533,118.12000274658205,20187000.0,0.0,0.0,-2.739997863769517,2.739997863769517,0.0,44.62319278602684,114.26000213623048,123.26000213623048,42.88889567057292,-57.111104329427086,1.8659556559114208,1.812463998787213,-0.0001692622580811154,3426099840.0,-1.0
2426,2022-08-22,GOOG,116.0999984741211,116.5,114.66999816894533,115.06999969482422,19316000.0,0.0,0.0,-3.0500030517578267,3.0500030517578267,0.0,34.26411128165921,114.66999816894533,123.26000213623048,4.656593028388452,-95.34340697161154,1.3729625555128848,1.7245637101323474,-0.02068085366107053,3406783840.0,-1.0
2427,2022-08-23,GOOG,114.31999969482422,115.93000030517578,114.3000030517578,114.7699966430664,14390700.0,0.0,0.0,-0.3000030517578125,0.3000030517578125,0.0,33.384523680272665,114.3000030517578,123.26000213623048,5.245464724690517,-94.75453527530948,0.9471362356243702,1.569078215230752,-0.04873605311601481,3392393140.0,-1.0
2428,2022-08-24,GOOG,114.4499969482422,115.71700286865234,113.77999877929688,114.6999969482422,16051200.0,0.0,0.0,-0.06999969482420454,0.06999969482420454,0.0,33.15537783393532,113.77999877929688,123.26000213623048,9.704618598815648,-90.29538140118434,0.597134029450828,1.3746893780747673,-0.042730785842283625,3376341940.0,-1.0
2429,2022-08-25,GOOG,115.1500015258789,117.77999877929688,115.0500030517578,117.6999969482422,14874700.0,0.0,0.0,3.0,0.0,3.0,50.09442227453467,113.77999877929688,123.26000213623048,41.35017701315757,-58.64982298684242,0.555427069862418,1.2108369164322976,-0.040358781215280026,3391216640.0,1.0
2430,2022-08-26,GOOG,115.80999755859376,116.5999984741211,111.22000122070312,111.3000030517578,31698700.0,0.0,0.0,-6.399993896484403,6.399993896484403,0.0,30.850574786550368,111.22000122070312,123.26000213623048,0.6644669848114306,-99.33553301518857,0.005880200153526971,0.9698455731765435,-0.09423823616937832,3359517940.0,-1.0
2431,2022-08-29,GOOG,110.77999877929688,111.95999908447266,109.80999755859376,110.33999633789062,20386100.0,0.0,0.0,-0.9600067138671733,0.9600067138671733,0.0,28.92725136350812,109.80999755859376,123.26000213623048,3.940510029105032,-96.05948997089497,-0.501325207136631,0.6756114171139086,-0.09933887508063932,3339131840.0,-1.0
2432,2022-08-30,GOOG,111.02999877929688,111.37000274658205,108.8000030517578,109.91000366210938,20548200.0,0.0,0.0,-0.42999267578125,0.42999267578125,0.0,28.024311741577563,108.8000030517578,123.26000213623048,7.676353254707383,-92.32364674529262,-0.9272966632566266,0.3550298010398015,-0.08651924916155607,3318583640.0,-1.0
2433,2022-08-31,GOOG,111.62999725341795,111.7699966430664,109.0500030517578,109.1500015258789,25898000.0,0.0,0.0,-0.7600021362304688,0.7600021362304688,0.0,26.347106794486834,108.8000030517578,123.26000213623048,2.420459863631253,-97.57954013636875,-1.3110944512749256,0.021804950576855973,-0.09688895437147382,3292685640.0,-1.0
2434,2022-09-01,GOOG,109.1999969482422,111.22000122070312,108.19000244140624,110.5500030517578,22784400.0,0.0,0.0,1.400001525878892,0.0,1.400001525878892,34.65897630171334,108.19000244140624,123.26000213623048,15.660256523841195,-84.3397434761588,-1.4851684432274368,-0.2795897281840027,-0.0640873647037169,3315470040.0,1.0
2435,2022-09-02,GOOG,111.33999633789062,111.6750030517578,108.12999725341795,108.68000030517578,20618100.0,0.0,0.0,-1.870002746582017,1.870002746582017,0.0,29.52392647216712,108.12999725341795,123.22799682617188,3.642886920929383,-96.35711307907061,-1.7538002122254994,-0.574431824992302,-0.05553141050313093,3294851940.0,-1.0
2436,2022-09-06,GOOG,108.13500213623048,108.87999725341795,106.51000213623048,107.4800033569336,20565100.0,0.0,0.0,-1.1999969482421875,1.1999969482421875,0.0,26.60527348533884,106.51000213623048,122.1500015258789,6.202054082848118,-93.79794591715188,-2.040006622984336,-0.8675467845907089,-0.06351828438929574,3274286840.0,-1.0
2437,2022-09-07,GOOG,107.76000213623048,110.98999786376952,107.61499786376952,110.4800033569336,22987200.0,0.0,0.0,3.0,0.0,3.0,42.89084785189241,106.51000213623048,121.69000244140624,26.152840190322685,-73.84715980967731,-2.001678236849699,-1.0943730750425071,-0.03679157544540179,3297274040.0,1.0
2438,2022-09-08,GOOG,109.18000030517578,110.58000183105467,108.05999755859376,109.41999816894533,21660700.0,0.0,0.0,-1.060005187988267,1.060005187988267,0.0,39.33268019758767,106.51000213623048,120.0,21.57150847688646,-78.42849152311354,-2.033396544910218,-1.2821777690160494,-0.07034833469824087,3275613340.0,-1.0
2439,2022-09-09,GOOG,110.0500030517578,112.0,110.0,111.77999877929688,21732900.0,0.0,0.0,2.3600006103515483,0.0,2.3600006103515483,49.99045846132424,106.51000213623048,117.77999877929688,46.76129736301773,-53.23870263698226,-1.8468123040189397,-1.3951046760166277,0.004312629958472369,3297346240.0,1.0
2440,2022-09-12,GOOG,111.98999786376952,112.63999938964844,110.93000030517578,111.87000274658205,19732900.0,0.0,0.0,0.09000396728517046,0.0,0.09000396728517046,50.37409306458212,106.51000213623048,117.77999877929688,47.55991310475838,-52.44008689524162,-1.6724019719814436,-1.450564135209591,0.013866290189154418,3317079140.0,1.0
2441,2022-09-13,GOOG,108.88999938964844,109.37000274658205,105.0,105.30999755859376,33015000.0,0.0,0.0,-6.560005187988281,6.560005187988281,0.0,30.619905244812628,105.0,117.77999877929688,2.4256462300759276,-97.57435376992407,-2.0400022456721416,-1.5684517573021013,-0.041852478848578456,3284064140.0,-1.0
2442,2022-09-14,GOOG,105.44000244140624,106.0999984741211,104.5,105.87000274658205,22115800.0,0.0,0.0,0.5600051879882812,0.0,0.5600051879882812,33.200163134450136,104.5,117.77999877929688,10.316286690612046,-89.68371330938795,-2.2600874907393234,-1.7067789039895458,-0.030050377768608527,3306179940.0,1.0
2443,2022-09-15,GOOG,105.01000213623048,106.20999908447266,103.30999755859376,103.9000015258789,26494900.0,0.0,0.0,-1.9700012207031392,1.9700012207031392,0.0,28.845725768403398,103.30999755859376,116.5999984741211,4.439457687288892,-95.5605423127111,-2.5639140622783856,-1.878205935647314,-0.06015378871374133,3279685040.0,-1.0
2444,2022-09-16,GOOG,102.97000122070312,104.02999877929688,101.8550033569336,103.62999725341795,64540100.0,0.0,0.0,-0.2700042724609517,0.2700042724609517,0.0,28.259574780907457,101.8550033569336,112.63999938964844,16.457993040518087,-83.54200695948192,-2.79427523194515,-2.0614197949068815,-0.046466719153269276,3215144940.0,-1.0
2445,2022-09-19,GOOG,102.54000091552734,104.0199966430664,102.37000274658205,103.8499984741211,19738600.0,0.0,0.0,0.2200012207031392,0.0,0.2200012207031392,29.604430573109198,101.8550033569336,112.63999938964844,18.497875299498943,-81.50212470050106,-2.92536408251749,-2.2342086524290035,-0.03377376971935431,3234883540.0,1.0
2446,2022-09-20,GOOG,102.87999725341795,103.16999816894533,101.12000274658205,101.83000183105467,24001700.0,0.0,0.0,-2.0199966430664205,2.0199966430664205,0.0,24.699118058923986,101.12000274658205,112.63999938964844,6.163188293114297,-93.8368117068857,-3.155870873352768,-2.4185410966137564,-0.07829472540775462,3210881840.0,-1.0
2447,2022-09-21,GOOG,102.23999786376952,103.48999786376952,99.98999786376952,100.01000213623048,26596800.0,0.0,0.0,-1.8199996948241903,1.8199996948241903,0.0,21.069700716449418,99.98999786376952,112.63999938964844,0.15813652211853016,-99.84186347788146,-3.4456881823025185,-2.623970513751509,-0.0859988684900701,3184285040.0,-1.0
2448,2022-09-22,GOOG,99.4499969482422,101.68000030517578,99.41000366210938,100.56999969482422,21272700.0,0.0,0.0,0.5599975585937358,0.0,0.5599975585937358,24.98329819261535,99.41000366210938,112.63999938964844,8.767924469546424,-91.23207553045359,-3.5888137537878464,-2.8169391617587767,-0.10028626951952424,3205557740.0,1.0
2449,2022-09-23,GOOG,100.05999755859376,100.11000061035156,98.01000213623048,99.16999816894533,25657000.0,0.0,0.0,-1.400001525878892,1.400001525878892,0.0,21.857108064299695,98.01000213623048,112.63999938964844,7.928887563145906,-92.0711124368541,-3.771732044009852,-3.007897738208992,-0.11352466493100843,3179900740.0,-1.0
2450,2022-09-26,GOOG,98.61000061035156,100.44000244140624,98.37999725341795,98.80999755859376,22437900.0,0.0,0.0,-0.3600006103515625,0.3600006103515625,0.0,21.074671626858134,98.01000213623048,112.63999938964844,5.468185731725829,-94.53181426827418,-3.9007793908042885,-3.1864740687280517,-0.061722534903520865,3157462840.0,-1.0
2451,2022-09-27,GOOG,99.91000366210938,100.45999908447266,97.33999633789062,98.08999633789062,24225000.0,0.0,0.0,-0.7200012207031392,0.7200012207031392,0.0,19.466535063775112,97.33999633789062,112.63999938964844,4.901959806562474,-95.09804019343753,-4.014867530362551,-3.352152761054952,-0.07348640981255283,3133237840.0,-1.0
2452,2022-09-28,GOOG,98.0199966430664,101.4000015258789,97.8000030517578,100.73999786376952,24617000.0,0.0,0.0,2.650001525878892,0.0,2.650001525878892,39.17679010339257,97.33999633789062,112.63999938964844,22.222227762812548,-77.77777223718745,-3.847103215640203,-3.4511428519720027,-0.030413894280091114,3157854840.0,1.0
2453,2022-09-29,GOOG,99.3000030517578,99.3000030517578,96.5199966430664,98.08999633789062,21921500.0,0.0,0.0,-2.650001525878892,2.650001525878892,0.0,30.549601148223275,96.5199966430664,112.63999938964844,9.739450541701117,-90.26054945829888,-3.8832184387553212,-3.5375579693286667,-0.05345943319847579,3135933340.0,-1.0
2454,2022-09-30,GOOG,97.7300033569336,99.49400329589844,96.02999877929688,96.1500015258789,26277800.0,0.0,0.0,-1.9399948120117188,1.9399948120117188,0.0,25.758239162218203,96.02999877929688,109.37000274658205,0.8995705464280537,-99.10042945357195,-4.022018060800804,-3.634449987623094,-0.074145373725364,3109655540.0,-1.0
2455,2022-10-03,GOOG,97.22000122070312,99.97000122070312,97.0199966430664,99.3000030517578,24840000.0,0.0,0.0,3.150001525878892,0.0,3.150001525878892,42.619074571950236,96.02999877929688,106.20999908447266,32.12184847183518,-67.87815152816482,-3.833647066768606,-3.6742894034521965,-0.024845318018302476,3134495540.0,1.0
2456,2022-10-04,GOOG,101.04000091552734,102.72000122070312,101.04000091552734,102.41000366210938,22580900.0,0.0,0.0,3.1100006103515767,0.0,3.1100006103515767,54.41323899893173,96.02999877929688,106.20999908447266,62.671951783427126,-37.328048216572874,-3.394283452193747,-3.6182882132005068,0.023997614984646143,3157076440.0,1.0
2457,2022-10-05,GOOG,100.69000244140624,102.73999786376952,99.73999786376952,102.22000122070312,18475500.0,0.0,0.0,-0.19000244140625,0.19000244140625,0.0,53.636091653171476,96.02999877929688,104.02999877929688,77.37503051757812,-22.624969482421875,-3.0265282970441945,-3.499936229969245,0.016406498268725977,3138600940.0,-1.0
2458,2022-10-06,GOOG,101.5,103.7300033569336,101.5,102.23999786376952,17156200.0,0.0,0.0,0.01999664306639204,0.0,0.01999664306639204,53.716365129031395,96.02999877929688,104.0199966430664,77.72216201247994,-22.27783798752005,-2.7023155139668233,-3.340412086768761,0.030956940118060272,3155757140.0,1.0
2459,2022-10-07,GOOG,100.6500015258789,101.41999816894533,99.20999908447266,99.56999969482422,24249900.0,0.0,0.0,-2.6699981689452983,2.6699981689452983,0.0,42.405085298595885,96.02999877929688,103.7300033569336,45.97401053252151,-54.02598946747849,-2.630498338264033,-3.1984293370678154,0.007691551007070752,3131507240.0,-1.0
2460,2022-10-10,GOOG,99.8499984741211,99.98999786376952,97.87000274658205,98.70999908447266,16529900.0,0.0,0.0,-0.8600006103515625,0.8600006103515625,0.0,39.327322068488485,96.02999877929688,103.7300033569336,34.80517807689831,-65.1948219231017,-2.61285816851624,-3.081315103357501,0.006320754100614945,3114977340.0,-1.0
2461,2022-10-11,GOOG,98.25,100.12000274658205,97.25,98.0500030517578,21617700.0,0.0,0.0,-0.659996032714858,0.659996032714858,0.0,36.952394732034016,96.02999877929688,103.7300033569336,26.233806124319237,-73.76619387568077,-2.621910617408858,-2.989434206167773,-0.026702351290987636,3093359640.0,-1.0
2462,2022-10-12,GOOG,98.2699966430664,99.64800262451172,97.66999816894533,98.3000030517578,17343400.0,0.0,0.0,0.25,0.0,0.25,38.573671283590514,96.02999877929688,103.7300033569336,29.480557440884432,-70.51944255911557,-2.579180648679028,-2.9073834946700243,0.002140959544373544,3110703040.0,1.0
2463,2022-10-13,GOOG,95.93000030517578,100.52999877929688,95.2699966430664,99.70999908447266,32812200.0,0.0,0.0,1.409996032714858,0.0,1.409996032714858,47.37948318019362,95.2699966430664,103.7300033569336,52.48225671178768,-47.51774328821232,-2.4038320648857763,-2.806673208713175,0.03702545504001442,3143515240.0,1.0
2464,2022-10-14,GOOG,100.625,101.29000091552734,97.02999877929688,97.18000030517578,22624800.0,0.0,0.0,-2.529998779296875,2.529998779296875,0.0,36.535665736444685,95.2699966430664,103.7300033569336,22.57685752162111,-77.42314247837889,-2.440879862656786,-2.7335145395018974,-0.021349473126169194,3120890440.0,-1.0
2465,2022-10-17,GOOG,99.5199966430664,101.7699966430664,99.51000213623048,100.77999877929688,23311600.0,0.0,0.0,3.5999984741210938,0.0,3.5999984741210938,53.86994423843025,95.2699966430664,103.7300033569336,65.1299972043612,-34.870002795638804,-2.154910254853405,-2.617793682572199,-0.015916461522553216,3144202040.0,1.0
2466,2022-10-18,GOOG,103.94000244140624,104.22000122070312,100.6500015258789,101.38999938964844,21610500.0,0.0,0.0,0.6100006103515625,0.0,0.6100006103515625,56.2084692907215,95.2699966430664,104.22000122070312,68.37988398211569,-31.620116017884314,-1.8576415931577088,-2.465763264689301,-0.008119759549431338,3165812540.0,1.0
2467,2022-10-19,GOOG,100.6999969482422,101.65899658203124,99.63500213623048,100.29000091552734,21573700.0,0.0,0.0,-1.0999984741210938,1.0999984741210938,0.0,50.84533267024354,95.2699966430664,104.22000122070312,56.089404523930284,-43.910595476069716,-1.691318256794304,-2.3108742631103016,-0.019072740502601215,3144238840.0,-1.0
2468,2022-10-20,GOOG,100.81999969482422,103.0,99.97000122070312,100.52999877929688,25125100.0,0.0,0.0,0.23999786376953125,0.0,0.23999786376953125,51.99835164167045,95.2699966430664,104.22000122070312,58.77094352972265,-41.22905647027734,-1.5225885396642127,-2.1532171184210838,0.009641449105302735,3169363940.0,1.0
2469,2022-10-21,GOOG,98.45999908447266,101.62000274658205,98.2300033569336,101.4800033569336,28988700.0,0.0,0.0,0.9500045776367188,0.0,0.9500045776367188,56.64342800236851,95.2699966430664,104.22000122070312,69.38551438715534,-30.614485612844653,-1.2972576150395412,-1.9820252177447752,0.028062043340619125,3198352640.0,1.0
2470,2022-10-24,GOOG,102.08999633789062,103.0999984741211,100.3000030517578,102.97000122070312,24680800.0,0.0,0.0,1.4899978637695312,0.0,1.4899978637695312,63.10466940522704,95.2699966430664,104.22000122070312,86.03352669647386,-13.966473303526142,-0.9870725013145005,-1.7830346744587202,0.05017846013067628,3223033440.0,1.0
2471,2022-10-25,GOOG,103.3000030517578,105.0999984741211,103.0199966430664,104.93000030517578,29910200.0,0.0,0.0,1.9599990844726562,0.0,1.9599990844726562,69.91066609228285,95.2699966430664,105.0999984741211,98.27061915280363,-1.7293808471963725,-0.5764480835228198,-1.54171735627154,0.06744656203039079,3252943640.0,1.0
2472,2022-10-26,GOOG,96.76000213623048,98.54000091552734,94.56999969482422,94.81999969482422,71504300.0,0.0,0.0,-10.110000610351562,10.110000610351562,0.0,33.3240868870939,94.56999969482422,105.0999984741211,2.3741693160641884,-97.62583068393582,-1.0546603623349142,-1.444305957484215,-0.049042216774124237,3181439340.0,-1.0
2473,2022-10-27,GOOG,94.30999755859376,95.16999816894533,91.9000015258789,92.5999984741211,54036500.0,0.0,0.0,-2.220001220703125,2.220001220703125,0.0,29.42276498016207,91.9000015258789,105.0999984741211,5.303008409675462,-94.69699159032454,-1.5944032951089042,-1.474325425009153,-0.047129057590780454,3127402840.0,-1.0
2474,2022-10-28,GOOG,92.52999877929688,96.86000061035156,92.322998046875,96.58000183105467,35696900.0,0.0,0.0,3.9800033569335795,0.0,3.9800033569335795,43.18259463456544,91.9000015258789,105.0999984741211,35.45455596335567,-64.54544403664433,-1.681615828836172,-1.515783505774557,-0.04167490572648236,3163099740.0,1.0
2475,2022-10-31,GOOG,95.77999877929688,96.3499984741211,94.37999725341795,94.66000366210938,29868700.0,0.0,0.0,-1.9199981689452983,1.9199981689452983,0.0,38.95514426921409,91.9000015258789,105.0999984741211,20.909111926711557,-79.09088807328844,-1.883943270973262,-1.5894154588142981,-0.06637731302941674,3133231040.0,-1.0
2476,2022-11-01,GOOG,95.58999633789062,96.16500091552734,90.43000030517578,90.5,43220600.0,0.0,0.0,-4.160003662109375,4.160003662109375,0.0,31.29572836044467,90.43000030517578,105.0999984741211,0.47716226013170204,-99.5228377398683,-2.3528446272207617,-1.742101292495591,-0.09761691919589577,3090010440.0,-1.0
2477,2022-11-02,GOOG,90.91000366210938,91.3000030517578,87.01000213623047,87.06999969482422,43553600.0,0.0,0.0,-3.4300003051757812,3.4300003051757812,0.0,26.364082812209972,87.01000213623047,105.0999984741211,0.3316615297930236,-99.66833847020698,-2.9670226984575265,-1.9870855736879782,-0.13389037349958277,3046456840.0,-1.0
2478,2022-11-03,GOOG,86.34500122070312,86.55000305175781,83.44999694824219,83.48999786376953,48510400.0,0.0,0.0,-3.5800018310546875,3.5800018310546875,0.0,22.158842174756288,83.44999694824219,105.0999984741211,0.18476172151549014,-99.81523827848451,-3.6999883111806326,-2.3296661211865093,-0.17727635886932502,2997946440.0,-1.0
2479,2022-11-04,GOOG,85.51000213623047,86.7300033569336,83.87999725341797,86.69999694824219,40173300.0,0.0,0.0,3.2099990844726562,0.0,3.2099990844726562,33.18494595834365,83.44999694824219,105.0999984741211,15.011546286106151,-84.98845371389385,-3.9760157068755007,-2.658936038324308,-0.1580072261783143,3038119740.0,1.0
2480,2022-11-07,GOOG,87.33999633789062,88.94000244140625,86.95999908447266,88.6500015258789,26899900.0,0.0,0.0,1.9500045776367188,0.0,1.9500045776367188,39.21963279140907,83.44999694824219,105.0999984741211,24.018495201586916,-75.98150479841308,-3.99140984594888,-2.925430799849223,-0.1551510409982706,3065019640.0,1.0
2481,2022-11-08,GOOG,89.16000366210938,90.40499877929688,87.6500015258789,88.91000366210938,30172000.0,0.0,0.0,0.26000213623046875,0.0,0.26000213623046875,40.05262280023947,83.44999694824219,105.0999984741211,25.219428771590042,-74.78057122840997,-3.9372437178774646,-3.1277933834548715,-0.06232858101387906,3095191640.0,1.0
2482,2022-11-09,GOOG,88.54499816894531,89.48999786376953,87.36000061035156,87.4000015258789,26743900.0,0.0,0.0,-1.5100021362304688,1.5100021362304688,0.0,36.68364956303892,83.44999694824219,105.0999984741211,18.24482355308455,-81.75517644691546,-3.970393004838442,-3.2963133077315856,-0.05615547552838707,3068447740.0,-1.0
2483,2022-11-10,GOOG,92.33999633789062,94.5500030517578,91.6500015258789,94.16999816894533,42371200.0,0.0,0.0,6.7699966430664205,0.0,6.7699966430664205,55.88130081042581,83.44999694824219,105.0999984741211,49.51501369590757,-50.48498630409243,-3.411061312214642,-3.3192629086281973,-0.02495344394717569,3110818940.0,1.0
2484,2022-11-11,GOOG,94.70999908447266,97.36000061035156,94.16000366210938,96.7300033569336,30569100.0,0.0,0.0,2.560005187988267,0.0,2.560005187988267,61.03592380196872,83.44999694824219,105.0999984741211,61.33951719503303,-38.66048280496697,-2.7297490444537544,-3.2013601357933097,0.02186773309467771,3141388040.0,1.0
2485,2022-11-14,GOOG,95.5,97.18000030517578,95.11299896240234,96.02999877929688,24170100.0,0.0,0.0,-0.7000045776367188,0.7000045776367188,0.0,58.86598944049124,83.44999694824219,98.54000091552734,83.36645807600776,-16.63354192399224,-2.2206899514673495,-3.005226098928118,0.06110495888725831,3117217940.0,-1.0
2486,2022-11-15,GOOG,98.66999816894533,100.41999816894533,97.0199966430664,98.72000122070312,31831000.0,0.0,0.0,2.69000244140625,0.0,2.69000244140625,64.4672925633681,83.44999694824219,100.41999816894533,89.98234044810656,-10.017659551893441,-1.5819603824174635,-2.7205729556259874,0.13380040848411112,3149048940.0,1.0
2487,2022-11-16,GOOG,98.0199966430664,99.8499984741211,97.9020004272461,98.98999786376952,24660200.0,0.0,0.0,0.26999664306639204,0.0,0.26999664306639204,65.01895622990195,83.44999694824219,100.41999816894533,91.57336356917152,-8.426636430828486,-1.0419650005820102,-2.3848513646171923,0.1856509809149991,3173709140.0,1.0
2488,2022-11-17,GOOG,97.18000030517578,99.4800033569336,97.0999984741211,98.5,21818700.0,0.0,0.0,-0.48999786376951704,0.48999786376951704,0.0,62.97168618101207,83.44999694824219,100.41999816894533,88.68592792672897,-11.31407207327103,-0.6461055993810731,-2.0371022115699686,0.13610153941299585,3151890440.0,-1.0
2489,2022-11-18,GOOG,99.01000213623048,99.16000366210938,96.73999786376952,97.8000030517578,24969900.0,0.0,0.0,-0.6999969482422017,0.6999969482422017,0.0,59.86458781320034,83.44999694824219,100.41999816894533,84.56101986609656,-15.438980133903438,-0.3844365305007216,-1.7065690753561191,0.10321490545274048,3126920540.0,-1.0
2490,2022-11-21,GOOG,97.55999755859376,98.72000122070312,95.66999816894533,95.83000183105467,18696900.0,0.0,0.0,-1.970001220703125,1.970001220703125,0.0,51.59743363855937,83.44999694824219,100.41999816894533,72.95229223501217,-27.047707764987834,-0.33219520319471485,-1.4316943009238383,0.07783149121491251,3108223640.0,-1.0
2491,2022-11-22,GOOG,96.16000366210938,97.5479965209961,94.41000366210938,97.33000183105467,18868900.0,0.0,0.0,1.5,0.0,1.5,56.834579683565245,83.44999694824219,100.41999816894533,81.79141947190371,-18.20858052809628,-0.16782156837439288,-1.1789197544139494,0.1136155621488808,3127092540.0,1.0
2492,2022-11-23,GOOG,97.33999633789062,99.06900024414062,97.33999633789062,98.81999969482422,17568900.0,0.0,0.0,1.4899978637695455,0.0,1.4899978637695455,61.597058725810555,83.87999725341797,100.41999816894533,90.32649101839489,-9.673508981605119,0.08173391890376536,-0.9267890197504064,0.04937880021550578,3144661440.0,1.0
2493,2022-11-25,GOOG,98.46499633789062,98.94000244140624,97.52999877929688,97.5999984741211,8567800.0,0.0,0.0,-1.220001220703125,1.220001220703125,0.0,55.7824897843446,86.95999908447266,100.41999816894533,79.04903501756283,-20.95096498243717,0.17900112444846172,-0.7056309909106327,0.008994056518092153,3136093640.0,-1.0
2494,2022-11-28,GOOG,97.1999969482422,97.83000183105467,95.88999938964844,96.25,19974500.0,0.0,0.0,-1.3499984741210938,1.3499984741210938,0.0,49.7824425468552,87.36000061035156,100.41999816894533,68.07045215562559,-31.92954784437442,0.14547553969521232,-0.5354096847894637,0.00229096348536606,3116119140.0,-1.0
2495,2022-11-29,GOOG,96.0,96.38999938964844,94.38999938964844,95.44000244140624,20220000.0,0.0,0.0,-0.8099975585937642,0.8099975585937642,0.0,46.33228569441928,87.36000061035156,100.41999816894533,61.86832573898803,-38.13167426101198,0.05293602514664997,-0.41774054280224093,-0.03322527085432225,3095899140.0,-1.0
2496,2022-11-30,GOOG,95.12000274658205,101.4499969482422,94.66999816894533,101.4499969482422,39888100.0,0.0,0.0,6.009994506835966,0.0,6.009994506835966,66.31739657993106,91.6500015258789,101.4499969482422,100.0,-0.0,0.4592600581664925,-0.2423404226084942,0.02485098633761096,3135787240.0,1.0
2497,2022-12-01,GOOG,101.4000015258789,102.58999633789062,100.66999816894533,101.27999877929688,21771500.0,0.0,0.0,-0.1699981689453267,0.1699981689453267,0.0,65.52106763126844,94.16000366210938,102.58999633789062,84.46027643230015,-15.539723567699848,0.7588102579309322,-0.04211028650060888,0.028223337860882047,3114015740.0,-1.0
2498,2022-12-02,GOOG,99.37000274658205,101.1500015258789,99.16999816894533,100.83000183105467,18821500.0,0.0,0.0,-0.4499969482422017,0.4499969482422017,0.0,63.203052222759105,94.38999938964844,102.58999633789062,78.53664436773678,-21.46335563226322,0.9489559825825609,0.15610296731602513,0.03098158164364606,3095194240.0,-1.0
2499,2022-12-05,GOOG,99.81500244140624,101.75,99.3550033569336,99.87000274658205,19955500.0,0.0,0.0,-0.9599990844726278,0.9599990844726278,0.0,58.13992352834774,94.38999938964844,102.58999633789062,66.829334102476,-33.170665897523996,1.0105351164390726,0.3269893971406347,0.04215799685206911,3075238740.0,-1.0
2500,2022-12-06,GOOG,99.66999816894533,100.20999908447266,96.76000213623048,97.30999755859376,20877600.0,0.0,0.0,-2.5600051879882812,2.5600051879882812,0.0,46.642921825080634,94.38999938964844,102.58999633789062,35.60974702034834,-64.39025297965166,0.8430478688068774,0.4302010914738833,-0.00020553038204640384,3054361140.0,-1.0
2501,2022-12-07,GOOG,96.7699966430664,97.30999755859376,95.0250015258789,95.1500015258789,26647900.0,0.0,0.0,-2.159996032714858,2.159996032714858,0.0,39.11298815269516,94.38999938964844,102.58999633789062,9.268322183868477,-90.73167781613152,0.5299109072966388,0.45014305463843446,-0.037138212712801044,3027713240.0,-1.0
2502,2022-12-08,GOOG,95.69000244140624,95.87000274658205,93.8000030517578,93.9499969482422,25593200.0,0.0,0.0,-1.2000045776367045,1.2000045776367045,0.0,35.444921047852006,93.8000030517578,102.58999633789062,1.7064165079743023,-98.29358349202569,0.1828099494096591,0.3966764335926794,-0.037397557202285214,3002120040.0,-1.0
2503,2022-12-09,GOOG,93.9000015258789,94.48999786376952,93.0199966430664,93.06999969482422,21885300.0,0.0,0.0,-0.879997253417983,0.879997253417983,0.0,32.83904855115891,93.0199966430664,102.58999633789062,0.5224979451656185,-99.47750205483437,-0.16141776088166182,0.28505759469781117,-0.03303896420961849,2980234740.0,-1.0
2504,2022-12-12,GOOG,93.08999633789062,93.875,91.9000015258789,93.55999755859376,27380900.0,0.0,0.0,0.48999786376954546,0.0,0.48999786376954546,35.86828237419877,91.9000015258789,102.58999633789062,15.528501761755937,-84.47149823824405,-0.39018416857695115,0.15000924204285868,-0.019698290388945328,3007615640.0,1.0
2505,2022-12-13,GOOG,98.06999969482422,99.8000030517578,95.37999725341795,95.8499984741211,34788500.0,0.0,0.0,2.2900009155273295,0.0,2.2900009155273295,48.41496849600057,91.9000015258789,102.58999633789062,36.95041033886947,-63.04958966113053,-0.38229243013572045,0.04354890760714282,-0.055199592336884096,3042404140.0,1.0
2506,2022-12-14,GOOG,95.54000091552734,97.22000122070312,93.94000244140624,95.30999755859376,26452900.0,0.0,0.0,-0.5400009155273295,0.5400009155273295,0.0,45.96805274976835,91.9000015258789,102.58999633789062,31.898949369771874,-68.10105063022813,-0.41482983139751184,-0.04812684019378814,-0.058945510393543454,3015951240.0,-1.0
2507,2022-12-15,GOOG,93.54000091552734,94.02999877929688,90.43000030517578,91.1999969482422,28298800.0,0.0,0.0,-4.1100006103515625,4.1100006103515625,0.0,31.837173996580702,90.43000030517578,102.58999633789062,6.332211301671871,-93.66778869832812,-0.7634579884096127,-0.1911930698369531,-0.09550733618896479,2987652440.0,-1.0
2508,2022-12-16,GOOG,91.1999969482422,91.75,90.01000213623047,90.86000061035156,48485500.0,0.0,0.0,-0.3399963378906392,0.3399963378906392,0.0,30.929629270899184,90.01000213623047,102.58999633789062,6.756747741655725,-93.24325225834428,-1.055021545918521,-0.3639587650532668,-0.09021730137620165,2939166940.0,-1.0
2509,2022-12-19,GOOG,90.87999725341795,91.1999969482422,88.92500305175781,89.1500015258789,23020500.0,0.0,0.0,-1.7099990844726562,1.7099990844726562,0.0,26.539339535506798,88.92500305175781,102.58999633789062,1.6465319038935893,-98.35346809610641,-1.4078416783871859,-0.5727353477200507,-0.08385568017100642,2916146440.0,-1.0
2510,2022-12-20,GOOG,88.7300033569336,89.77999877929688,88.04000091552734,89.62999725341797,21976800.0,0.0,0.0,0.4799957275390625,0.0,0.4799957275390625,29.76814591119809,88.04000091552734,102.58999633789062,10.92781332045512,-89.07218667954487,-1.6299336708209324,-0.7841750123402272,-0.05801370660997418,2938123240.0,1.0
2511,2022-12-21,GOOG,89.7300033569336,90.91500091552734,88.91000366210938,90.25,20336400.0,0.0,0.0,0.6200027465820312,0.0,0.6200027465820312,34.0860095851115,88.04000091552734,101.75,16.119615113436474,-83.88038488656353,-1.7359037173499985,-0.9745207533421816,-0.03938261914239938,2958459640.0,1.0
2512,2022-12-22,GOOG,88.93000030517578,89.18000030517578,86.94000244140625,88.26000213623047,23656100.0,0.0,0.0,-1.9899978637695312,1.9899978637695312,0.0,27.764372516481572,86.94000244140625,101.75,8.912896100096024,-91.08710389990398,-1.9578925723689196,-1.1711951171475292,-0.05168150396868698,2934803540.0,-1.0
2513,2022-12-23,GOOG,87.62000274658203,90.0999984741211,87.62000274658203,89.80999755859375,17815000.0,0.0,0.0,1.5499954223632812,0.0,1.5499954223632812,38.08436621499035,86.94000244140625,100.20999908447266,21.627700401017634,-78.37229959898237,-1.985856939931736,-1.3341274817043707,-0.04008123234132732,2952618540.0,1.0
2514,2022-12-27,GOOG,89.30999755859375,89.5,87.53500366210938,87.93000030517578,15470900.0,0.0,0.0,-1.8799972534179688,1.8799972534179688,0.0,31.73852223498109,86.94000244140625,99.8000030517578,7.698272292247334,-92.30172770775266,-2.135106787270061,-1.494323342817509,-0.08262909019329467,2937147640.0,-1.0
2515,2022-12-28,GOOG,87.5,88.5199966430664,86.37000274658203,86.45999908447266,17879600.0,0.0,0.0,-1.470001220703125,1.470001220703125,0.0,27.59075289810447,86.37000274658203,99.8000030517578,0.6701141909575494,-99.32988580904245,-2.3449737817106637,-1.6644534305961398,-0.09285488092348748,2919268040.0,-1.0
2516,2022-12-29,GOOG,87.02999877929688,89.36499786376953,86.98999786376953,88.94999694824219,18280700.0,0.0,0.0,2.4899978637695312,0.0,2.4899978637695312,42.32275003649473,86.37000274658203,99.8000030517578,19.210678652522862,-80.78932134747714,-2.284043833445054,-1.7883715111659226,-0.024671053457128278,2937548740.0,1.0
2517,2022-12-30,GOOG,87.36499786376953,88.83000183105469,87.02999877929688,88.7300033569336,19190300.0,0.0,0.0,-0.21999359130859375,0.21999359130859375,0.0,41.462776792370335,86.37000274658203,99.8000030517578,17.572602805094842,-82.42739719490515,-2.2278270512507987,-1.8762626191828977,-0.023442628649677832,2918358440.0,-1.0
2531,2013-01-22,IBM,118.71250587227752,119.76306152343751,118.49872927621864,119.7630615234375,7502226.0,0.0,0.0,0.9834060668945455,0.0,0.9834060668945455,68.34325043138986,116.28767678835074,119.92788696289064,95.4720900291431,-4.527909970856889,0.06323225415574996,-0.1312384900565387,0.01664405310936945,1667848.0,1.0
2532,2013-01-23,IBM,124.2950550092851,127.39785125982148,124.20954050105118,125.04020690917967,13106903.0,0.0,0.0,5.277145385742173,0.0,5.277145385742173,88.20440153371524,116.28767678835074,127.39785125982148,78.77941200027162,-21.220587999728377,0.4486064588611356,-0.015269500273003805,0.0644754685280855,14774751.0,1.0
2533,2013-01-24,IBM,124.54552115788604,125.247925804503,124.03856578068591,124.85701751708984,4651771.0,0.0,0.0,-0.18318939208982954,0.18318939208982954,0.0,86.04218737707203,116.28767678835074,127.39785125982148,77.13056847796483,-22.869431522035182,0.7242771546412143,0.13263983070983987,0.05983020836780506,10122980.0,-1.0
2534,2013-01-25,IBM,124.87529302461245,125.32116361794012,124.6798438363048,125.19290161132812,3513409.0,0.0,0.0,0.33588409423828125,0.0,0.33588409423828125,86.73037087947097,116.28767678835074,127.39785125982148,80.1537801755019,-19.846219824498107,0.9463123048149527,0.29537432553086246,0.05410113016006157,13636389.0,1.0
2535,2013-01-28,IBM,125.11967894545076,125.95645817808006,124.7776402186225,125.16854858398438,2953590.0,0.0,0.0,-0.02435302734375,0.02435302734375,0.0,86.37409875210145,116.28767678835074,127.39785125982148,79.9345844517418,-20.065415548258205,1.1032027444721564,0.45694000931912127,0.06390853524687934,10682799.0,-1.0
2536,2013-01-29,IBM,124.808116425351,125.65711018083849,124.38056336895843,124.53936767578124,3783487.0,0.0,0.0,-0.6291809082031392,0.6291809082031392,0.0,76.9509680013847,116.28767678835074,127.39785125982148,74.2714788918896,-25.728521108110403,1.1699948403211238,0.5995509755195219,0.05922044277654259,6899312.0,-1.0
2537,2013-01-30,IBM,124.4111670365773,125.138001741883,124.10577323828451,124.30733489990234,3136326.0,0.0,0.0,-0.23203277587889204,0.23203277587889204,0.0,73.53715131445716,116.28767678835074,127.39785125982148,72.18300785595116,-27.816992144048836,1.1922311304102493,0.7180870064976674,0.05675319655108457,3762986.0,-1.0
2538,2013-01-31,IBM,124.1851571953499,124.88756185342308,123.96527798224214,124.03245544433594,3233604.0,0.0,0.0,-0.27487945556640625,0.27487945556640625,0.0,69.33273881229434,116.28767678835074,127.39785125982148,69.70888419324672,-30.291115806753282,1.17693626693341,0.809856858584816,0.04864478192664157,529382.0,-1.0
2539,2013-02-01,IBM,124.99748622730164,125.4250296144914,124.50274589166806,125.32119750976562,3525752.0,0.0,0.0,1.2887420654296875,0.0,1.2887420654296875,76.57723651388118,116.28767678835074,127.39785125982148,81.30854060493479,-18.69145939506521,1.237515216904086,0.8953885302486702,0.05507291655359259,4055134.0,1.0
2540,2013-02-04,IBM,124.7165096948172,125.22346494685056,124.33781647095532,124.4721908569336,3335485.0,0.0,0.0,-0.8490066528320312,0.8490066528320312,0.0,64.91979096770682,116.28767678835074,127.39785125982148,73.6668365523823,-26.333163447617693,1.2121463341118073,0.9587400910212978,0.039320382040956,719649.0,-1.0
2541,2013-02-05,IBM,124.78975429250534,125.05850296710886,123.69033941744138,123.86135864257812,3804197.0,0.0,0.0,-0.6108322143554688,0.6108322143554688,0.0,57.636017703035776,116.8740112374572,127.39785125982148,66.39541640952419,-33.60458359047582,1.1361428330997256,0.9942206394369834,-0.009427753646135462,-3084548.0,-1.0
2542,2013-02-06,IBM,122.9107036353364,123.46272998129604,122.40161452098896,123.297119140625,3790913.0,0.81262,0.0,-0.564239501953125,0.564239501953125,0.0,51.47990574187059,118.0283774272385,127.39785125982148,56.233058627733136,-43.76694137226686,1.0244629075991725,1.0002690930694214,-0.012493477799526476,-6875461.0,-1.0
2543,2013-02-07,IBM,123.05177410977971,123.2296513355574,121.8618665127062,122.51202392578124,3218228.0,0.0,0.0,-0.7850952148437642,0.7850952148437642,0.0,43.94424555621311,118.37042972318538,127.39785125982148,45.87793076669757,-54.12206923330244,0.8703931894501409,0.9742939123455653,-0.021413975161865828,-10093689.0,-1.0
2544,2013-02-08,IBM,122.65308034973592,123.95340483970044,122.47521293077617,123.70191955566406,3026392.0,0.0,0.0,1.1898956298828267,0.0,1.1898956298828267,55.369162371412926,118.49872927621864,127.39785125982148,58.46858026030669,-41.53141973969331,0.8245227263234227,0.9443396751411368,-0.0117172328425319,-7067297.0,1.0
2545,2013-02-11,IBM,123.27259676185898,123.8675505999423,122.51816036583617,122.76964569091795,3080156.0,0.0,0.0,-0.932273864746108,0.932273864746108,0.0,46.7544908355165,121.8618665127062,127.39785125982148,16.397790450647193,-83.6022095493528,0.7124840517932682,0.8979685504715632,-0.014210141081416716,-10147453.0,-1.0
2546,2013-02-12,IBM,122.677625195004,123.12538240837178,122.0704050132391,122.69602966308594,2575043.0,0.0,0.0,-0.07361602783201704,0.07361602783201704,0.0,46.10097271212425,121.8618665127062,125.95645817808006,20.372315936504364,-79.62768406349564,0.6114753754071529,0.8406699154586812,-0.012962269990856923,-12722496.0,-1.0
2547,2013-02-13,IBM,123.07017810757092,123.25418362892162,122.4077543148642,122.72669982910156,2269611.0,0.0,0.0,0.030670166015625,0.0,0.030670166015625,46.46072078624742,121.8618665127062,125.95645817808006,21.12135683049604,-78.87864316950396,0.5277522990999017,0.7780863921869253,-0.010527531770266219,-10452885.0,1.0
2548,2013-02-14,IBM,122.50594421414068,122.86782713440984,122.21766941153378,122.45687866210938,3445733.0,0.0,0.0,-0.2698211669921875,0.2698211669921875,0.0,43.51263110180643,121.8618665127062,125.95645817808006,14.531660249175237,-85.46833975082477,0.43651353820965255,0.7097718213914709,-0.022855820919146952,-13898618.0,-1.0
2549,2013-02-15,IBM,122.65923995175822,123.43819933363464,122.56109909712318,123.27259826660156,3794679.0,0.0,0.0,0.8157196044921875,0.0,0.8157196044921875,53.749824800801036,121.8618665127062,125.65711018083849,37.171045583737474,-62.828954416262526,0.4202203482403064,0.651861526761238,-0.009637434531146183,-10103939.0,1.0
2550,2013-02-19,IBM,123.03951411218142,123.830749645603,122.806443049382,122.8677749633789,3136222.0,0.0,0.0,-0.40482330322265625,0.40482330322265625,0.0,48.696261539981045,121.8618665127062,125.4250296144914,28.23077198371111,-71.76922801628889,0.3726532069396882,0.5960198627969281,-0.008021740517689335,-13240161.0,-1.0
2551,2013-02-20,IBM,123.0517754800945,123.72647545461946,121.97226531046536,122.24828338623048,3886308.0,0.0,0.0,-0.6194915771484233,0.6194915771484233,0.0,41.763101767617556,121.8618665127062,125.4250296144914,10.844770853477986,-89.155229146522,0.2850347059062983,0.5338228314188022,-0.008506571456858403,-17126469.0,-1.0
2552,2013-02-21,IBM,121.83121471831488,122.10109474733184,121.512269152972,121.64720916748048,4103353.0,0.0,0.0,-0.60107421875,0.60107421875,0.0,36.02144394956048,121.512269152972,125.4250296144914,3.448716471033022,-96.55128352896698,0.16824068623122912,0.4607064023812875,-0.0070590194381627835,-21229822.0,-1.0
2553,2013-02-22,IBM,122.19925087898795,123.34010314941406,121.96004165592694,123.34010314941406,3250863.0,0.0,0.0,1.6928939819335795,0.0,1.6928939819335795,55.778668703977836,121.512269152972,125.22346494685056,49.25188801563614,-50.74811198436387,0.20225100619489922,0.40901532314400985,-0.0029249053494856403,-17978959.0,1.0
2554,2013-02-25,IBM,123.69578992345404,124.19874090687296,121.14422607421876,121.14422607421876,4021661.0,0.0,0.0,-2.1958770751952983,2.1958770751952983,0.0,38.14742622240791,121.14422607421876,125.05850296710886,0.0,-100.0,0.060675516980609245,0.33934736191132975,-0.013239588723676143,-22000620.0,-1.0
2555,2013-02-26,IBM,121.83117240352868,122.6101413650158,121.34661613696514,122.14398956298828,3547614.0,0.0,0.0,0.999763488769517,0.0,0.999763488769517,46.955697319027315,121.14422607421876,124.19874090687296,32.730680436761276,-67.26931956323872,0.02501649073280987,0.2764811876756258,-0.004499249907381042,-18453006.0,1.0
2556,2013-02-27,IBM,121.99066928298647,124.35822790132556,121.81279205595078,124.10062408447266,4377615.0,0.0,0.0,1.956634521484375,0.0,1.956634521484375,59.86305974422272,121.14422607421876,124.35822790132556,91.9849511384753,-8.015048861524704,0.14577102355141847,0.25033915485078434,0.01119499063597651,-14075391.0,1.0
2557,2013-02-28,IBM,124.00862031166264,124.58517947665226,123.15606263171333,123.18059539794922,4904903.0,0.0,0.0,-0.9200286865234375,0.9200286865234375,0.0,52.88164724811382,121.14422607421876,124.58517947665226,59.18038071338903,-40.81961928661097,0.16833163929069883,0.23393765173876724,0.005909972095865523,-18980294.0,-1.0
2558,2013-03-01,IBM,123.07018575038212,124.47476980158132,122.27895021190469,124.45637512207033,3460482.0,0.0,0.0,1.275779724121108,0.0,1.275779724121108,60.29121998876795,121.14422607421876,124.58517947665226,96.25672482252045,-3.74327517747954,0.28183366257803755,0.2435168539066213,0.009602919644060792,-15519812.0,1.0
2559,2013-03-04,IBM,124.2600927158768,125.85482025146486,124.23555016258202,125.85482025146484,3863296.0,0.0,0.0,1.398445129394517,0.0,1.398445129394517,66.8788109887539,121.14422607421876,125.85482025146486,99.9999999999997,-3.0167860317591506e-13,0.47495344398342354,0.2898041719219818,0.02431105543317802,-11656516.0,1.0
2560,2013-03-05,IBM,126.26573336721567,127.3943087097955,126.16146425577844,126.67668151855467,3982959.0,0.0,0.0,0.8218612670898295,0.0,0.8218612670898295,70.2280653374315,121.14422607421876,127.3943087097955,88.51811675007393,-11.481883249926069,0.6840590290704398,0.3686551433516735,0.0362246242618649,-7673557.0,1.0
2561,2013-03-06,IBM,126.98338967878732,127.87889424699844,126.75644694142444,127.8114242553711,3760161.0,0.0,0.0,1.1347427368164205,0.0,1.1347427368164205,74.35880051645037,121.14422607421876,127.87889424699844,98.99816902783644,-1.0018309721635559,0.9276401983294562,0.4804521543472301,0.05067288538780934,-3913396.0,1.0
2562,2013-03-07,IBM,127.756215736037,128.5597175192659,127.72554488930946,128.44931030273438,4063082.0,0.0,0.0,0.6378860473632812,0.0,0.6378860473632812,76.47583579967345,121.14422607421876,128.5597175192659,98.51112745055818,-1.488872549441819,1.1571629256350064,0.6157943086047855,0.04142373018069412,149686.0,1.0
2563,2013-03-08,IBM,128.7131090409916,129.2589974900316,128.45549535180388,129.03819274902344,3870723.0,0.0,0.0,0.5888824462890625,0.0,0.5888824462890625,78.37748086841606,121.14422607421876,129.2589974900316,97.27897768533713,-2.7210223146628807,1.3693684258504106,0.7665091320539106,0.06516172442232993,4020409.0,1.0
2564,2013-03-11,IBM,128.82959321397155,128.92773405394524,128.2162349907585,128.8541259765625,3189986.0,0.0,0.0,-0.1840667724609375,0.1840667724609375,0.0,76.15713539019133,121.14422607421876,129.2589974900316,95.01068492600866,-4.989315073991336,1.50556466556921,0.9143202387569707,0.054936280021489425,830423.0,-1.0
2565,2013-03-12,IBM,128.43704930131108,129.25280770986603,128.24690570701185,129.1424102783203,3756814.0,0.0,0.0,0.2882843017578125,0.0,0.2882843017578125,77.31831161948308,121.14422607421876,129.2589974900316,98.56327177024248,-1.4367282297575212,1.6174730298478295,1.0549507969751424,0.04062659822255066,4587237.0,1.0
2566,2013-03-13,IBM,128.92773103699497,130.25257850278302,128.66398916089918,130.06857299804688,3510271.0,0.0,0.0,0.9261627197265625,0.0,0.9261627197265625,80.78689046564152,121.14422607421876,130.25257850278302,97.97981571113675,-2.020184288863243,1.7589263737184524,1.1957459123238046,0.05591771640529286,8097508.0,1.0
2567,2013-03-14,IBM,130.12382207997618,132.3993785015881,130.12382207997618,132.36257934570312,5758753.0,0.0,0.0,2.29400634765625,0.0,2.29400634765625,86.63017599591673,121.14422607421876,132.3993785015881,99.67304613489291,-0.32695386510708596,2.02898483652163,1.3623936971633699,0.06352590790048462,13856261.0,1.0
2568,2013-03-15,IBM,132.10497666467734,132.42392228810553,130.89666419050616,131.8228302001953,8295094.0,0.0,0.0,-0.5397491455078125,0.5397491455078125,0.0,80.02294859102032,121.34661613696514,132.42392228810553,94.57366186590107,-5.426338134098929,2.1750464529847875,1.5249242483276535,0.047419796371772405,5561167.0,-1.0
2569,2013-03-18,IBM,130.5838224659129,131.5651918518886,130.42433990634015,130.77395629882812,3144276.0,0.0,0.0,-1.0488739013671875,1.0488739013671875,0.0,68.33651243181818,121.81279205595078,132.42392228810553,84.45061031974203,-15.549389680257974,2.1823448031599497,1.656408359294113,0.03234434886639592,2416891.0,-1.0
2570,2013-03-19,IBM,131.33822315248585,131.94544325989418,129.927501267533,130.91500854492188,3345736.0,0.0,0.0,0.14105224609375,0.0,0.14105224609375,69.03812826666217,122.27895021190469,132.42392228810553,85.12648697453366,-14.873513025466334,2.174203677240726,1.7599674228834359,0.024282526445756014,5762627.0,1.0
2571,2013-03-20,IBM,131.7246553654331,132.37481278269513,131.44250899464862,131.90866088867188,3157874.0,0.0,0.0,0.99365234375,0.0,0.99365234375,73.76361907988348,122.27895021190469,132.42392228810553,94.9210170756171,-5.078982924382905,2.221103754880801,1.852194689282909,0.026931640020365855,8920501.0,1.0
2572,2013-03-21,IBM,130.62060638953085,130.6451391528789,128.87253442046503,130.19125366210938,6098598.0,0.0,0.0,-1.7174072265625,1.7174072265625,0.0,56.55100672196896,124.23555016258202,132.42392228810553,72.7336692596465,-27.266330740353496,2.0973196844342823,1.9012196883131838,0.008935811084464174,2821903.0,-1.0
2573,2013-03-22,IBM,130.1605927049882,130.74941822853145,129.79871973368785,130.0808563232422,3170949.0,0.0,0.0,-0.1103973388671875,0.1103973388671875,0.0,55.588894275784625,126.16146425577844,132.42392228810553,62.585522285844775,-37.41447771415522,1.9677103283282946,1.914517816316206,0.0095203031907789,-349046.0,-1.0
2574,2013-03-25,IBM,130.36301523595324,130.5286261014763,128.83575745333687,129.25897216796875,3391655.0,0.0,0.0,-0.8218841552734375,0.8218841552734375,0.0,48.5007313783095,126.75644694142444,132.42392228810553,44.155908468305974,-55.844091531694026,1.7789105558831864,1.887396364229602,0.0009025841270673407,-3740701.0,-1.0
2575,2013-03-26,IBM,129.8907514597317,130.3384989987208,129.7251405732048,130.25262451171875,2406114.0,0.0,0.0,0.99365234375,0.0,0.99365234375,56.27785305610597,127.72554488930946,132.42392228810553,53.786220388699256,-46.213779611300744,1.6891238637169579,1.8477418641270733,0.0014150344655095015,-1334587.0,1.0
2576,2013-03-27,IBM,129.39385885121882,130.12989052306656,128.86637519699923,129.35092163085938,3371676.0,0.0,0.0,-0.901702880859375,0.901702880859375,0.0,48.59402545822247,128.2162349907585,132.42392228810553,26.966990651047322,-73.03300934895267,1.5282904809827755,1.783851587498214,-0.022753090259581166,-4706263.0,-1.0
2577,2013-03-28,IBM,128.70081292578627,130.9150370707537,128.64560930588243,130.82916259765625,3922395.0,0.0,0.0,1.478240966796875,0.0,1.478240966796875,59.14543277655548,128.2162349907585,132.42392228810553,62.098901896659896,-37.901098103340104,1.5016962240511589,1.7274205148088029,-0.007537902205786429,-783868.0,1.0
2578,2013-04-01,IBM,130.52247567491233,130.95182843565107,129.57177717854634,130.26486206054688,2243147.0,0.0,0.0,-0.564300537109375,0.564300537109375,0.0,54.241529915508174,128.24690570701185,132.42392228810553,48.310949079514046,-51.689050920485954,1.4190931669799056,1.6657550452430234,-0.0038929329102649346,-3027015.0,-1.0
2579,2013-04-02,IBM,130.59609576253027,131.69400074091922,129.76806101632363,131.4793243408203,3260173.0,0.0,0.0,1.2144622802734375,0.0,1.2144622802734375,62.0542946827931,128.64560930588243,132.42392228810553,74.99947855750608,-25.000521442493916,1.4343083520442406,1.6194657066032672,0.004310550808273472,233158.0,1.0
2580,2013-04-03,IBM,131.45479889491932,131.80441532538785,130.4182257775626,130.43663024902344,3272725.0,0.0,0.0,-1.042694091796875,1.042694091796875,0.0,53.07673605818083,128.64560930588243,132.42392228810553,47.40266228784463,-52.597337712155365,1.347291457165852,1.5650308567157845,-0.011159469209461537,-3039567.0,-1.0
2581,2013-04-04,IBM,130.50409182297057,130.60223268909272,128.8296275390939,129.6085968017578,3880137.0,0.0,0.0,-0.828033447265625,0.828033447265625,0.0,46.86423075152053,128.64560930588243,132.42392228810553,25.4872346575369,-74.51276534246311,1.1981434883215627,1.4916533830369403,-0.004475391733025025,-6919704.0,-1.0
2582,2013-04-05,IBM,128.25305770300878,128.70694322853367,126.5601892166532,128.4431915283203,4338808.0,0.0,0.0,-1.1654052734375,1.1654052734375,0.0,39.37901360506677,126.5601892166532,132.37481278269513,32.38390740656133,-67.61609259343868,0.9752459019963169,1.3883718868288157,-0.012589591129784639,-11258512.0,-1.0
2583,2013-04-08,IBM,128.2346200740932,128.38795471191406,127.16737653543814,128.38795471191406,2459355.0,0.0,0.0,-0.05523681640625,0.05523681640625,0.0,39.03801686581368,126.5601892166532,132.37481278269513,31.43394365088779,-68.5660563491122,0.7851198133729724,1.267721472137647,-0.00673854542896124,-13717867.0,-1.0
2584,2013-04-09,IBM,128.53521374062873,128.80509377817717,127.95252621469578,128.32667541503906,2695856.0,0.0,0.0,-0.061279296875,0.061279296875,0.0,38.6100415685483,126.5601892166532,132.37481278269513,30.380061208129533,-69.61993879187047,0.6223544017872769,1.138648058067573,-0.014786259423942849,-16413723.0,-1.0
2585,2013-04-10,IBM,129.9458790967866,130.3445608912984,129.0933119070447,130.03175354003906,3686313.0,0.0,0.0,1.705078125,0.0,1.705078125,54.59231977425157,126.5601892166532,131.80441532538785,66.19783837321035,-33.80216162678965,0.6230854083077304,1.0355355281156045,0.005263448459398301,-12727410.0,1.0
2586,2013-04-11,IBM,129.72514299910833,130.7003842844619,129.32646099402876,130.5961151123047,3823758.0,0.0,0.0,0.564361572265625,0.0,0.564361572265625,58.698759921923795,126.5601892166532,131.80441532538785,76.95941807179807,-23.040581928201924,0.6613657592840525,0.960701574349294,-0.0017813114501715743,-8903652.0,1.0
2587,2013-04-12,IBM,129.28963699655253,129.7189897778727,128.67014059100003,129.65151977539062,3311008.0,0.0,0.0,-0.9445953369140625,0.9445953369140625,0.0,49.97121042534717,126.5601892166532,131.80441532538785,58.947316432229776,-41.05268356777022,0.6087816707715206,0.8903175936337394,-0.004708424631587715,-12214660.0,-1.0
2588,2013-04-15,IBM,129.07500788823344,129.84170117320508,128.3512420654297,128.3512420654297,4412133.0,0.0,0.0,-1.3002777099609375,1.3002777099609375,0.0,40.42463285909029,126.5601892166532,131.80441532538785,34.15285328360185,-65.84714671639816,0.4573258343411908,0.8037192417752297,-0.023791438624083727,-16626793.0,-1.0
2589,2013-04-16,IBM,129.32025460465974,130.03175354003906,128.31435278146327,130.03175354003906,2991037.0,0.0,0.0,1.680511474609375,0.0,1.680511474609375,53.633969873274076,126.5601892166532,131.80441532538785,66.19783837321035,-33.80216162678965,0.4670242218595604,0.7363802377920959,-0.003104010799814483,-13635756.0,1.0
2590,2013-04-17,IBM,129.1301394092939,129.47361765249673,128.4983767419379,128.60264587402344,3420211.0,0.0,0.0,-1.429107666015625,1.429107666015625,0.0,44.05025121263164,126.5601892166532,131.80441532538785,38.94676955229626,-61.05323044770374,0.3556790319015306,0.6602399966139829,-0.007761452191886842,-17055967.0,-1.0
2591,2013-04-18,IBM,128.8725335276486,128.9584079883821,126.4436431288659,127.05699157714844,6801092.0,0.0,0.0,-1.545654296875,1.545654296875,0.0,36.01842725128969,126.4436431288659,131.80441532538785,11.44141973950087,-88.55858026049913,0.14147623064127401,0.5564872434194411,-0.010792319426804586,-23857059.0,-1.0
2592,2013-04-19,IBM,120.05864784936156,120.52479996165778,116.39077268053484,116.53797912597656,19713962.0,0.0,0.0,-10.519012451171875,10.519012451171875,0.0,14.81154822412752,116.39077268053484,131.80441532538785,0.9550399528101217,-99.04496004718987,-0.8646489902792922,0.27225999667969436,-0.09229818803895828,-43571021.0,-1.0
2593,2013-04-22,IBM,117.2432941931763,117.3843624941147,115.11494455828964,115.20694732666016,10298288.0,0.0,0.0,-1.3310317993164062,1.3310317993164062,0.0,13.639086519013546,115.11494455828964,131.80441532538785,0.5512623477066462,-99.44873765229335,-1.7489326464385755,-0.13197853194395975,-0.10223695148297562,-53869309.0,-1.0
2594,2013-04-23,IBM,116.09019433739452,118.10200875781914,115.68538405005854,117.52545928955078,6585721.0,0.0,0.0,2.318511962890625,0.0,2.318511962890625,25.4930553466711,115.11494455828964,130.7003842844619,15.466453135827946,-84.53354686417207,-2.2372920415288604,-0.5530412338609401,-0.09617877103101102,-47283588.0,1.0
2595,2013-04-24,IBM,117.86275445923482,118.0713025052538,117.20645905459168,117.58674621582033,3863819.0,0.0,0.0,0.06128692626954546,0.0,0.06128692626954546,25.803679575484026,115.11494455828964,130.7003842844619,15.859685071187638,-84.14031492881236,-2.5895147476265805,-0.9603359366140684,-0.09961528247066997,-43419769.0,1.0
2596,2013-04-25,IBM,118.18786228740215,119.70899166550925,117.96091951897802,118.960693359375,4864841.0,0.0,0.0,1.3739471435546733,0.0,1.3739471435546733,33.026272465415616,115.11494455828964,130.7003842844619,24.675266586333695,-75.3247334136663,-2.726575086722022,-1.3135837666356593,-0.08245816504531922,-38554928.0,1.0
2597,2013-04-26,IBM,119.08948527813187,119.42683525412298,118.5313306385169,119.18148803710938,3650854.0,0.0,0.0,0.220794677734375,0.0,0.220794677734375,34.21371502786515,115.11494455828964,130.7003842844619,26.091939337398905,-73.90806066260109,-2.785295202081116,-1.6079260537247508,-0.07144265907178238,-34904074.0,1.0
2598,2013-04-29,IBM,119.46979293310136,122.475253048937,119.39005653583266,122.1501693725586,6205290.0,0.0,0.0,2.9686813354492188,0.0,2.9686813354492188,48.40543374281721,115.11494455828964,130.7003842844619,45.139726166691766,-54.86027383330823,-2.563163048976122,-1.7989734527750254,-0.06061276536621951,-28698784.0,1.0
2599,2013-04-30,IBM,122.13789573406116,124.26011726660327,121.0461190071258,124.2294464111328,7886735.0,0.0,0.0,2.0792770385742045,0.0,2.0792770385742045,56.06504158045031,115.11494455828964,130.7003842844619,58.480877106966645,-41.51912289303336,-2.194325620894759,-1.8780438863989721,-0.03400551701847987,-20812049.0,1.0
2600,2013-05-01,IBM,123.81848785027104,124.00249338869033,122.18082289496084,122.44456481933594,5124459.0,0.0,0.0,-1.7848815917968608,1.7848815917968608,0.0,48.87784420855226,115.11494455828964,130.03175354003906,49.136650271609845,-50.86334972839015,-2.0225046963225566,-1.9069360483836892,-0.03630203029804824,-25936508.0,-1.0
2601,2013-05-02,IBM,122.7450857527419,124.16194578738455,122.51814301536643,124.13741302490234,4126575.0,0.0,0.0,1.6928482055664062,0.0,1.6928482055664062,55.167373183953046,115.11494455828964,130.03175354003906,60.48524505242114,-39.51475494757886,-1.729989199097048,-1.871546678526361,0.06520993375653839,-21809933.0,1.0
2602,2013-05-03,IBM,125.08814297181456,125.9345822286548,124.97160742581886,125.43775939941406,4699364.0,0.0,0.0,1.3003463745117188,0.0,1.3003463745117188,59.57539456880674,115.11494455828964,130.03175354003906,69.20256774591866,-30.797432254081343,-1.377502794608077,-1.7727379017427043,0.0888037771172363,-17110569.0,1.0
2603,2013-05-06,IBM,124.99613459406086,125.11880822153428,123.6038168226319,124.37664794921876,5048519.0,0.0,0.0,-1.0611114501952983,1.0611114501952983,0.0,54.52745027077216,115.11494455828964,129.47361765249673,64.50250193846742,-35.49749806153259,-1.1701836021451868,-1.652227041823201,0.058295357457727626,-22159088.0,-1.0
2604,2013-05-07,IBM,124.39501133976864,124.9593040104369,123.68352210069249,124.8979721069336,3609746.0,0.0,0.0,0.5213241577148295,0.0,0.5213241577148295,56.61154093969228,115.11494455828964,128.9584079883821,70.66893048872387,-29.331069511276127,-0.9528792217273008,-1.5123574778040212,0.0621772957106419,-18549342.0,1.0
2605,2013-05-08,IBM,125.05818235576876,126.23518621753728,124.79320428258436,126.21670532226562,3767378.0,0.908222,0.0,1.3187332153320312,0.0,1.3187332153320312,61.730868412221106,115.11494455828964,126.23518621753728,99.83380851030084,-0.16619148969916564,-0.6666817547246069,-1.3432223331881386,0.06099503758750413,-14781964.0,1.0
2606,2013-05-09,IBM,126.13659997188726,126.3276348001996,124.92262443829648,125.2430648803711,3705246.0,0.0,0.0,-0.9736404418945312,0.9736404418945312,0.0,56.09274067004115,115.11494455828964,126.3276348001996,90.32729972531762,-9.672700274682384,-0.5124499830505158,-1.177067863160614,0.05086005337820865,-18487210.0,-1.0
2607,2013-05-10,IBM,125.32315467836324,126.03797870151844,124.98422355975886,126.00100708007812,3430043.0,0.0,0.0,0.7579421997070312,0.0,0.7579421997070312,59.421723192080286,115.68538405005854,126.3276348001996,96.93083984027392,-3.0691601597260787,-0.3253663123557686,-1.006727552999645,0.03152543895190574,-15057167.0,1.0
2608,2013-05-13,IBM,125.82231763856494,126.00102859261251,124.61450895017757,124.76856231689452,3816226.0,0.0,0.0,-1.232444763183608,1.232444763183608,0.0,52.02161157536487,117.20645905459168,126.3276348001996,82.90711058762551,-17.092889412374486,-0.2733157124549592,-0.8600451848907077,0.004339678887222309,-18873393.0,-1.0
2609,2013-05-14,IBM,124.53442520611308,125.50807062271755,124.52825834910084,125.22460174560548,3869886.0,0.0,0.0,0.4560394287109659,0.0,0.4560394287109659,54.44388171887913,117.96091951897802,126.3276348001996,86.81641459618221,-13.183585403817782,-0.19306985969964785,-0.7266501198524957,0.02270445348367578,-15003507.0,1.0
2610,2013-05-15,IBM,124.63299438251504,125.51420563791744,124.50358876292324,125.29236602783205,4213393.0,0.0,0.0,0.0677642822265625,0.0,0.0677642822265625,54.83483679855739,118.5313306385169,126.3276348001996,86.72103151829683,-13.278968481703176,-0.12259750137262415,-0.6058395961565215,0.009303826902676171,-10790114.0,1.0
2611,2013-05-16,IBM,125.71139838657017,127.3074336996332,125.71139838657017,126.1365966796875,4714322.0,0.0,0.0,0.8442306518554545,0.0,0.8442306518554545,59.79471969785557,119.39005653583266,127.3074336996332,85.21180694411099,-14.788193055889016,0.0013135856574848503,-0.48440895979372023,0.005571187524549437,-6075792.0,1.0
2612,2013-05-17,IBM,126.48171298554976,129.10069939497689,126.32149273307184,128.44749450683594,5966489.0,0.0,0.0,2.3108978271484375,0.0,2.3108978271484375,70.14854579863272,121.0461190071258,129.10069939497689,91.89026793839948,-8.109732061600528,0.2826099205689019,-0.3310051837211958,0.03272999091661677,-109303.0,1.0
2613,2013-05-20,IBM,128.18866661129957,128.88500995415214,127.81893061298724,127.92985534667967,3780767.0,0.0,0.0,-0.5176391601562642,0.5176391601562642,0.0,65.77085062791555,122.18082289496084,129.10069939497689,83.079986350992,-16.920013649008006,0.458506774632653,-0.17310279205042603,0.02427487963655861,-3890070.0,-1.0
2614,2013-05-21,IBM,127.70803191409952,129.08839500363084,127.56013551752476,128.57691955566406,3120113.0,0.0,0.0,0.6470642089843892,0.0,0.6470642089843892,68.59742410850339,122.51814301536643,129.10069939497689,92.04291146012456,-7.957088539875441,0.6426813457724307,-0.009945964485854634,0.018699697693519868,-769957.0,1.0
2615,2013-05-22,IBM,128.4844542642589,129.50123805491407,127.0178243710762,127.55394744873048,5425393.0,0.0,0.0,-1.0229721069335795,1.0229721069335795,0.0,59.61696828506157,123.6038168226319,129.50123805491407,66.98064239460764,-33.019357605392344,0.698087719623274,0.13166077233597112,0.018451181872358946,-6195350.0,-1.0
2616,2013-05-23,IBM,126.62344671790832,128.55225666871186,126.40777392396816,127.04248809814452,5417339.0,0.0,0.0,-0.5114593505859659,0.5114593505859659,0.0,55.430618297999274,123.6038168226319,129.50123805491407,58.30804923157794,-41.69195076842205,0.6927594361527127,0.2438805050993195,0.008265656300703084,-11612689.0,-1.0
2617,2013-05-24,IBM,126.13660248716744,127.2088485525666,125.97021540715905,126.77131652832033,3447407.0,0.0,0.0,-0.27117156982419033,0.27117156982419033,0.0,53.14749490167294,123.68352210069249,129.50123805491407,53.07571651701568,-46.92428348298432,0.6590668545616722,0.3269177749917901,0.016051753536592717,-15060096.0,-1.0
2618,2013-05-28,IBM,127.83125572803606,128.53992295532618,127.65871160478686,128.040771484375,4196029.0,0.0,0.0,1.2694549560546733,0.0,1.2694549560546733,61.67437175985631,124.50358876292324,129.50123805491407,70.77692960809404,-29.22307039190596,0.7263859302122029,0.4068114060358727,0.022488949451726636,-10864067.0,1.0
2619,2013-05-29,IBM,127.07943112197168,128.43514598655548,126.96851623918876,128.1270294189453,3597612.0,0.0,0.0,0.0862579345703125,0.0,0.0862579345703125,62.21353846488531,124.50358876292324,129.50123805491407,72.50289974986747,-27.49710025013254,0.7777286408514499,0.48099485299898814,0.02262439030390384,-7266455.0,1.0
2620,2013-05-30,IBM,127.5416378995248,130.01889484085817,127.5416378995248,129.01443481445312,4602086.0,0.0,0.0,0.8874053955078125,0.0,0.8874053955078125,67.62072999402588,124.50358876292324,130.01889484085817,81.78777365732097,-18.212226342679028,0.8798571960761734,0.5607673216144253,0.02281525116833172,-2664369.0,1.0
2621,2013-05-31,IBM,128.5399606504388,130.62899131184008,128.18870544433594,128.18870544433594,5176654.0,0.0,0.0,-0.8257293701171875,0.8257293701171875,0.0,58.61519862832419,124.50358876292324,130.62899131184008,60.16121637694387,-39.83878362305614,0.8839950446089659,0.6254128662133335,-0.0020147458967074705,-7841023.0,-1.0
2622,2013-06-03,IBM,128.33042974229758,129.43964777832124,127.76349192667494,128.7617950439453,3474812.0,0.0,0.0,0.573089599609375,0.0,0.573089599609375,62.603542984245784,124.50358876292324,130.62899131184008,69.51716637423367,-30.48283362576632,0.9228658612004068,0.6849034652107482,0.006503092612831773,-4366211.0,1.0
2623,2013-06-04,IBM,128.54611803500464,128.79260547855117,126.37697738719972,127.06099700927734,3763822.0,0.0,0.0,-1.7007980346679688,1.7007980346679688,0.0,47.069903906264756,124.50358876292324,130.62899131184008,41.7508600607209,-58.249139939279104,0.8071625532678155,0.7093552828221618,-0.011790005170643658,-8130033.0,-1.0
2624,2013-06-05,IBM,126.42625247758988,127.1225958675367,124.72544906643218,124.93497467041016,4409308.0,0.0,0.0,-2.1260223388671875,2.1260223388671875,0.0,34.66426199350376,124.72544906643218,130.62899131184008,3.5491505822789726,-96.45084941772103,0.537757856704502,0.6750357975986299,-0.020532275407415423,-12539341.0,-1.0
2625,2013-06-06,IBM,125.0952034946926,125.83467559198466,124.15236280094774,125.58818817138672,3848652.0,0.0,0.0,0.6532135009765625,0.0,0.6532135009765625,40.247277838213705,124.15236280094774,130.62899131184008,22.169333442920458,-77.83066655707954,0.37265422107405755,0.6145594822937155,-0.011447350792077593,-8690689.0,1.0
2626,2013-06-07,IBM,126.23515071808276,127.15950012207033,125.77914778752152,127.15950012207033,3089256.0,0.0,0.0,1.571311950683608,0.0,1.571311950683608,51.70237980073668,124.15236280094774,130.62899131184008,46.43059758738989,-53.56940241261011,0.3643733095281476,0.5645222477406019,0.003062077482355985,-5601433.0,1.0
2627,2013-06-10,IBM,127.54161754604368,127.54777456654956,126.26601272576966,126.3399658203125,2774306.0,0.0,0.0,-0.8195343017578267,0.8195343017578267,0.0,46.35445411249327,124.15236280094774,130.62899131184008,33.77687967876597,-66.22312032123403,0.2883697260997593,0.5092917434124333,-0.013283313153654719,-8375739.0,-1.0
2628,2013-06-11,IBM,125.1999224128133,126.9130492864601,124.79320501751054,125.6990737915039,2943862.0,0.0,0.0,-0.6408920288085938,0.6408920288085938,0.0,42.39733577583459,124.15236280094774,130.62899131184008,23.881422069444287,-76.1185779305557,0.17442050477018256,0.44231749568398315,-0.01894959743039515,-11319601.0,-1.0
2629,2013-06-12,IBM,126.07497423595028,126.4693677792678,123.5607461332252,123.98595428466795,3566651.0,0.0,0.0,-1.7131195068359517,1.7131195068359517,0.0,33.560984759226514,123.5607461332252,130.62899131184008,6.015752717933945,-93.98424728206606,-0.05347970325577478,0.34315805589603154,-0.03897610788294403,-14886252.0,-1.0
2630,2013-06-13,IBM,123.86886845269682,125.95789833635848,123.45599399375271,125.56967163085938,3032877.0,0.0,0.0,1.5837173461914205,0.0,1.5837173461914205,45.645012487309856,123.45599399375271,130.62899131184008,29.467146624700813,-70.53285337529918,-0.10510734945970057,0.2535049748248851,-0.02043108091620316,-11853375.0,1.0
2631,2013-06-14,IBM,125.69293817489084,126.1674419206739,124.36188061489764,124.60221099853516,2933507.0,0.0,0.0,-0.9674606323242188,0.9674606323242188,0.0,40.45822042323979,123.45599399375271,130.62899131184008,15.979610112109647,-84.02038988789036,-0.22152370587288317,0.15849923868533142,-0.032304489417769644,-14786882.0,-1.0
2632,2013-06-17,IBM,125.36632993270864,126.43241918016916,124.81788291985814,125.11984252929688,3368015.0,0.0,0.0,0.5176315307617188,0.0,0.5176315307617188,44.36138737020182,123.45599399375271,130.62899131184008,23.196001082401292,-76.8039989175987,-0.2689213536763049,0.07301512021300414,-0.015277343367915974,-11418867.0,1.0
2633,2013-06-18,IBM,125.107488206366,126.9993161879586,125.01505422314295,126.24752044677734,3428579.0,0.0,0.0,1.1276779174804688,0.0,1.1276779174804688,52.23256164984393,123.45599399375271,130.62899131184008,38.91715456222939,-61.08284543777061,-0.21304538288862318,0.015803019592678665,0.010505831372118246,-7990288.0,1.0
2634,2013-06-19,IBM,125.98251301291536,126.34609186951133,124.43577345312696,124.4419403076172,2977021.0,0.0,0.0,-1.805580139160142,1.805580139160142,0.0,41.40964441712558,123.45599399375271,130.62899131184008,13.745248605883829,-86.25475139411617,-0.3108585145846803,-0.049529287242793145,-0.009127035595141053,-10967309.0,-1.0
2635,2013-06-20,IBM,123.65935580399412,124.29407973080151,121.5703258681136,121.61346435546876,4722481.0,0.0,0.0,-2.8284759521484375,2.8284759521484375,0.0,30.12640222392288,121.5703258681136,129.43964777832124,0.5481855723707041,-99.45181442762929,-0.609559593562139,-0.16153534850666235,-0.04361479685967218,-15689790.0,-1.0
2636,2013-06-21,IBM,122.32212345584226,122.33444733205788,119.26561527994626,120.4487762451172,9324881.0,0.0,0.0,-1.1646881103515625,1.1646881103515625,0.0,26.673266339139204,119.26561527994626,128.79260547855117,12.419042536059276,-87.58095746394072,-0.9295382027468833,-0.3151359193547066,-0.046629659403059076,-25014671.0,-1.0
2637,2013-06-24,IBM,119.54291934356176,120.109847165906,117.90990244365926,119.26561737060548,4556585.0,0.0,0.0,-1.1831588745117188,1.1831588745117188,0.0,23.51407693807539,117.90990244365926,127.54777456654956,14.06653781726723,-85.93346218273277,-1.264014709553436,-0.5049116773944526,-0.05118141468225568,-29571256.0,-1.0
2638,2013-06-25,IBM,120.35633568945298,120.52887978255409,119.02527844681742,120.1529769897461,4023125.0,0.0,0.0,0.8873596191406108,0.0,0.8873596191406108,30.624717552463352,117.90990244365926,127.54777456654956,23.273545420461083,-76.72645457953891,-1.4408831571605845,-0.6921059733476791,-0.030914608973541147,-25548131.0,1.0
2639,2013-06-26,IBM,120.76310595553568,120.9233262432334,119.85723677582207,120.07908630371094,3472929.0,0.0,0.0,-0.07389068603515625,0.07389068603515625,0.0,30.353589028006255,117.90990244365926,127.54777456654956,22.506875297709993,-77.49312470229,-1.5689285896858678,-0.8674704966153169,-0.04372540961394933,-29021060.0,-1.0
2640,2013-06-27,IBM,120.81235412674438,121.33615328556772,120.34401732815472,120.56585693359376,3675853.0,0.0,0.0,0.4867706298828267,0.0,0.4867706298828267,34.74495646146653,117.90990244365926,127.54777456654956,27.557478000009066,-72.44252199999094,-1.61254133987309,-1.0164846652668715,-0.03239392008051001,-25345207.0,1.0
2641,2013-06-28,IBM,118.15026367560772,118.72335850374122,116.10437179164263,117.76820373535156,10518367.0,0.0,0.0,-2.7976531982422017,2.7976531982422017,0.0,24.500425483172492,116.10437179164263,126.9993161879586,15.271596468831353,-84.72840353116865,-1.851493861985702,-1.1834865046106378,-0.058756777864581444,-35863574.0,-1.0
2642,2013-07-01,IBM,118.40911680322536,119.42590108002828,117.77439256987816,117.87299346923828,4646750.0,0.0,0.0,0.10478973388671875,0.0,0.10478973388671875,25.45041390309848,116.10437179164263,126.9993161879586,16.233416282451994,-83.766583717548,-2.0092485890462513,-1.3486389214977605,-0.06633418975598449,-31216824.0,1.0
2643,2013-07-02,IBM,117.56480250235546,119.07457065180576,117.24436207611286,118.00849151611328,3825954.0,0.0,0.0,0.135498046875,0.0,0.135498046875,26.82415148232593,116.10437179164263,126.9993161879586,17.47709446883005,-82.52290553116995,-2.0991395284782044,-1.4987390428938494,-0.05169839666273768,-27390870.0,1.0
2644,2013-07-03,IBM,117.68810055499716,119.68468720284412,117.39846477727622,119.08694458007812,1958740.0,0.0,0.0,1.0784530639648438,0.0,1.0784530639648438,37.41529539212715,116.10437179164263,126.9993161879586,27.37575043929571,-72.62424956070429,-2.0596189325982692,-1.6109150208347336,-0.0207750004391436,-25432130.0,1.0
2645,2013-07-05,IBM,119.85105501652768,120.26392953149532,118.5323115088126,120.12220001220705,2516048.0,0.0,0.0,1.0352554321289205,0.0,1.0352554321289205,46.062231554642125,116.10437179164263,126.9993161879586,36.87791396092858,-63.12208603907143,-1.9226034565620154,-1.6732527079801904,-0.00271132877469471,-22916082.0,1.0
2646,2013-07-08,IBM,120.53504663807333,120.6459615179628,119.92497053895264,120.1529769897461,3083085.0,0.0,0.0,0.03077697753904829,0.0,0.03077697753904829,46.31665665690384,116.10437179164263,126.9993161879586,37.16040257601004,-62.83959742398996,-1.7908900075729264,-1.6967801678987378,0.00744019641791005,-19832997.0,1.0
2647,2013-07-09,IBM,118.2426966014847,118.80963440231795,117.56484388479151,117.88528442382812,5443593.0,0.0,0.0,-2.2676925659179688,2.2676925659179688,0.0,33.059086205184116,116.10437179164263,126.34609186951133,17.3888040157811,-82.6111959842189,-1.8481775873369202,-1.7270596517863743,-0.018873378111234795,-25276590.0,-1.0
2648,2013-07-10,IBM,118.01464447536328,119.19781513800736,117.86674814253276,118.4706573486328,4071032.0,0.0,0.0,0.5853729248046733,0.0,0.5853729248046733,38.31783819075457,116.10437179164263,124.29407973080151,28.89340590127555,-71.10659409872446,-1.8253044079978054,-1.7467086030286607,-0.013394746783882194,-21205558.0,1.0
2649,2013-07-11,IBM,119.4135177670584,119.6168666528149,118.6925168761628,118.80960845947266,4369665.0,0.0,0.0,0.33895111083985796,0.0,0.33895111083985796,41.393840467393424,116.10437179164263,122.33444733205788,43.42221294558676,-56.57778705441324,-1.7595446599223123,-1.749275814407391,-0.014566714978755835,-16835893.0,1.0
2650,2013-07-12,IBM,118.97598200555544,119.36420870293628,118.06395613418512,118.35974884033205,4701456.0,0.0,0.0,-0.4498596191406108,0.4498596191406108,0.0,38.4569373674466,116.10437179164263,121.33615328556772,43.109159878107604,-56.890840121892396,-1.7238566546503478,-1.7441919824559824,0.0050229610898184784,-21537349.0,-1.0
2651,2013-07-15,IBM,118.57544218244352,120.0975345010585,118.11942920541358,119.54908752441406,5935736.0,0.0,0.0,1.189338684082017,0.0,1.189338684082017,49.40708634247047,116.10437179164263,121.33615328556772,65.84211777138019,-34.157882228619805,-1.581377694267573,-1.7116291248183007,0.014219491724482225,-15601613.0,1.0
2652,2013-07-16,IBM,119.57373373000584,119.9064980640337,118.73565112123588,119.4566421508789,3917584.0,0.0,0.0,-0.09244537353515625,0.09244537353515625,0.0,48.631049906827414,116.10437179164263,121.33615328556772,64.07512169857976,-35.924878301420236,-1.4591017877789199,-1.6611236574104244,0.012271579919042486,-19519197.0,-1.0
2653,2013-07-17,IBM,119.99275071346268,120.09750856803866,118.95131935192134,119.88799285888672,7184346.0,0.0,0.0,0.4313507080078125,0.0,0.4313507080078125,52.6363177878177,116.10437179164263,121.33615328556772,72.31993674883898,-27.68006325116101,-1.3122647634702247,-1.5913518786223848,0.006726583519572449,-12334851.0,1.0
2654,2013-07-18,IBM,122.18040239078552,123.8257432517891,120.77539188581066,122.0078582763672,8779496.0,0.0,0.0,2.119865417480483,0.0,2.119865417480483,67.15728655069474,116.10437179164263,123.8257432517891,76.45644967600846,-23.543550323991532,-1.0131649697763834,-1.4757144968531848,0.015697833239555425,-3555355.0,1.0
2655,2013-07-19,IBM,121.95854665660649,122.00785199782908,119.08073955313866,119.26561737060548,7319490.0,0.0,0.0,-2.7422409057617188,2.7422409057617188,0.0,46.07356833231513,117.24436207611286,123.8257432517891,30.7117190227921,-69.28828097720789,-0.9860308140065683,-1.3777777602838617,-0.0073852487168615255,-10874845.0,-1.0
2656,2013-07-22,IBM,119.17935484548696,120.65215169479556,119.10541157793456,119.60455322265624,3554308.0,0.0,0.0,0.33893585205075283,0.0,0.33893585205075283,48.38453519192061,117.24436207611286,123.8257432517891,35.86163881931455,-64.13836118068545,-0.9264979586053101,-1.2875217999481514,0.01458425287966314,-7320537.0,1.0
2657,2013-07-23,IBM,119.67848319259193,121.04651206185731,119.6106969593563,120.1529769897461,2995535.0,0.0,0.0,0.548423767089858,0.0,0.548423767089858,52.208300041547545,117.39846477727622,123.8257432517891,42.85658733152426,-57.14341266847573,-0.8255489507430411,-1.1951272301071294,0.014200306462068601,-4325002.0,1.0
2658,2013-07-24,IBM,120.75076302532231,121.58266911716792,120.69530065209968,121.157470703125,3093963.0,0.0,0.0,1.0044937133789062,0.0,1.0044937133789062,58.677837573177214,117.56484388479151,123.8257432517891,57.38196076542796,-42.618039234572045,-0.6569207624787055,-1.0874859365814447,0.01976155189883677,-1231039.0,1.0
2659,2013-07-25,IBM,120.96640283300596,121.9092432496439,120.57201914176191,121.53334045410156,3152958.0,0.0,0.0,0.3758697509765625,0.0,0.3758697509765625,60.959613164800466,117.56484388479151,123.8257432517891,63.38540737819168,-36.61459262180831,-0.4873349801844853,-0.9674557453020528,0.02681309858177139,1921919.0,1.0
2660,2013-07-26,IBM,121.14512752181844,121.6257882324993,120.1653153671627,121.61346435546876,2599415.0,0.0,0.0,0.08012390136720171,0.0,0.08012390136720171,61.48275294675858,117.56484388479151,123.8257432517891,64.66515804451848,-35.33484195548152,-0.3425234126541028,-0.8424692787724628,0.01726802666421956,4521334.0,1.0
2661,2013-07-29,IBM,121.29303248124252,121.51487211901711,120.49193123997712,120.91097259521484,2210930.0,0.0,0.0,-0.7024917602539205,0.7024917602539205,0.0,54.14312557521588,117.86674814253276,123.8257432517891,51.08620491990956,-48.913795080090445,-0.281202096028764,-0.730215842223723,0.012174546497791594,2310404.0,-1.0
2662,2013-07-30,IBM,121.39163673213204,121.90926912506886,120.6644787379728,120.78772735595705,2785707.0,0.0,0.0,-0.12324523925779829,0.12324523925779829,0.0,52.86559686006225,118.06395613418512,123.8257432517891,47.273027728671,-52.726972271329,-0.23978514757101266,-0.632129703293181,0.00750479239509283,-475303.0,-1.0
2663,2013-07-31,IBM,119.85109617470428,121.342374492067,119.85109617470428,120.19001770019533,3985260.0,0.0,0.0,-0.5977096557617188,0.5977096557617188,0.0,46.699534341360824,118.06395613418512,123.8257432517891,36.899342558395674,-63.100657441604326,-0.2522833353842202,-0.5561604297113888,-0.01489937289165566,-4460563.0,-1.0
2664,2013-08-01,IBM,121.18209919988333,121.50253967379476,120.4179696462107,120.66446685791016,3010074.0,0.0,0.0,0.47444915771482954,0.0,0.47444915771482954,51.84391686822185,118.11942920541358,123.8257432517891,44.60037831449365,-55.399621685506354,-0.22135296539656224,-0.48919893684842347,0.011728857973861029,-1450489.0,1.0
2665,2013-08-02,IBM,120.47342411760071,120.47342411760071,119.06841370815684,120.26390838623048,4052204.0,0.0,0.0,-0.4005584716796733,0.4005584716796733,0.0,47.388396691998715,118.73565112123588,123.8257432517891,30.024157241108814,-69.97584275889119,-0.2265502745341479,-0.4366692043855684,0.005512793165547647,-5502693.0,-1.0
2666,2013-08-05,IBM,120.26391869890584,120.70760778764452,119.7647672446378,120.4734344482422,2605481.0,0.0,0.0,0.20952606201171875,0.0,0.20952606201171875,49.98281437785168,118.95131935192134,123.8257432517891,31.226563950709185,-68.77343604929081,-0.21132629899872768,-0.3916006233082003,0.0026670788067402196,-2897212.0,1.0
2667,2013-08-06,IBM,118.4768110356423,118.6308643709922,117.25050202982628,117.6941909790039,6211671.0,0.0,0.0,-2.7792434692382955,2.7792434692382955,0.0,28.484528200282796,117.25050202982628,123.8257432517891,6.747873335743232,-93.25212666425678,-0.41869444011538803,-0.3970193866696379,-0.028584945724124955,-9108883.0,-1.0
2668,2013-08-07,IBM,117.4217336379918,117.62610895275031,116.46180425406142,116.77764892578124,4081178.0,0.908222,0.0,-0.9165420532226705,0.9165420532226705,0.0,24.478280878487283,116.46180425406142,122.00785199782908,5.694950464044323,-94.30504953595567,-0.6495047426665508,-0.4475164578690205,-0.03913075630564411,-13190061.0,-1.0
2669,2013-08-08,IBM,117.32880702696472,117.58892189483424,115.68143922288849,116.387451171875,4756790.0,0.0,0.0,-0.3901977539062358,0.3901977539062358,0.0,22.896391724697324,115.68143922288849,121.90926912506886,11.33640385295909,-88.66359614704092,-0.8540638804944507,-0.5288259423941065,-0.04297232392227923,-17946851.0,-1.0
2670,2013-08-09,IBM,116.4308227962593,117.1492203341005,115.81150912037523,116.31934356689452,3399082.0,0.0,0.0,-0.06810760498048296,0.06810760498048296,0.0,22.602217288131982,115.68143922288849,121.90926912506886,10.242802934979006,-89.757197065021,-1.0100311097587422,-0.6250669758670337,-0.037975288179114775,-21345933.0,-1.0
2671,2013-08-12,IBM,115.79290792069688,117.39693147528376,115.74336599743384,117.1058578491211,3165719.0,0.0,0.0,0.7865142822265767,0.0,0.7865142822265767,33.915672682235524,115.68143922288849,121.90926912506886,22.87182933069377,-77.12817066930623,-1.0579758429051367,-0.7116487492746544,-0.030482149034774197,-18180214.0,1.0
2672,2013-08-13,IBM,117.38453674905288,117.66322487244982,116.15829516758146,116.69091033935548,3705873.0,0.0,0.0,-0.4149475097656108,0.4149475097656108,0.0,31.144388787462375,115.68143922288849,121.90926912506886,16.20903480542363,-83.79096519457637,-1.1165836835550635,-0.7926357361307363,-0.0291131279268807,-21886087.0,-1.0
2673,2013-08-14,IBM,116.78999703528002,117.00675776477856,115.99727688280636,116.13972473144533,3025346.0,0.0,0.0,-0.5511856079101562,0.5511856079101562,0.0,27.678066466083564,115.68143922288849,121.90926912506886,7.358670929602533,-92.64132907039748,-1.1937458647818602,-0.8728577618609612,-0.03749854654223095,-24911433.0,-1.0
2674,2013-08-15,IBM,115.33466250976451,115.81153831195554,114.85159890697298,115.06217193603516,3862250.0,0.0,0.0,-1.0775527954101705,1.0775527954101705,0.0,22.12369021031624,114.85159890697298,121.90926912506886,2.9836053903774844,-97.01639460962251,-1.3265547840405532,-0.9635971662968795,-0.0432526808748791,-28773683.0,-1.0
2675,2013-08-16,IBM,114.90731736025512,115.47708914377876,114.78346252441406,114.78346252441406,3584014.0,0.0,0.0,-0.27870941162109375,0.27870941162109375,0.0,20.873555096838203,114.78346252441406,121.90926912506886,0.0,-100.0,-1.4377230253922306,-1.0584223381159499,-0.04723009640994891,-32357697.0,-1.0
2676,2013-08-19,IBM,114.75869687421164,115.50187541102238,113.94120542605236,114.09603881835938,3398349.0,0.0,0.0,-0.6874237060546875,0.6874237060546875,0.0,17.981846946341307,113.94120542605236,121.50253967379476,2.0476993508551846,-97.95230064914482,-1.5632732970759804,-1.159392529907956,-0.030572045491067845,-35756046.0,-1.0
2677,2013-08-20,IBM,114.18269462522238,114.96302932664553,113.43951636561432,114.30036163330078,3261219.0,0.0,0.0,0.20432281494140625,0.0,0.20432281494140625,21.701903200985328,113.43951636561432,121.50253967379476,10.676457636096336,-89.32354236390367,-1.627524608836083,-1.2530189456935814,-0.02121371097353497,-32494827.0,1.0
2678,2013-08-21,IBM,114.36854436142694,115.5452446892592,114.12701254090342,114.48622131347656,3714346.0,0.0,0.0,0.18585968017578125,0.0,0.18585968017578125,25.259930285207375,113.43951636561432,120.70760778764452,14.401372892608203,-85.5986271073918,-1.6444902964545207,-1.3313132158457694,-0.01633535092705829,-28780481.0,1.0
2679,2013-08-22,IBM,114.97546823100208,115.34706247579932,114.10843476247364,114.69058227539062,2462598.0,0.0,0.0,0.2043609619140625,0.0,0.2043609619140625,29.334006706947903,113.43951636561432,120.70760778764452,17.2131284147612,-82.7868715852388,-1.622739619462223,-1.3895984965690602,-0.014002497276536019,-26317883.0,1.0
2680,2013-08-23,IBM,114.78347350281967,115.03119308285852,114.30659774289816,114.83301544189452,2398164.0,0.0,0.0,0.14243316650389204,0.0,0.14243316650389204,32.3016706623508,113.43951636561432,118.6308643709922,26.84272129005077,-73.15727870994922,-1.5758435700053326,-1.4268475112563148,-0.01940844334324332,-23919719.0,1.0
2681,2013-08-26,IBM,114.740089949472,115.81149835762338,114.37469353080508,114.41184997558594,2270238.0,0.0,0.0,-0.42116546630857954,0.42116546630857954,0.0,28.253441075805412,113.43951636561432,117.66322487244982,23.02085024092039,-76.97914975907962,-1.5547404543543877,-1.4524260998759295,-0.019530744572492265,-26189957.0,-1.0
2682,2013-08-27,IBM,113.72441394303932,114.26321700136144,113.0679438644771,113.17322540283205,3337472.0,0.0,0.0,-1.238624572753892,1.238624572753892,0.0,19.823080654656906,113.0679438644771,117.66322487244982,2.2910794393701517,-97.70892056062985,-1.6192962046486485,-1.4858001208304734,-0.025542503527305915,-29527429.0,-1.0
2683,2013-08-28,IBM,113.13606052384472,113.625321618156,112.15754821988378,112.81401824951172,4162243.0,0.0,0.0,-0.3592071533203267,0.3592071533203267,0.0,18.02351582477644,112.15754821988378,117.66322487244982,11.92351224116981,-88.0764877588302,-1.6800751704588777,-1.5246551307561544,-0.01953859942582359,-33689672.0,-1.0
2684,2013-08-29,IBM,112.69018437374324,113.76779070476488,112.36814201133808,113.11132049560548,3118021.0,0.0,0.0,0.2973022460937642,0.0,0.2973022460937642,24.56353190159969,112.15754821988378,117.66322487244982,17.323434264472798,-82.67656573552719,-1.6848314926191676,-1.5566904031287572,-0.01456779567398847,-30571651.0,1.0
2685,2013-08-30,IBM,113.17942006932026,113.32805573264253,112.411470789599,112.88214874267578,2856626.0,0.0,0.0,-0.2291717529297017,0.2291717529297017,0.0,22.936040238158924,112.15754821988378,117.66322487244982,13.16097127596999,-86.83902872403002,-1.6876390559792327,-1.5828801336988525,-0.010639195613233343,-33428277.0,-1.0
2686,2013-09-03,IBM,113.7244424197492,114.151766363445,113.03081572184676,113.92881774902344,3647611.0,0.0,0.0,1.0466690063476562,0.0,1.0466690063476562,42.88003246458099,112.15754821988378,117.00675776477856,36.526974401517506,-63.473025598482494,-1.5871115640235587,-1.583726419763794,-0.0032505923775580925,-29780666.0,1.0
2687,2013-09-04,IBM,113.6934548281098,114.07122685142892,112.90692236519898,113.41475677490234,2717403.0,0.0,0.0,-0.5140609741210938,0.5140609741210938,0.0,37.39556953813243,112.15754821988378,115.81153831195554,34.406457689811184,-65.59354231018881,-1.5312715971713686,-1.5732354552453092,-0.009358895125383015,-32498069.0,-1.0
2688,2013-09-05,IBM,113.5509988613852,114.5728652911666,113.37759224323592,114.04644775390624,2999510.0,0.0,0.0,0.631690979003892,0.0,0.631690979003892,47.00601512001592,112.15754821988378,115.81149835762338,51.6947266059565,-48.3052733940435,-1.4196807296817582,-1.542524510132599,-0.005616280855020195,-29498559.0,1.0
2689,2013-09-06,IBM,114.35613540440052,114.56670840692122,113.11750789654424,113.35285186767578,3037061.0,0.0,0.0,-0.6935958862304545,0.6935958862304545,0.0,39.35250621822907,112.15754821988378,115.81149835762338,32.7126425576086,-67.2873574423914,-1.3714027818606098,-1.5083001644782015,-0.01288970396294864,-32535620.0,-1.0
2690,2013-09-09,IBM,113.75538011153937,114.8763403326889,113.52623387466336,114.56048583984376,3155991.0,0.0,0.0,1.207633972167983,0.0,1.207633972167983,54.30082200682381,112.15754821988378,115.81149835762338,65.76273702099522,-34.23726297900478,-1.2216143280927128,-1.450962997201104,0.0012991299790148236,-29379629.0,1.0
2691,2013-09-10,IBM,115.935406496883,116.21409476415138,115.42137422183308,115.56381225585938,3294482.0,0.0,0.0,1.0033264160156108,0.0,1.0033264160156108,63.03504732819874,112.15754821988378,116.21409476415138,83.9695538755512,-16.03044612444881,-1.010299848771055,-1.3628303675150943,0.0211232545906348,-26085147.0,1.0
2692,2013-09-11,IBM,115.70625219286576,118.20827839423298,115.70005450784328,118.10299682617188,5191193.0,0.0,0.0,2.5391845703125,0.0,2.5391845703125,76.27569897054644,112.15754821988378,118.20827839423298,98.26001879066727,-1.7399812093327354,-0.6306709154042096,-1.2163984770929175,0.04688228164129815,-20893954.0,1.0
2693,2013-09-12,IBM,118.26401243122912,118.48697094549368,117.57658337135464,118.12157440185548,3509121.0,0.0,0.0,0.01857757568360796,0.0,0.01857757568360796,76.34722169378719,112.15754821988378,118.48697094549368,94.22701627812371,-5.772983721876288,-0.32457173971489794,-1.0380331296173135,0.04429489359948424,-17384833.0,1.0
2694,2013-09-13,IBM,118.4188011767454,119.5893032812552,118.28874868224266,119.01334381103516,3881078.0,0.0,0.0,0.8917694091796733,0.0,0.8917694091796733,79.73161748157247,112.15754821988378,119.5893032812552,92.25002081656662,-7.749979183433381,-0.009913407525985463,-0.8324091851990478,0.054315010270897135,-13503755.0,1.0
2695,2013-09-16,IBM,119.96090828149384,120.6483470859814,119.2858549603126,119.62029266357422,4081910.0,0.0,0.0,0.6069488525390625,0.0,0.6069488525390625,81.77908320752024,112.15754821988378,120.6483470859814,87.89213549137249,-12.107864508627506,0.28514426755278066,-0.6088984946486822,0.049956411617372076,-9421845.0,1.0
2696,2013-09-17,IBM,119.78748349615935,120.23958816471978,118.8027734720659,119.00714874267578,3065721.0,0.0,0.0,-0.6131439208984375,0.6131439208984375,0.0,73.16411088386089,112.15754821988378,120.6483470859814,80.67086066708451,-19.329139332915492,0.4641535814356388,-0.39428807943181793,0.049309209196408466,-12487566.0,-1.0
2697,2013-09-18,IBM,119.27964373485852,120.69786531454004,118.90805953931924,120.40679168701172,4018523.0,0.0,0.0,1.3996429443359375,0.0,1.3996429443359375,78.99292256813825,112.36814201133808,120.69786531454004,96.505602684108,-3.4943973158920025,0.7107658707121516,-0.173277289403024,0.055769768005664355,-8469043.0,1.0
2698,2013-09-19,IBM,120.25817217026588,120.69788151195031,119.6636294698874,119.7689208984375,3324293.0,0.0,0.0,-0.6378707885742188,0.6378707885742188,0.0,70.89551232729356,112.411470789599,120.69788151195031,88.78934867412394,-11.210651325876055,0.8449964908338785,0.030377466644356553,0.05660262556297768,-11793336.0,-1.0
2699,2013-09-20,IBM,120.12191964194692,120.4130031875395,117.68183135986328,117.68183135986328,8918091.0,0.0,0.0,-2.0870895385742188,2.0870895385742188,0.0,51.11417693636297,112.90692236519898,120.69788151195031,61.28781969875092,-38.71218030124907,0.7740419937107959,0.17911037205764446,0.027246266434162836,-20711427.0,-1.0
2700,2013-09-23,IBM,117.70661791531596,119.16200618206472,117.25452304000412,118.28257751464844,3494477.0,0.0,0.0,0.6007461547851562,0.0,0.6007461547851562,55.260173885770726,112.90692236519898,120.69788151195031,68.99863095407184,-31.001369045928158,0.7575526077547607,0.2947988191970678,0.023526095286383386,-17216950.0,1.0
2701,2013-09-24,IBM,118.24547535255054,118.6356429873206,117.45894239586512,117.65093231201172,3227224.0,0.0,0.0,-0.6316452026367188,0.6316452026367188,0.0,50.10485035739623,113.11750789654424,120.69788151195031,59.80476221190355,-40.19523778809644,0.6856128758416276,0.3729616305259798,-0.003827714167368046,-20444174.0,-1.0
2702,2013-09-25,IBM,117.7561401362622,118.05341147027684,116.74047131559736,117.34120178222656,2776607.0,0.0,0.0,-0.30973052978515625,0.30973052978515625,0.0,47.59271586538265,113.11750789654424,120.69788151195031,55.71880886053218,-44.28119113946782,0.5967287520539912,0.41771505483158217,-0.006606520642656322,-23220781.0,-1.0
2703,2013-09-26,IBM,117.7314023009078,118.75946677738344,117.33504700046626,117.80572509765624,2189906.0,0.0,0.0,0.4645233154296733,0.0,0.4645233154296733,51.77671261472278,113.52623387466336,120.69788151195031,59.672357586879635,-40.32764241312037,0.5573458358476415,0.44564121103479404,-0.010146918611885547,-21030875.0,1.0
2704,2013-09-27,IBM,116.9696523842995,117.01300652605649,115.47090978611934,115.76199340820312,4085153.0,0.0,0.0,-2.043731689453111,2.043731689453111,0.0,36.84419525822438,115.42137422183308,120.69788151195031,6.455391182876209,-93.54460881712379,0.3571061126102393,0.4279341913498831,-0.03225455455306703,-25116028.0,-1.0
2705,2013-09-30,IBM,114.91971367257366,115.65050669621604,114.16415956409354,114.68437957763672,4161197.0,0.0,0.0,-1.0776138305664062,1.0776138305664062,0.0,31.34440885187587,114.16415956409354,120.69788151195031,7.962077628874704,-92.03792237112529,0.11019009898755883,0.36438537287741823,-0.03632360921767819,-29277225.0,-1.0
2706,2013-10-01,IBM,114.7834665618477,115.59476024613,114.35613276684197,115.42755126953124,2804535.0,0.0,0.0,0.743171691894517,0.0,0.743171691894517,38.63362946699997,114.16415956409354,120.69788151195031,19.336477975652482,-80.66352202434751,-0.025234019859851742,0.28646149432996426,-0.04135348469730549,-26472690.0,1.0
2707,2013-10-02,IBM,114.90730973133262,115.38418541398288,114.20748547430672,114.54811096191406,3783487.0,0.0,0.0,-0.8794403076171733,0.8794403076171733,0.0,33.74212230133446,114.16415956409354,120.69788151195031,5.876457567137064,-94.12354243286293,-0.20120272301433317,0.18892865086110475,-0.04359069028392282,-30256177.0,-1.0
2708,2013-10-03,IBM,114.38707931834472,114.54810046415449,113.33424418743674,113.86685943603516,3359543.0,0.0,0.0,-0.6812515258789062,0.6812515258789062,0.0,30.31177862972619,113.33424418743674,120.69788151195031,7.23304564206795,-92.76695435793205,-0.39112186144834027,0.07291854839921573,-0.03241767977048382,-33615720.0,-1.0
2709,2013-10-04,IBM,114.05887770520624,114.65342056190202,113.69349104733298,114.01553344726562,2995326.0,0.0,0.0,0.14867401123046875,0.0,0.14867401123046875,32.05126914128529,113.33424418743674,120.69788151195031,9.25207516074797,-90.74792483925202,-0.5236016462205981,-0.04638549052474708,-0.03607500070629055,-30620394.0,1.0
2710,2013-10-07,IBM,112.62208236767847,113.52628221861109,112.62208236767847,112.72117614746094,4148854.0,0.0,0.0,-1.2943572998046875,1.2943572998046875,0.0,25.625772802790763,112.62208236767847,120.69788151195031,1.2270461165784614,-98.77295388342155,-0.7246829181131744,-0.18204497604243258,-0.04190154780479771,-34769248.0,-1.0
2711,2013-10-08,IBM,112.6468218048184,112.7087591065923,110.67741132474625,110.68360900878906,5834902.0,0.0,0.0,-2.037567138671875,2.037567138671875,0.0,18.785310146660706,110.67741132474625,120.69788151195031,0.061850231845723164,-99.93814976815428,-1.0365076481533748,-0.35293751046462113,-0.05673704267826851,-40604150.0,-1.0
2712,2013-10-09,IBM,111.08618708825578,112.51060696634038,110.91896819719408,112.2938461303711,4626981.0,0.0,0.0,1.6102371215820312,0.0,1.6102371215820312,34.68378099325825,110.67741132474625,120.4130031875395,16.603354253195597,-83.3966457468044,-1.140550790519697,-0.5104601664756364,-0.04678787013717722,-35977169.0,1.0
2713,2013-10-10,IBM,113.43953500619968,114.4304428100586,112.93789824761303,114.4304428100586,3827209.0,0.0,0.0,2.1365966796875,0.0,2.1365966796875,49.7455480699072,110.67741132474625,119.16200618206472,44.23347901019852,-55.766520989801485,-1.0386276260873188,-0.6160936583979729,-0.011502485046617883,-32149960.0,1.0
2714,2013-10-11,IBM,114.72770103246292,115.33461926636278,114.0278768623998,115.29127502441406,3381300.0,0.0,0.0,0.8608322143554688,0.0,0.8608322143554688,54.61126498433742,110.67741132474625,118.75946677738344,57.087751088892915,-42.91224891110709,-0.8782667230274228,-0.6685282713238629,0.005291875397612555,-28768660.0,1.0
2715,2013-10-14,IBM,114.82683386512964,115.80534660711164,114.21371768674412,115.79296112060548,2785603.0,0.0,0.0,0.5016860961914205,0.0,0.5016860961914205,57.38578733102059,110.67741132474625,118.75946677738344,63.29515833982583,-36.70484166017417,-0.7025985669526165,-0.6753423304496137,0.0031657073814290726,-25983057.0,1.0
2716,2013-10-15,IBM,115.03117556057354,115.1550402740574,114.0898195535572,114.36231994628906,3519895.0,0.0,0.0,-1.4306411743164205,1.4306411743164205,0.0,47.77631834412843,110.67741132474625,118.75946677738344,45.59370624387913,-54.406293756120874,-0.6710851977965433,-0.6744909039189997,-0.001621947442562166,-29502952.0,-1.0
2717,2013-10-16,IBM,114.8329708032217,115.6442642211914,114.56666815721653,115.6442642211914,7027028.0,0.0,0.0,1.2819442749023438,0.0,1.2819442749023438,55.48360279493793,110.67741132474625,117.01300652605649,78.3959949874636,-21.604005012536398,-0.5364842001307295,-0.6468895631613457,0.015609500375785013,-22475924.0,1.0
2718,2013-10-17,IBM,107.66137196948424,109.61840718906564,106.87484915524853,108.27449798583984,23397869.0,0.0,0.0,-7.3697662353515625,7.3697662353515625,0.0,28.036702402702815,106.87484915524853,115.80534660711164,15.672686075279232,-84.32731392472077,-1.0128152736059377,-0.7200747052502642,-0.050353099159783477,-45873793.0,-1.0
2719,2013-10-18,IBM,108.25592114103809,108.37978588856998,107.295991588164,107.6242218017578,11033208.0,0.0,0.0,-0.6502761840820455,0.6502761840820455,0.0,26.692366567740862,106.87484915524853,115.80534660711164,8.3911635443436,-91.6088364556564,-1.4263409541762684,-0.8613279550354651,-0.04521736305372959,-56907001.0,-1.0
2720,2013-10-21,IBM,108.020555053054,108.2249204586431,106.91198022344231,107.05442810058594,7425240.0,0.0,0.0,-0.5697937011718608,0.5697937011718608,0.0,25.45819332665627,106.87484915524853,115.80534660711164,2.0108504179680016,-97.989149582032,-1.7795273335918438,-1.044967830746741,-0.03278878363927351,-64332241.0,-1.0
2721,2013-10-22,IBM,107.35786941527904,108.73274671982776,107.11014003467773,108.36115264892578,7298256.0,0.0,0.0,1.3067245483398438,0.0,1.3067245483398438,33.58415985268688,106.87484915524853,115.80534660711164,16.643008989014113,-83.3569910109859,-1.9317206739612942,-1.2223183993896516,-0.0350214514594106,-57033985.0,1.0
2722,2013-10-23,IBM,108.4355174051935,108.992893900381,108.00819344861674,108.8566436767578,5658232.0,0.0,0.0,0.49549102783201704,0.0,0.49549102783201704,36.607670334017385,106.87484915524853,115.80534660711164,22.191311650795235,-77.80868834920476,-1.9894202144242428,-1.37573876239657,-0.04870905850248841,-51375753.0,1.0
2723,2013-10-24,IBM,109.26537820831844,110.1695778140194,109.15389897188122,110.11383819580078,5787832.0,0.0,0.0,1.257194519042983,0.0,1.257194519042983,44.062798797111554,106.87484915524853,115.80534660711164,36.26885353263858,-63.73114646736142,-1.9116659418066888,-1.482924198278594,-0.044907447051105165,-45587921.0,1.0
2724,2013-10-25,IBM,110.50398688919668,110.91892522872058,109.16007813453164,109.52547454833984,5065569.0,0.0,0.0,-0.5883636474609375,0.5883636474609375,0.0,41.43166994602803,106.87484915524853,115.80534660711164,29.680601863206768,-70.31939813679323,-1.87589697154705,-1.5615187529322854,-0.05412666289566315,-50653490.0,-1.0
2725,2013-10-28,IBM,109.64319231193876,110.16961011263426,109.12297219715728,109.8351821899414,3883484.0,0.0,0.0,0.3097076416015625,0.0,0.3097076416015625,43.48148544523396,106.87484915524853,115.80534660711164,33.148579355736594,-66.8514206442634,-1.8017890858292844,-1.6095728195116854,-0.039585920943837616,-46770006.0,1.0
2726,2013-10-29,IBM,110.00236427021126,112.91314084899462,109.92805136544108,112.78927612304688,9314212.0,0.0,0.0,2.9540939331054688,0.0,2.9540939331054688,59.19793286266558,106.87484915524853,115.80534660711164,66.22729584413527,-33.77270415586474,-1.4875399485365932,-1.5851662453166673,-0.02468767575609132,-37455794.0,1.0
2727,2013-10-30,IBM,112.52294760513271,112.8264067237428,111.38960193208791,111.56920623779295,5516290.0,0.0,0.0,-1.2200698852539205,1.2200698852539205,0.0,52.27111564102063,106.87484915524853,115.80534660711164,52.56546018682388,-47.43453981317612,-1.321708840886913,-1.5324747644307166,0.03042921752806449,-42972084.0,-1.0
2728,2013-10-31,IBM,111.25958387712711,112.51059695201953,110.881801869168,110.9870834350586,4516733.0,0.0,0.0,-0.5821228027343608,0.5821228027343608,0.0,49.107711404574694,106.87484915524853,115.80534660711164,46.04709090367811,-53.95290909632189,-1.2231591176558823,-1.4706116350757499,0.031246327053543244,-47488817.0,-1.0
2729,2013-11-01,IBM,111.35868773293714,111.68692785927593,110.78272797500934,110.9994888305664,3812147.0,0.0,0.0,0.0124053955078125,0.0,0.0124053955078125,49.18333250859207,106.87484915524853,115.6442642211914,47.03437623036494,-52.96562376963506,-1.131019056571077,-1.4026931193748153,0.03685098131834197,-43676670.0,1.0
2730,2013-11-04,IBM,111.41440838364268,111.97179475790766,111.06759502771402,111.6435546875,3643532.0,0.0,0.0,0.6440658569335938,0.0,0.6440658569335938,53.3369958721345,106.87484915524853,115.6442642211914,54.378832526371546,-45.621167473628454,-0.9945619745909653,-1.3210668904180454,0.030291317121816874,-40033138.0,1.0
2731,2013-11-05,IBM,111.19145120980698,111.35247239014689,110.05810526295424,110.14481353759766,6377253.0,0.0,0.0,-1.4987411499023438,1.4987411499023438,0.0,43.73795484153531,106.87484915524853,112.91314084899462,54.153799587652586,-45.846200412347414,-0.9958748065063361,-1.2560284736357037,0.011833635663662356,-46410391.0,-1.0
2732,2013-11-06,IBM,110.77365554822856,111.9193086777675,110.69271261006686,111.57063293457033,4770492.0,0.908222,0.0,1.4258193969726705,0.0,1.4258193969726705,53.019186688682495,106.91198022344231,112.91314084899462,77.62919544749339,-22.370804552506613,-0.8718138059677614,-1.1791855401021152,0.013229897010574865,-41639899.0,1.0
2733,2013-11-07,IBM,111.82595234007492,112.9404708972193,111.82595234007492,112.07501220703124,5459597.0,0.0,0.0,0.5043792724609091,0.0,0.5043792724609091,55.98300205282037,106.91198022344231,112.9404708972193,85.64385785727966,-14.356142142720344,-0.7244444349798158,-1.0882373190776553,0.02327803343656032,-36180302.0,1.0
2734,2013-11-08,IBM,111.34650576198024,112.12481032431889,110.4250081860466,112.06877136230467,6563650.0,0.0,0.0,-0.0062408447265625,0.0062408447265625,0.0,55.932625334612574,107.11014003467773,112.9404708972193,85.04888392329364,-14.951116076706366,-0.60122616969376,-0.9908350892008763,0.02033582616998486,-42743952.0,-1.0
2735,2013-11-11,IBM,112.19330402721108,114.18574308498398,112.09990906748725,113.86820220947266,5462526.0,0.0,0.0,1.799430847167983,0.0,1.799430847167983,66.08567582903041,108.00819344861674,114.18574308498398,94.85976003103296,-5.140239968967031,-0.3542917282942426,-0.8635264170195496,0.009565856999106392,-37281426.0,1.0
2736,2013-11-12,IBM,113.6502949651188,114.59670664578846,113.48217804887156,113.98651885986328,4454391.0,0.0,0.0,0.118316650390625,0.0,0.118316650390625,66.66830915839653,109.12297219715728,114.59670664578846,88.85244083995036,-11.147559160049635,-0.1473486960077537,-0.7202908728171904,0.021666485794639367,-32827035.0,1.0
2737,2013-11-13,IBM,113.48840740877095,114.28538513183592,113.0650095772912,114.28538513183594,4920802.0,0.0,0.0,0.29886627197265625,0.0,0.29886627197265625,68.25769578391743,109.12297219715728,114.59670664578846,94.31244761918668,-5.687552380813313,0.04030652879826846,-0.5681713924940986,0.029717887836085533,-27906233.0,1.0
2738,2013-11-14,IBM,112.37386212648572,114.06744326295238,111.86330036713316,113.45103454589844,6612289.0,0.0,0.0,-0.8343505859375,0.8343505859375,0.0,59.16928213577248,109.12297219715728,114.59670664578846,79.06964412245975,-20.93035587754025,0.12031264037696587,-0.43047458591988574,0.022086099144782212,-34518522.0,-1.0
2739,2013-11-15,IBM,113.55686235907235,114.11723201869457,112.79724087857647,114.06120300292967,5414201.0,0.0,0.0,0.6101684570312358,0.0,0.6101684570312358,63.29338836135316,109.92805136544108,114.59670664578846,88.52980974815215,-11.47019025184785,0.2302988121819709,-0.2983199062995144,0.021655063941638852,-29104321.0,1.0
2740,2013-11-18,IBM,114.26663987397396,115.18192600982344,114.11098498324615,114.858154296875,5590765.0,0.0,0.0,0.7969512939453267,0.0,0.7969512939453267,68.1427158158055,110.05810526295424,115.18192600982344,93.68104918295052,-6.318950817049485,0.3774202864868528,-0.1631718677422409,0.04279221697232671,-23513556.0,1.0
2741,2013-11-19,IBM,114.95779983394245,115.93534619012856,114.65893203157027,115.34384155273438,4787542.0,0.0,0.0,0.485687255859375,0.0,0.485687255859375,70.85065467298755,110.05810526295424,115.93534619012856,89.93567483920441,-10.064325160795592,0.5271295942275884,-0.025111575348275003,0.033819012395285286,-18726014.0,1.0
2742,2013-11-20,IBM,115.32518626468544,115.96027801270166,114.970279421978,115.30650329589844,3813507.0,0.0,0.0,-0.0373382568359375,0.0373382568359375,0.0,70.32043372400585,110.05810526295424,115.96027801270166,88.92315178624338,-11.076848213756612,0.6354374861506642,0.10699823695151289,0.02883328785990047,-22539521.0,-1.0
2743,2013-11-21,IBM,115.52440485105014,115.65516573063026,114.19818265446958,114.646484375,4664637.0,0.0,0.0,-0.6600189208984375,0.6600189208984375,0.0,61.008244406593725,110.05810526295424,115.96027801270166,77.74050856512312,-22.259491434876878,0.6604015630957178,0.2176789021803539,0.023001171346493043,-27204158.0,-1.0
2744,2013-11-22,IBM,114.25419835391644,115.18193656856018,112.02515214018598,112.8843994140625,7960269.0,0.0,0.0,-1.7620849609375,1.7620849609375,0.0,43.331787286529924,110.05810526295424,115.96027801270166,47.88565619718952,-52.11434380281048,0.5318691903720776,0.2805169598186987,-0.008639837780176296,-35164427.0,-1.0
2745,2013-11-25,IBM,112.230653818741,112.54197364652488,110.71764164201592,111.4149932861328,7491347.0,0.0,0.0,-1.4694061279297017,1.4694061279297017,0.0,33.88511977184312,110.4250081860466,115.96027801270166,17.88503778657605,-82.11496221342395,0.3078884213555284,0.28599125212606463,-0.022559909710831327,-42655774.0,-1.0
2746,2013-11-26,IBM,111.2469039682742,111.41501093801752,110.40010833740236,110.40010833740234,6020776.0,0.0,0.0,-1.0148849487304545,1.0148849487304545,0.0,28.869405973664115,110.40010833740236,115.96027801270166,-2.5558311247825413e-13,-100.00000000000027,0.047936731521460274,0.23838034800514377,-0.03399626986382964,-48676550.0,-1.0
2747,2013-11-27,IBM,110.72388160287603,112.18707596832708,110.71765063445028,111.43368530273438,4807939.0,0.0,0.0,1.0335769653320312,0.0,1.0335769653320312,39.40862535205149,110.40010833740236,115.96027801270166,18.588946483479017,-81.41105351652098,-0.07382482727015827,0.17593931295008336,-0.017781673399795306,-43868611.0,1.0
2748,2013-11-29,IBM,111.58310320774814,112.548187657264,111.4523522670679,111.87574005126952,3002543.0,0.0,0.0,0.44205474853514204,0.0,0.44205474853514204,43.53715946001255,110.40010833740236,115.96027801270166,26.539328834200106,-73.4606711657999,-0.13311712530325792,0.1141280252994151,-0.019160441009937634,-40866068.0,1.0
2749,2013-12-02,IBM,111.73876833862988,111.81971129743609,110.28179508011834,110.50595092773438,4769760.0,0.0,0.0,-1.369789123535142,1.369789123535142,0.0,35.008446931324386,110.28179508011834,115.96027801270166,3.9474600923746466,-96.05253990762536,-0.28732512611497896,0.033837395016536265,-0.03789198421116402,-45635828.0,-1.0
2750,2013-12-03,IBM,110.2070708127088,110.97291335200552,109.3602753858756,109.63423919677734,6133744.0,0.0,0.0,-0.8717117309570312,0.8717117309570312,0.0,30.605974176805177,109.3602753858756,115.96027801270166,4.150965179744126,-95.84903482025588,-0.47440725661313365,-0.06781153530939775,-0.049500712644000466,-51769572.0,-1.0
2751,2013-12-04,IBM,109.19215430548194,110.51837629176954,109.06140338438172,109.42253112792967,5509700.0,0.0,0.0,-0.21170806884767046,0.21170806884767046,0.0,29.56413325866535,109.06140338438172,115.96027801270166,5.2345891613325,-94.76541083866749,-0.6324636175574057,-0.18074195175899938,-0.05102897061121847,-57279272.0,-1.0
2752,2013-12-05,IBM,109.67782615537482,110.11989689551386,109.13612950097684,109.63423919677734,4586605.0,0.0,0.0,0.21170806884767046,0.0,0.21170806884767046,32.2261174690547,109.06140338438172,115.96027801270166,8.303322545450062,-91.69667745454994,-0.732200993414736,-0.29103376009014675,-0.04371913544097861,-52692667.0,1.0
2753,2013-12-06,IBM,110.02029559903198,110.82972520492852,109.5906668608844,110.62425231933594,4957831.0,0.0,0.0,0.9900131225585938,0.0,0.9900131225585938,43.705730469414725,109.06140338438172,115.96027801270166,22.653679319503915,-77.34632068049608,-0.7230232363736064,-0.37743165534683876,-0.020021784289574796,-47734836.0,1.0
2754,2013-12-09,IBM,110.82347731954424,110.92310323188842,110.1012217527262,110.49348449707033,3971244.0,0.0,0.0,-0.1307678222656108,0.1307678222656108,0.0,42.605858709036674,109.06140338438172,115.96027801270166,20.758184339368928,-79.24181566063108,-0.7180247259633461,-0.4455502694701403,-0.008270958529754457,-51706080.0,-1.0
2755,2013-12-10,IBM,110.14479453068012,110.624231172079,109.62178087094668,110.28177642822266,4317679.0,0.0,0.0,-0.21170806884767046,0.21170806884767046,0.0,40.692895205365964,109.06140338438172,115.96027801270166,17.689450955251367,-82.31054904474864,-0.7228142889130567,-0.5010030733587236,-0.0010718459516184664,-56023759.0,-1.0
2756,2013-12-11,IBM,110.20706053580912,110.68026619335484,109.02404142307176,109.08631134033205,4278558.0,0.0,0.0,-1.1954650878906108,1.1954650878906108,0.0,31.482898668587467,109.02404142307176,115.65516573063026,0.939055194445719,-99.06094480555429,-0.8136943310568512,-0.5635413248983492,-0.021065209824346787,-60302317.0,-1.0
2757,2013-12-12,IBM,108.99912704535916,109.45988066309948,107.90328194610456,107.94686889648438,5932494.0,0.0,0.0,-1.1394424438476705,1.1394424438476705,0.0,25.208278200035025,107.90328194610456,115.18193656856018,0.5988325128842794,-99.40116748711571,-0.9665194661100287,-0.6441369531406851,-0.03511816907744836,-66234811.0,-1.0
2758,2013-12-13,IBM,108.04032764466984,108.57580348475656,107.54844871846056,107.59202575683594,4376882.0,0.0,0.0,-0.3548431396484375,0.3548431396484375,0.0,23.523630741665826,107.54844871846056,112.548187657264,0.8715862749786687,-99.12841372502133,-1.103546366663977,-0.7360188358453436,-0.02636894344996865,-70611693.0,-1.0
2759,2013-12-16,IBM,107.85349919614131,111.04764031182783,107.54841034760724,110.73632049560548,7862782.0,0.0,0.0,3.1442947387695455,0.0,3.1442947387695455,54.56713395499724,107.54841034760724,112.548187657264,63.76104275366412,-36.23895724633588,-0.9475006691075265,-0.7783152024977802,0.010052345935926743,-62748911.0,1.0
2760,2013-12-17,IBM,110.43121695249413,110.51215990247036,109.03650383838536,109.43499755859376,5723607.0,0.0,0.0,-1.3013229370117188,1.3013229370117188,0.0,45.70707459293745,107.54841034760724,112.548187657264,37.733424793594246,-62.26657520640575,-0.9182541519450496,-0.8063029923872341,0.00011392928435838279,-68472518.0,-1.0
2761,2013-12-18,IBM,109.86459198418554,111.29043974428896,108.8683728107978,111.2655258178711,5959794.0,0.0,0.0,1.8305282592773295,0.0,1.8305282592773295,57.03106179310472,107.54841034760724,112.548187657264,74.34562061563177,-25.654379384368216,-0.7388507338320807,-0.7928125406762035,0.014879353685903096,-62512724.0,1.0
2762,2013-12-19,IBM,110.75497923509958,112.41120402132846,110.75497923509958,112.21195220947266,6199642.0,0.0,0.0,0.9464263916015625,0.0,0.9464263916015625,61.78592268831446,107.54841034760724,112.41120402132846,95.90252383249222,-4.097476167507772,-0.5143741477324681,-0.7371248620874565,0.014352186404420264,-56313082.0,1.0
2763,2013-12-20,IBM,112.14968520814932,113.32024232522404,112.0874252319336,112.0874252319336,8005561.0,0.0,0.0,-0.1245269775390625,0.1245269775390625,0.0,60.765073163943875,107.54841034760724,113.32024232522404,78.64080073586129,-21.359199264138706,-0.3425741408549072,-0.6582147178409468,0.014425653622187395,-64318643.0,-1.0
2764,2013-12-23,IBM,112.7287377919725,113.89930484703072,112.45477402107647,113.46345520019533,4267575.0,0.0,0.0,1.376029968261733,0.0,1.376029968261733,67.5921496805228,107.54841034760724,113.89930484703072,93.13719277064106,-6.862807229358939,-0.09430024522677627,-0.5454318233181127,0.028850449049879767,-60051068.0,1.0
2765,2013-12-24,IBM,113.29532395370096,114.25418709218424,113.26419893841673,114.07984924316406,1687826.0,0.0,0.0,0.6163940429687358,0.0,0.6163940429687358,70.26631982711476,107.54841034760724,114.25418709218424,97.40018411496976,-2.5998158850302393,0.15046202085711968,-0.4062530544830662,0.045776026721198404,-58363242.0,1.0
2766,2013-12-26,IBM,114.2915791292778,115.53684834431816,114.26044416913412,115.40609741210938,3478682.0,0.0,0.0,1.3262481689453125,0.0,1.3262481689453125,75.32184010613062,107.54841034760724,115.53684834431816,98.36324783064453,-1.6367521693554865,0.44631023638903855,-0.23574039630864524,0.06910092522255584,-54884560.0,1.0
2767,2013-12-27,IBM,115.71118939710146,116.12213510634656,114.9142119100554,115.23798370361328,3537154.0,0.0,0.0,-0.16811370849609375,0.16811370849609375,0.0,73.49417611723905,107.54841034760724,116.12213510634656,89.68766285817547,-10.312337141824536,0.6596032121769468,-0.05667167461152678,0.07106435530879995,-58421714.0,-1.0
2768,2013-12-30,IBM,115.38741491254126,116.2466623015384,114.98270018003248,116.06609344482422,3157456.0,0.0,0.0,0.8281097412109375,0.0,0.8281097412109375,76.70665293779572,107.54841034760724,116.2466623015384,97.92407879571059,-2.0759212042894064,0.8852562838421818,0.131713917079215,0.04813030562479503,-55264258.0,1.0
2769,2013-12-31,IBM,116.11591066872276,116.9253501358824,115.997611723135,116.78836822509766,3786206.0,0.0,0.0,0.7222747802734375,0.0,0.7222747802734375,79.2389282882451,107.54841034760724,116.9253501358824,98.5391618814059,-1.4608381185941024,1.1095789714331517,0.3272869279500024,0.06719395833647046,-51478052.0,1.0
2770,2014-01-02,IBM,116.56418513495656,116.682493990625,115.31268514085748,115.51815795898438,4755639.0,0.0,0.0,-1.2702102661132812,1.2702102661132812,0.0,64.91816031187676,107.54841034760724,116.9253501358824,84.99305521127944,-15.00694478872055,1.1713582758808911,0.4961011975361803,0.03822057290300629,-56233691.0,-1.0
2771,2014-01-03,IBM,115.70496417336896,116.65137552603892,115.3749614244756,116.20930480957033,4250107.0,0.0,0.0,0.6911468505859517,0.0,0.6911468505859517,68.49315391007019,107.54841034760724,116.9253501358824,92.36376320548196,-7.636236794518051,1.2615462740998424,0.6491902128489129,0.0356232337232274,-51983584.0,1.0
2772,2014-01-06,IBM,116.52687914003528,116.65763010868652,115.3749946088834,115.81084442138672,4254919.0,0.0,0.0,-0.39846038818360796,0.39846038818360796,0.0,64.14487306897652,107.54841034760724,116.9253501358824,88.1143983041328,-11.885601695867203,1.2860437771555269,0.7765609257102357,0.03321888411432905,-56238503.0,-1.0
2773,2014-01-07,IBM,116.05363568686492,118.51928988693336,116.04741465776796,118.12079620361328,6205186.0,0.0,0.0,2.3099517822265625,0.0,2.3099517822265625,74.83241156791642,108.8683728107978,118.51928988693336,95.87092418081735,-4.1290758191826535,1.4748508653745773,0.9162189136431041,0.04104705779671991,-50033317.0,1.0
2774,2014-01-08,IBM,117.88422535399825,117.9402543796934,116.5953590080408,117.03742980957033,4815470.0,0.0,0.0,-1.0833663940429545,1.0833663940429545,0.0,64.43822827965319,108.8683728107978,118.51928988693336,84.64539622843381,-15.354603771566191,1.519546839260741,1.0368844987666317,0.025925530109196737,-54848787.0,-1.0
2775,2014-01-09,IBM,117.69123104698126,117.990098961015,116.15331444006864,116.67009735107422,4520080.0,0.0,0.0,-0.36733245849610796,0.36733245849610796,0.0,61.1170305850539,110.75497923509958,118.51928988693336,76.18342929874396,-23.816570701256033,1.5079454051979297,1.1310966800528914,0.010952627004196858,-59368867.0,-1.0
2776,2014-01-10,IBM,117.24911144668764,117.4109973380714,115.98514933782832,116.5953369140625,4207430.0,0.0,0.0,-0.07476043701171875,0.07476043701171875,0.0,60.38614586743267,112.0874252319336,118.51928988693336,70.0871663806655,-29.912833619334506,1.4757076039955308,1.2000188648414194,0.01177869628420658,-63576297.0,-1.0
2777,2014-01-13,IBM,115.97269257720768,116.40231128088551,114.47836362684032,114.66515350341795,6050796.0,0.0,0.0,-1.9301834106445455,1.9301834106445455,0.0,44.52417438736757,112.45477402107647,118.51928988693336,36.4477483649746,-63.55225163502539,1.2796581420471824,1.215946720282572,-0.012070191214562098,-69627093.0,-1.0
2778,2014-01-14,IBM,115.2255259979658,116.07854239744177,114.4908184693105,115.76100158691406,4831683.0,0.0,0.0,1.095848083496108,0.0,1.095848083496108,52.66873476874244,113.26419893841673,118.51928988693336,47.51207301563662,-52.48792698436338,1.1988932180581173,1.2125360198376811,-0.008796823294965894,-64795410.0,1.0
2779,2014-01-15,IBM,115.69873204195788,117.46080379852076,115.49326913459772,116.89420318603516,5038059.0,0.0,0.0,1.1332015991210938,0.0,1.1332015991210938,59.724022025404516,114.26044416913412,118.51928988693336,61.84208565935162,-38.15791434064838,1.2123511033965855,1.2124990365494621,0.01191193879268182,-59757351.0,1.0
2780,2014-01-16,IBM,116.76347710958984,117.67252271966504,116.30894436680369,117.5293197631836,4989734.0,0.0,0.0,0.6351165771484375,0.0,0.6351165771484375,63.26513075264655,114.47836362684032,118.51928988693336,75.50140586512518,-24.498594134874814,1.2597436338428452,1.2219479560081388,0.011358943724655735,-54767617.0,1.0
2781,2014-01-17,IBM,117.08100762755252,118.8057136720302,116.96892970942112,118.357421875,7996252.0,0.0,0.0,0.8281021118164062,0.0,0.8281021118164062,67.55652908303858,114.47836362684032,118.8057136720302,89.64050071409177,-10.359499285908221,1.348577908585085,1.247273946523528,0.021989110487333763,-46771365.0,1.0
2782,2014-01-21,IBM,118.44458665587749,118.54421257685809,116.30271382565002,117.32383728027344,11585810.0,0.0,0.0,-1.0335845947265625,1.0335845947265625,0.0,57.82759036699645,114.47836362684032,118.8057136720302,65.75556919866105,-34.24443080133896,1.3203578097338493,1.2618907191655924,-0.00674698231771198,-58357175.0,-1.0
2783,2014-01-22,IBM,112.87198018008117,114.25423151602124,111.86952970513828,113.47593688964844,14430721.0,0.0,0.0,-3.847900390625,3.847900390625,0.0,35.726480783220296,111.86952970513828,118.8057136720302,23.159812256680773,-76.84018774331923,0.9762462164781169,1.2047618186280973,-0.030430375356984007,-72787896.0,-1.0
2784,2014-01-23,IBM,112.96537358126652,114.3912118611994,112.51707182805136,113.7748031616211,7294699.0,0.0,0.0,0.29886627197265625,0.0,0.29886627197265625,37.85504071057161,111.86952970513828,118.8057136720302,27.468611928073823,-72.53138807192619,0.7193589874051867,1.1076812523835151,-0.024816077599908448,-65493197.0,1.0
2785,2014-01-24,IBM,112.85333428815588,113.82465011706222,111.85088348388672,111.85088348388672,7207568.0,0.0,0.0,-1.923919677734375,1.923919677734375,0.0,30.3815753175041,111.85088348388672,118.8057136720302,0.0,-100.0,0.3564211672752151,0.9574292353618551,-0.04069162245890434,-72700765.0,-1.0
2786,2014-01-27,IBM,111.83216108087548,111.85706507507136,110.61800689297606,110.76744079589844,5448196.0,0.0,0.0,-1.0834426879882812,1.0834426879882812,0.0,26.92729236657651,110.61800689297606,118.8057136720302,1.8251008121671557,-98.17489918783284,-0.018422081838011195,0.7622589719218819,-0.03399212915546601,-78148961.0,-1.0
2787,2014-01-28,IBM,110.8608145241901,111.10987429397292,109.68402649056942,110.11365509033205,5578632.0,0.0,0.0,-0.653785705566392,0.653785705566392,0.0,24.95200429315844,109.68402649056942,118.8057136720302,4.709968575065966,-95.29003142493403,-0.36404659727213584,0.5369978580830783,-0.0487845338167876,-83727593.0,-1.0
2788,2014-01-29,IBM,109.57195612578236,111.15967982552034,109.51591718192772,109.83345794677734,5199561.0,0.0,0.0,-0.2801971435547017,0.2801971435547017,0.0,24.0785420587044,109.51591718192772,118.8057136720302,3.4181670738206016,-96.5818329261794,-0.6530382649850992,0.29899063346944277,-0.06040286897735003,-88927154.0,-1.0
2789,2014-01-30,IBM,110.31290682025846,110.74252552074134,109.80856620705252,110.43120574951172,5076970.0,0.0,0.0,0.597747802734375,0.0,0.597747802734375,30.101486119684495,109.51591718192772,118.8057136720302,9.852622375088254,-90.14737762491175,-0.8243306213841493,0.07432638249872431,-0.060394410756177797,-83850184.0,1.0
2790,2014-01-31,IBM,109.65291339706984,110.7300756523664,109.1734767663115,110.00782012939452,5432296.0,0.0,0.0,-0.4233856201172017,0.4233856201172017,0.0,28.268682712617803,109.1734767663115,118.8057136720302,8.66198964217407,-91.33801035782592,-0.9829143047984417,-0.13712175496070897,-0.07054565411557956,-89282480.0,-1.0
2791,2014-02-03,IBM,109.5968974040389,109.5968974040389,107.54218843157908,107.65426635742188,7517393.0,0.0,0.0,-2.353553771972642,2.353553771972642,0.0,20.329305758730328,107.54218843157908,118.8057136720302,0.9950519348976792,-99.00494806510231,-1.2837073569114494,-0.3664388753508571,-0.08241778607830608,-96799873.0,-1.0
2792,2014-02-04,IBM,108.046518648296,108.18350055816614,107.31803207668897,107.61688995361328,4549891.0,0.0,0.0,-0.03737640380859375,0.03737640380859375,0.0,20.225219025314203,107.31803207668897,118.8057136720302,2.6015508389918858,-97.39844916100812,-1.5077238788724117,-0.5946958760551682,-0.05163250550407783,-101349764.0,-1.0
2793,2014-02-05,IBM,107.2121873289812,108.94312448789309,107.2121873289812,108.48860168457033,4929066.0,0.0,0.0,0.8717117309570455,0.0,0.8717117309570455,29.885777583690825,107.2121873289812,118.8057136720302,11.009716265960886,-88.99028373403911,-1.5965151027171345,-0.7950597213875615,-0.04646196987518869,-96420698.0,1.0
2794,2014-02-06,IBM,108.91429235224174,109.46522376640796,108.801610011166,109.35253143310548,4489641.0,0.908222,0.0,0.8639297485351562,0.0,0.8639297485351562,38.41423356907451,107.2121873289812,118.8057136720302,18.461545182993824,-81.53845481700618,-1.57896949929588,-0.9518416769692255,-0.022336453436607395,-91931057.0,1.0
2795,2014-02-07,IBM,109.9598121690995,111.16183722210891,109.60296972468676,110.96775817871094,4908773.0,0.0,0.0,1.6152267456054545,0.0,1.6152267456054545,51.21541097753371,107.2121873289812,118.54421257685809,33.14121498655646,-66.85878501344355,-1.4183789927602959,-1.0451491401274395,0.0018084500406723159,-87022284.0,1.0
2796,2014-02-10,IBM,110.79244517422114,111.21816397151588,110.34168585806664,110.89887237548828,3703258.0,0.0,0.0,-0.06888580322265625,0.06888580322265625,0.0,50.696856092361976,107.2121873289812,114.3912118611994,51.353565236640286,-48.64643476335972,-1.28189152045519,-1.0924976161929896,0.007130971036354072,-90725542.0,-1.0
2797,2014-02-11,IBM,110.69228164366923,112.93354794332302,110.68601651792356,112.5015640258789,4861076.0,0.0,0.0,1.602691650390625,0.0,1.602691650390625,61.23381499828706,107.2121873289812,114.3912118611994,73.67820897059087,-26.32179102940912,-1.0324983946473196,-1.0804977718838555,0.024292288788671845,-85864466.0,1.0
2798,2014-02-12,IBM,112.3889164536742,113.4719841645782,112.22614304065443,112.83967590332033,4166218.0,0.0,0.0,0.33811187744142046,0.0,0.33811187744142046,63.1508351643265,107.2121873289812,113.82465011706222,85.10427589071183,-14.89572410928817,-0.7983666688909921,-1.024071551285283,0.021809688099138302,-81698248.0,1.0
2799,2014-02-13,IBM,111.575039423984,114.16689353768813,111.34965472317514,113.84134674072266,4688172.0,0.0,0.0,1.0016708374023295,0.0,1.0016708374023295,68.47908880455971,107.2121873289812,114.16689353768813,95.31904314580677,-4.68095685419323,-0.5259265700421878,-0.9244425550366638,0.034847764520913316,-77010076.0,1.0
2800,2014-02-14,IBM,113.47821047434182,115.46279658041416,113.30918196880432,114.99952697753906,4874255.0,0.0,0.0,1.1581802368164062,0.0,1.1581802368164062,73.57646991269745,107.2121873289812,115.46279658041416,94.38502553257335,-5.614974467426643,-0.21409243874940387,-0.7823725317792118,0.0682300931365809,-72135821.0,1.0
2801,2014-02-18,IBM,114.6802354232214,115.19359605839944,114.14183426811664,114.6865005493164,4639219.0,0.0,0.0,-0.31302642822265625,0.31302642822265625,0.0,70.04404977281288,107.2121873289812,115.46279658041416,90.59104597684188,-9.408954023158119,0.007691082255178117,-0.6243598089723339,0.0656923889804879,-76775040.0,-1.0
2802,2014-02-19,IBM,114.40479239758392,116.22660549399124,114.19819307889502,114.53627014160156,4886389.0,0.0,0.0,-0.15023040771484375,0.15023040771484375,0.0,68.23006378028856,107.2121873289812,116.22660549399124,81.24853627324711,-18.751463726752885,0.16938126040949442,-0.4656115950959682,0.055744735973413784,-81661429.0,-1.0
2803,2014-02-20,IBM,114.54250216270644,115.73200679279536,114.4360749572842,115.35636901855467,5196737.0,0.0,0.0,0.8200988769531108,0.0,0.8200988769531108,72.68569390163489,107.2121873289812,116.22660549399124,90.34617143883517,-9.653828561164833,0.3595523216614396,-0.30057881174448664,0.054903508009980895,-76464692.0,1.0
2804,2014-02-21,IBM,115.35013528843469,116.26416439323464,114.329668966236,114.43609619140624,5961468.0,0.0,0.0,-0.9202728271484375,0.9202728271484375,0.0,61.515175157694486,107.2121873289812,116.26416439323464,79.8047632152372,-20.195236784762795,0.4310372031525276,-0.15425560876508376,0.03125536705093768,-82426160.0,-1.0
2805,2014-02-24,IBM,114.4548985290192,115.91985935830296,114.4548985290192,114.84931182861328,4806684.0,0.0,0.0,0.41321563720704546,0.0,0.41321563720704546,64.35342283666844,107.2121873289812,116.26416439323464,84.36968460504991,-15.630315394950086,0.5150948425729922,-0.02038551849746853,0.03562199838921143,-77619476.0,1.0
2806,2014-02-25,IBM,114.89311955228642,115.56926372632832,114.49245114537122,114.7115707397461,4081806.0,0.0,0.0,-0.1377410888671875,0.1377410888671875,0.0,62.57833657645553,107.2121873289812,116.26416439323464,82.84801604701599,-17.15198395298402,0.5640940476519205,0.09651039473240931,0.019644231020280012,-81701282.0,-1.0
2807,2014-02-26,IBM,115.15600333898507,115.99491048498577,114.91810847343666,115.23112487792967,3912772.0,0.0,0.0,0.5195541381835795,0.0,0.5195541381835795,66.5892990734439,108.801610011166,116.26416439323464,86.15702529703236,-13.84297470296764,0.6375012301943599,0.2047085618247995,0.021193334307857414,-77788510.0,1.0
2808,2014-02-27,IBM,115.0871896623611,116.41441739627714,115.07466940013384,115.98870849609376,4003879.0,0.0,0.0,0.7575836181640909,0.0,0.7575836181640909,71.69381464139344,109.60296972468676,116.41441739627714,93.75009659166943,-6.249903408330566,0.7481830295766088,0.31340345537516145,0.018862757836674238,-73784631.0,1.0
2809,2014-02-28,IBM,116.05754887920384,116.52082845428984,114.9744714979874,115.9260711669922,4882623.0,0.0,0.0,-0.0626373291015625,0.0626373291015625,0.0,70.6638628835878,110.34168585806664,116.52082845428984,90.37476028371371,-9.625239716286291,0.8213765267193622,0.41499806964400165,0.00805693913535932,-78667254.0,-1.0
2810,2014-03-03,IBM,114.7741419595422,115.59427394146311,114.45486034327554,115.35636901855467,4131805.0,0.0,0.0,-0.5697021484375284,0.5697021484375284,0.0,61.40604090774131,110.68601651792356,116.52082845428984,80.0428968673778,-19.957103132622187,0.8239151177546802,0.49678147926613747,0.005840865891188374,-82799059.0,-1.0
2811,2014-03-04,IBM,116.3267401386485,117.17191253888537,116.2453534628398,116.72115325927734,4950718.0,0.0,0.0,1.3647842407226705,0.0,1.3647842407226705,71.66665491304757,111.34965472317514,117.17191253888537,92.25799863428007,-7.742001365719936,0.9253863735910386,0.5825024581311178,0.01907590595515818,-77848341.0,1.0
2812,2014-03-05,IBM,116.80256378049404,117.66651174861654,116.6961365661285,117.15941619873048,3645519.0,0.0,0.0,0.4382629394531392,0.0,0.4382629394531392,74.20743569027346,111.34965472317514,117.66651174861654,91.97234403369094,-8.027655966309055,1.0293020777609172,0.6718623820570777,0.015630235205182252,-74202822.0,1.0
2813,2014-03-06,IBM,117.3034217118886,117.94199508566172,117.00918054679715,117.47245025634766,3992896.0,0.0,0.0,0.3130340576171733,0.0,0.3130340576171733,75.98245357356328,113.30918196880432,117.94199508566172,89.86480098656409,-10.135199013435916,1.1239589551050528,0.7622816966666728,0.026533184598177773,-70209926.0,1.0
2814,2014-03-07,IBM,117.91695133283794,118.27380379459368,117.18447101169424,117.49749755859376,4307219.0,0.0,0.0,0.02504730224610796,0.0,0.02504730224610796,76.13408997949756,114.14183426811664,118.27380379459368,81.21219841953194,-18.78780158046806,1.1873097525748904,0.8472873078483164,0.023057915522666006,-65902707.0,1.0
2815,2014-03-10,IBM,117.41608249349414,117.92944310857916,116.35179049267794,116.68985748291016,4802395.0,0.0,0.0,-0.807640075683608,0.807640075683608,0.0,61.652119278737864,114.19819307889502,118.27380379459368,61.13597636834184,-38.86402363165816,1.158985844247141,0.9096270151280814,0.01724574714134408,-70705102.0,-1.0
2816,2014-03-11,IBM,117.32841161880536,117.9795049745189,116.47071902701543,116.92147827148438,4424057.0,0.0,0.0,0.23162078857421875,0.0,0.23162078857421875,63.92296152349041,114.329668966236,118.27380379459368,65.71299963210426,-34.28700036789574,1.1420638041112028,0.9561143729247057,0.014669243187076297,-66281045.0,1.0
2817,2014-03-12,IBM,116.45196733262348,117.35347601277574,116.3768357804786,116.58343505859376,5055318.0,0.0,0.0,-0.3380432128906108,0.3380432128906108,0.0,58.12650722621513,114.329668966236,118.27380379459368,57.142217252654746,-42.85778274734525,1.0888244131881493,0.9826563809773944,0.0051274522340252204,-71336363.0,-1.0
2818,2014-03-13,IBM,116.70243068336596,117.07180348595718,115.0120949653996,115.13104248046876,5139207.0,0.0,0.0,-1.452392578125,1.452392578125,0.0,40.100056665570484,114.45486034327554,118.27380379459368,17.706000254071164,-82.29399974592883,0.918844007658663,0.9698939063136482,-0.006858066339349933,-76475570.0,-1.0
2819,2014-03-14,IBM,115.12475241590911,115.37517764918942,114.07299041748048,114.07299041748048,5742854.0,0.0,0.0,-1.0580520629882812,1.0580520629882812,0.0,31.808287448342583,114.07299041748048,118.27380379459368,0.0,-100.0,0.6907943059130872,0.9140739862335362,-0.011125338045858246,-82218424.0,-1.0
2820,2014-03-17,IBM,114.35468590969045,116.66481870425956,114.35468590969045,116.32675170898438,5165253.0,0.0,0.0,2.253761291503892,0.0,2.253761291503892,54.786601332746926,114.07299041748048,118.27380379459368,53.650593091871215,-46.34940690812879,0.6840378129047622,0.8680667515677815,-0.003379006626304193,-77053171.0,1.0
2821,2014-03-18,IBM,116.4394491426893,117.63520903696002,116.15772827547164,116.95281982421876,4143520.0,0.0,0.0,0.6260681152343892,0.0,0.6260681152343892,59.19390682489695,114.07299041748048,118.27380379459368,68.5540905584648,-31.445909441535203,0.7208917171682998,0.8386317446878852,-0.0017633783200258213,-72909651.0,1.0
2822,2014-03-19,IBM,116.19530920720015,116.88396360688644,114.88059172748744,115.63812255859376,4522799.0,0.0,0.0,-1.314697265625,1.314697265625,0.0,47.88422170334156,114.07299041748048,118.27380379459368,37.25783558109033,-62.742164418909674,0.6366744333177081,0.7982402824138498,-0.015614960731227034,-77432450.0,-1.0
2823,2014-03-20,IBM,115.48785094336944,117.86058517168898,115.3000270532932,117.63520050048828,5295480.0,0.0,0.0,1.997077941894517,0.0,1.997077941894517,60.958487397938086,114.07299041748048,118.27380379459368,84.79810368190545,-15.20189631809456,0.7227477426561393,0.7831417744623078,0.0011719648907912994,-72136970.0,1.0
2824,2014-03-21,IBM,118.01083683292276,118.1360494273536,116.69612957196584,116.86515808105467,13111819.0,0.0,0.0,-0.770042419433608,0.770042419433608,0.0,54.83785775847199,114.07299041748048,118.27380379459368,66.46731032581538,-33.53268967418463,0.7205197693067333,0.770617373431193,0.0015022779350826188,-85248789.0,-1.0
2825,2014-03-24,IBM,117.3409484777379,118.59931946227708,117.3033877001075,117.85430908203124,6002471.0,0.0,0.0,0.9891510009765625,0.0,0.9891510009765625,60.688193287717276,114.07299041748048,118.59931946227708,83.54051654502896,-16.459483454971032,0.7894697871919334,0.7743878561833412,0.007978267332379163,-79246318.0,1.0
2826,2014-03-25,IBM,118.17360052083085,122.3305863711366,118.13603974324865,122.1052017211914,11414684.0,0.0,0.0,4.2508926391601705,0.0,4.2508926391601705,76.06368428209267,114.07299041748048,122.3305863711366,97.2705778871948,-2.729422112805206,1.1735961964822934,0.8542295242431318,0.047363218109180316,-67831634.0,1.0
2827,2014-03-26,IBM,122.06762929978058,122.474562665336,120.1769504351134,120.59014892578124,7166878.0,0.0,0.0,-1.5150527954101705,1.5150527954101705,0.0,65.5245367098301,114.07299041748048,122.474562665336,77.57070124540377,-22.429298754596232,1.3403167078756297,0.9514469609696314,0.04741645978093678,-74998512.0,-1.0
2828,2014-03-27,IBM,120.14568533081231,120.62148523244146,118.5242065892501,118.84349822998048,7079014.0,0.0,0.0,-1.7466506958007528,1.7466506958007528,0.0,55.32707585905641,114.07299041748048,122.474562665336,56.78113181396095,-43.21886818603905,1.316329968049473,1.0244235623856,0.04181978393869623,-82077526.0,-1.0
2829,2014-03-28,IBM,118.9123848622024,120.59020006798325,118.392758962051,119.2316665649414,5433342.0,0.0,0.0,0.3881683349609233,0.0,0.3881683349609233,57.04142739349283,114.07299041748048,122.474562665336,61.40131864934766,-38.59868135065235,1.3135010223347052,1.082239054375421,0.02497202761428663,-76644184.0,1.0
2830,2014-03-31,IBM,119.9766354106297,121.3101280337606,119.8263822984927,120.50878143310548,8930016.0,0.0,0.0,1.2771148681640767,0.0,1.2771148681640767,62.50401076634038,114.07299041748048,122.474562665336,76.60222189088151,-23.397778109118498,1.3981940483931652,1.1454300531789698,0.03040509509930045,-67714168.0,1.0
2831,2014-04-01,IBM,120.90318776834152,122.16154876815088,120.6903333682753,121.7671356201172,5642229.0,0.0,0.0,1.2583541870117188,0.0,1.2583541870117188,67.24002159789791,114.07299041748048,122.474562665336,91.57982548564809,-8.420174514351917,1.548996678614671,1.2261433782661102,0.053001665245973495,-62071939.0,1.0
2832,2014-04-02,IBM,121.60436774420742,121.76714111447944,120.50878005789043,121.17239379882812,5150609.0,0.0,0.0,-0.5947418212890767,0.5947418212890767,0.0,62.90691152481743,114.07299041748048,122.474562665336,84.50089068935583,-15.499109310644165,1.6020507116653135,1.301324844945951,0.030069173880697075,-67222548.0,-1.0
2833,2014-04-03,IBM,120.95326137785584,121.065953696724,120.42111541814278,120.63397979736328,4279291.0,0.0,0.0,-0.5384140014648438,0.5384140014648438,0.0,58.93944139149834,114.35468590969045,122.474562665336,77.33237925448805,-22.667620745511954,1.5824098689348318,1.3575418497437273,0.03224931860096958,-71501839.0,-1.0
2834,2014-04-04,IBM,120.90324782999387,121.4353940867422,119.75131345796598,120.05807495117188,6370035.0,0.0,0.0,-0.5759048461914062,0.5759048461914062,0.0,54.6829702473549,114.88059172748744,122.474562665336,68.17886539280417,-31.821134607195834,1.503047456058411,1.3866429710066641,0.018699069099006982,-77871874.0,-1.0
2835,2014-04-07,IBM,120.02671676785684,122.27424832974296,119.93280982155132,121.7796630859375,7050563.0,0.0,0.0,1.721588134765625,0.0,1.721588134765625,63.72019455877246,114.88059172748744,122.474562665336,90.84932527282798,-9.15067472717201,1.5610748475316854,1.4215293463116685,-0.0026660505094388,-70821311.0,1.0
2836,2014-04-08,IBM,121.38530435787776,121.56059805465544,120.63403852009476,121.0096664428711,5360750.0,0.0,0.0,-0.7699966430664062,0.7699966430664062,0.0,57.77431748221318,115.3000270532932,122.474562665336,79.5820063948668,-20.417993605133205,1.5273236431430206,1.442688205677939,0.003478870544791013,-76182061.0,-1.0
2837,2014-04-09,IBM,121.37901981001755,123.33230068351747,121.20372614128516,123.10692596435548,5732185.0,0.0,0.0,2.097259521484389,0.0,2.097259521484389,67.34937824787082,116.69612957196584,123.33230068351747,96.60384406348898,-3.3961559365110308,1.6507777480461243,1.4843061141515763,0.03587430358305843,-70449876.0,1.0
2838,2014-04-10,IBM,122.74381775357618,124.71587401506096,122.4933925182166,122.50591278076172,8805123.0,0.0,0.0,-0.6010131835937642,0.6010131835937642,0.0,62.65175853042596,117.3033877001075,124.71587401506096,70.18596540487346,-29.814034595126532,1.6807446959544308,1.5235938305121475,0.02746121320074768,-79254999.0,-1.0
2839,2014-04-11,IBM,122.10523312899748,123.3322987834487,121.62317804546716,122.19915008544922,5057410.0,0.0,0.0,-0.3067626953125,0.3067626953125,0.0,60.17968912908535,118.13603974324865,124.71587401506096,61.750952597799255,-38.249047402200745,1.6605981900351594,1.55099470241675,0.014026933408849196,-84312409.0,-1.0
2840,2014-04-14,IBM,122.85648142501933,124.10858742686364,122.6311067412673,123.81434631347656,5680931.0,0.0,0.0,1.6151962280273438,0.0,1.6151962280273438,67.87950409577309,118.392758962051,124.71587401506096,85.74234860466045,-14.257651395339549,1.7547372569756874,1.5917432133285379,0.016812505960114965,-78631478.0,1.0
2841,2014-04-15,IBM,122.69370173831268,123.58895528532756,122.34311447395012,123.34479522705078,5597460.0,0.0,0.0,-0.46955108642578125,0.46955108642578125,0.0,63.7449659702215,118.392758962051,124.71587401506096,78.31640296727618,-21.683597032723824,1.7710388637021595,1.6276023434032623,0.017928187767168424,-84228938.0,-1.0
2842,2014-04-16,IBM,123.98966697526528,124.40285565089316,122.08020190866206,122.95668029785156,8919556.0,0.0,0.0,-0.38811492919921875,0.38811492919921875,0.0,60.24522138392853,118.392758962051,124.71587401506096,72.17836932491083,-27.82163067508917,1.7326672636381062,1.6486153274502313,0.019254114838869407,-93148494.0,-1.0
2843,2014-04-17,IBM,117.228293411331,119.38818369883428,117.0780502530576,118.9561996459961,11767082.0,0.0,0.0,-4.000480651855469,4.000480651855469,0.0,36.44675216850377,117.0780502530576,124.71587401506096,24.590111679218253,-75.40988832078175,1.3637318866500294,1.5916386392901911,-0.009177852515325768,-104915576.0,-1.0
2844,2014-04-21,IBM,118.82467835205384,120.7090920237127,118.78711757940783,120.37102508544922,5669006.0,0.0,0.0,1.414825439453125,0.0,1.414825439453125,45.26933484957805,117.0780502530576,124.71587401506096,43.11404576750655,-56.88595423249344,1.1720024168093914,1.5077113947940313,-0.011567103774086096,-99246570.0,1.0
2845,2014-04-22,IBM,120.20828476533003,120.82807265702633,119.70117922252469,120.29593658447266,4057016.0,0.0,0.0,-0.0750885009765625,0.0750885009765625,0.0,44.8877385151827,117.0780502530576,124.71587401506096,42.13093194717841,-57.86906805282159,1.0024409014226734,1.4066572961197599,-0.0058981226820866706,-103303586.0,-1.0
2846,2014-04-23,IBM,120.07055028441069,120.4587083464874,119.01878842223518,120.03298950195312,4954274.0,0.0,0.0,-0.26294708251953125,0.26294708251953125,0.0,43.40922617454851,117.0780502530576,124.71587401506096,38.68823556254015,-61.31176443745985,0.8371938967289196,1.292764616241592,-0.024969646819809177,-108257860.0,-1.0
2847,2014-04-24,IBM,120.3397655527296,120.3397655527296,118.96871189193152,119.0876693725586,4609827.0,0.0,0.0,-0.9453201293945312,0.9453201293945312,0.0,38.19106537921456,117.0780502530576,124.71587401506096,26.31140992671822,-73.68859007328177,0.6227760463000891,1.1587669022532914,-0.027902681026673926,-112867687.0,-1.0
2848,2014-04-25,IBM,119.28796846063788,119.36935513805042,118.3927150090998,118.71826171875,4049066.0,0.0,0.0,-0.36940765380859375,0.36940765380859375,0.0,36.227485834593175,117.0780502530576,124.71587401506096,21.474853528987204,-78.5251464710128,0.4182192731955894,1.010657376441751,-0.028485372969166867,-116916753.0,-1.0
2849,2014-04-28,IBM,119.66361965864397,121.4478717782102,119.31303236295668,120.9157257080078,5897662.0,0.0,0.0,2.1974639892577983,0.0,2.1974639892577983,52.862326735571145,117.0780502530576,124.71587401506096,50.24566649523734,-49.754333504762656,0.4284842361649339,0.8942227483863876,-0.02341102377692128,-111019091.0,1.0
2850,2014-04-29,IBM,121.1974631817946,122.66868899065426,121.08478081631236,122.14906311035156,4839110.0,0.0,0.0,1.2333374023437642,0.0,1.2333374023437642,59.674328645747245,117.0780502530576,124.71587401506096,66.39342586721146,-33.606574132788545,0.5300294644763284,0.8213840916043756,-0.009694224344838687,-106179981.0,1.0
2851,2014-04-30,IBM,121.69205111251756,123.24466365876258,121.6732657217584,123.00050354003906,4400313.0,0.0,0.0,0.8514404296875,0.0,0.8514404296875,63.83716520128892,117.0780502530576,124.71587401506096,77.54110950352741,-22.458890496472595,0.6714686438461683,0.7914010020527343,0.00035641204757097533,-101779668.0,1.0
2852,2014-05-01,IBM,122.90033869702086,123.16953935782628,120.9220171042729,121.159912109375,3843004.0,0.0,0.0,-1.8405914306640625,1.8405914306640625,0.0,50.76558282960561,117.0780502530576,124.40285565089316,55.726557015747744,-44.273442984252256,0.6278029449659357,0.7586813906353747,0.018525410780917406,-105622672.0,-1.0
2853,2014-05-02,IBM,121.29763331893764,121.35397949688378,119.73250056798943,119.85144805908205,3190195.0,0.0,0.0,-1.3084640502929545,1.3084640502929545,0.0,43.46515791371469,117.0780502530576,124.40285565089316,37.863091992095406,-62.1369080079046,0.48205857921109896,0.7033568283505196,-0.00431646258722429,-108812867.0,-1.0
2854,2014-05-05,IBM,119.6073070231218,119.88277282935184,118.82474551896784,119.73878479003906,2324317.0,0.0,0.0,-0.11266326904298296,0.11266326904298296,0.0,42.85290968415576,117.0780502530576,124.40285565089316,36.32498602307847,-63.67501397692153,0.35339046971650134,0.633363556623716,-0.004631509677322843,-111137184.0,-1.0
2855,2014-05-06,IBM,119.5321406307292,119.54466089066206,118.48036885078211,118.96868896484376,3335380.0,0.0,0.0,-0.7700958251952983,0.7700958251952983,0.0,38.56815939590486,117.0780502530576,124.40285565089316,25.81145312536003,-74.18854687463997,0.1871227344024078,0.5441153921794544,-0.008866733566542107,-114472564.0,-1.0
2856,2014-05-07,IBM,119.22684646428122,119.83135805863968,117.70927592657844,119.20166015625,3996766.0,1.051625,0.0,0.2329711914062358,0.0,0.2329711914062358,40.639945198767585,117.0780502530576,123.24466365876258,34.437214780283895,-65.56278521971612,0.07330813386211332,0.44995394051598614,0.0009572005589830734,-110475798.0,1.0
2857,2014-05-08,IBM,119.11353522220848,120.00141818517474,118.52791820120942,118.95611572265624,2543767.0,0.0,0.0,-0.2455444335937642,0.2455444335937642,0.0,39.038825334058394,117.70927592657844,123.24466365876258,22.524886356710912,-77.47511364328908,-0.0362858599402216,0.3527059804247446,0.0020035165648712994,-113019565.0,-1.0
2858,2014-05-09,IBM,119.00019955953756,120.0140141254874,118.61608310720604,119.69286346435548,2365634.0,0.0,0.0,0.7367477416992472,0.0,0.7367477416992472,46.35577895547742,117.70927592657844,123.24466365876258,35.83466296758156,-64.16533703241844,-0.06296468640283592,0.2695718470592285,-0.010113343293372212,-110653931.0,1.0
2859,2014-05-12,IBM,120.34772128671646,121.54415145823415,120.23437283721184,121.26078033447266,3951160.0,0.0,0.0,1.5679168701171733,0.0,1.5679168701171733,58.56735592166909,117.70927592657844,123.24466365876258,64.15999347696776,-35.84000652303224,0.041926635054480244,0.22404280465827883,-0.007272121072892879,-106702771.0,1.0
2860,2014-05-13,IBM,121.39932204930436,121.5504499738335,120.7507393297701,121.0215072631836,2329024.0,0.0,0.0,-0.2392730712890625,0.2392730712890625,0.0,56.31023490458166,117.70927592657844,123.24466365876258,59.837386229459725,-40.16261377054028,0.10454133837205859,0.20014251140103478,-0.016089334757977358,-109031795.0,-1.0
2861,2014-05-14,IBM,120.84521356877264,120.89558620204386,118.49014220725788,118.83647918701172,5493069.0,0.0,0.0,-2.185028076171875,2.185028076171875,0.0,40.047708831036616,117.70927592657844,123.24466365876258,20.36358273295715,-79.63641726704286,-0.02189714616862659,0.15573457988710251,-0.019176581444412477,-114524864.0,-1.0
2862,2014-05-15,IBM,119.05688100415902,119.06317255845704,117.23705394865966,117.41336822509766,4395501.0,0.0,0.0,-1.4231109619140625,1.4231109619140625,0.0,32.9059558269786,117.23705394865966,123.24466365876258,2.9348490488902255,-97.06515095110979,-0.23423361795637732,0.07774094031840653,-0.02034251461678216,-118920365.0,-1.0
2863,2014-05-16,IBM,117.29371336913962,118.01156354319238,117.07960959234092,117.79116821289062,4131177.0,0.0,0.0,0.37779998779296875,0.0,0.37779998779296875,36.38118773088776,117.07960959234092,123.24466365876258,11.541806655439675,-88.45819334456031,-0.3677868818071488,-0.011364624106704562,-0.016265544873898308,-114789188.0,1.0
2864,2014-05-19,IBM,117.5078134222202,117.8352556333485,117.14888329066632,117.7533950805664,3421152.0,0.0,0.0,-0.03777313232421875,0.03777313232421875,0.0,36.16508597809102,117.07960959234092,123.24466365876258,10.929109152429078,-89.07089084757092,-0.4712445676670285,-0.10334061281876937,-0.010215241462705249,-118210340.0,-1.0
2865,2014-05-20,IBM,117.2811464799354,117.56450766075888,116.30511123433376,116.42475128173828,3165719.0,0.0,0.0,-1.328643798828125,1.328643798828125,0.0,29.14009395477167,116.30511123433376,123.16953935782628,1.7428989750080632,-98.25710102499194,-0.6529195297977992,-0.21325639621457537,-0.023295890937020003,-121376059.0,-1.0
2866,2014-05-21,IBM,117.02925780143272,117.85416503597386,116.4625254153984,117.36929321289062,3125448.0,0.0,0.0,0.9445419311523438,0.0,0.9445419311523438,38.87894570180345,116.30511123433376,121.5504499738335,20.288145940758742,-79.71185405924126,-0.7124687104090555,-0.3130988590534714,-0.01333956224214028,-118250611.0,1.0
2867,2014-05-22,IBM,117.40706480406676,117.40706480406676,116.51290027670764,116.92220306396484,2320028.0,0.0,0.0,-0.44709014892578125,0.44709014892578125,0.0,36.16432410158181,116.30511123433376,121.5504499738335,11.764575374019286,-88.23542462598071,-0.7866700608260402,-0.40781309940798527,-0.023148083521418505,-120570639.0,-1.0
2868,2014-05-23,IBM,117.02294639780982,117.21186387760729,116.68921261932633,117.08592224121094,2680793.0,0.0,0.0,0.16371917724609375,0.0,0.16371917724609375,37.99361835226593,116.30511123433376,121.5504499738335,14.885807107123874,-85.11419289287613,-0.8227799017333979,-0.49080645987306787,-0.03442875826583203,-117889846.0,1.0
2869,2014-05-27,IBM,116.36804664815412,116.90329099465649,115.82020914470858,116.35545349121094,5014315.0,0.0,0.0,-0.73046875,0.73046875,0.0,33.1091418241095,115.82020914470858,121.5504499738335,9.340695486686764,-90.65930451331323,-0.8999656898888162,-0.5726383058762176,-0.03855557476924709,-122904161.0,-1.0
2870,2014-05-28,IBM,116.16653668181212,116.41841990109296,115.19680337326729,115.28496551513672,3892794.0,0.0,0.0,-1.0704879760742188,1.0704879760742188,0.0,27.196870419695614,115.19680337326729,121.5504499738335,1.3875833424788793,-98.61241665752112,-1.0355779187014207,-0.6652262284412582,-0.02988571940343354,-126796955.0,-1.0
2871,2014-05-29,IBM,115.63762158841172,115.72577370092226,114.81271440125772,115.7131805419922,2886855.0,0.0,0.0,0.42821502685548296,0.0,0.42821502685548296,32.740427896497906,114.81271440125772,121.5504499738335,13.364521819461078,-86.63547818053893,-1.09586575487441,-0.7513541337278886,-0.014480358657678272,-123910100.0,1.0
2872,2014-05-30,IBM,115.47389085079207,116.22322897152564,114.91346014867634,116.09099578857422,4833043.0,0.0,0.0,0.37781524658201704,0.0,0.37781524658201704,37.57918088432273,114.81271440125772,121.5504499738335,18.971973202976592,-81.02802679702341,-1.1004722079336346,-0.8211777485690379,-0.014433785232892737,-119077057.0,1.0
2873,2014-06-02,IBM,116.34287264879768,117.30001298021924,116.28619841135216,116.9284896850586,3347723.0,0.0,0.0,0.837493896484375,0.0,0.837493896484375,47.27993255621349,114.81271440125772,121.5504499738335,31.401874724983177,-68.59812527501683,-1.0247316286117467,-0.8618885245775798,-0.007005364006221759,-115729334.0,1.0
2874,2014-06-03,IBM,116.8403135886454,116.97254674859904,115.93984767954396,116.0972671508789,2632887.0,0.0,0.0,-0.8312225341796875,0.8312225341796875,0.0,40.136611176999615,114.81271440125772,120.89558620204386,21.117537763251423,-78.88246223674858,-1.0200212158739674,-0.8935150628368574,-0.0028128394285068525,-118362221.0,-1.0
2875,2014-06-04,IBM,116.31136640713446,116.77733325050278,115.99021582341489,116.1854248046875,2486133.0,0.0,0.0,0.08815765380859375,0.0,0.08815765380859375,41.223334302101335,114.81271440125772,119.06317255845704,32.295586797030715,-67.70441320296928,-0.9976740287713284,-0.9143468560237517,-0.010086696237113446,-115876088.0,1.0
2876,2014-06-05,IBM,116.27991574020228,117.18038190296622,115.81393869717104,117.11111450195312,2983401.0,0.0,0.0,0.925689697265625,0.0,0.925689697265625,51.82016972851362,114.81271440125772,118.01156354319238,71.85084381020027,-28.149156189799733,-0.8949518518718236,-0.9104678551933661,0.0016157020055884708,-112892687.0,1.0
2877,2014-06-06,IBM,117.41965524570516,118.16270185018034,117.06073515238944,117.356689453125,3448348.0,0.0,0.0,0.245574951171875,0.0,0.245574951171875,54.34001322514156,114.81271440125772,118.16270185018034,75.9398383025417,-24.06016169745831,-0.7846826077474418,-0.8853108057041813,0.0023125513873158976,-109444339.0,1.0
2878,2014-06-09,IBM,117.26221466064452,118.15637900658209,117.09849357895985,117.26221466064452,2853906.0,0.0,0.0,-0.09447479248048296,0.09447479248048296,0.0,53.10707734585464,114.81271440125772,118.16270185018034,73.11968467746269,-26.880315322537314,-0.6968835240558633,-0.8476253493745177,0.007793026817622062,-112298245.0,-1.0
2879,2014-06-10,IBM,117.24961966949196,117.26221282554724,115.7509436452787,116.0468978881836,4346025.0,0.0,0.0,-1.2153167724609233,1.2153167724609233,0.0,39.72770638135879,114.81271440125772,118.16270185018034,36.841436146956156,-63.158563853043844,-0.7171017221113516,-0.8215206239218845,0.006609121750110969,-116644270.0,-1.0
2880,2014-06-11,IBM,115.61869100735598,115.99021420671468,114.61117830262964,114.7623062133789,4248538.0,0.0,0.0,-1.2845916748046875,1.2845916748046875,0.0,30.39004443004768,114.61117830262964,118.16270185018034,4.255298007343689,-95.74470199265632,-0.827244640833058,-0.8226654273041194,-0.008217510953890228,-120892808.0,-1.0
2881,2014-06-12,IBM,114.90716589232107,114.95124697292545,113.91854765822872,114.1137466430664,4628864.0,0.0,0.0,-0.6485595703125,0.6485595703125,0.0,26.730074628868834,113.91854765822872,118.16270185018034,4.599243477248135,-95.40075652275186,-0.9558486067985257,-0.8493020632030008,-0.017031890648167014,-125521672.0,-1.0
2882,2014-06-13,IBM,114.60489623790382,115.23459429831028,114.30265041528112,114.95753479003906,2901186.0,0.0,0.0,0.8437881469726562,0.0,0.8437881469726562,37.94845631281201,113.91854765822872,118.16270185018034,24.480428486331192,-75.51957151366881,-0.9784031028044637,-0.8751222711232933,-0.016856070751689378,-122620486.0,1.0
2883,2014-06-16,IBM,114.85676715060087,115.05197614147346,114.126313860809,114.82527923583984,3719785.0,0.0,0.0,-0.13225555419921875,0.13225555419921875,0.0,36.925953326077405,113.91854765822872,118.16270185018034,21.36424683463671,-78.63575316536328,-0.9954744119440306,-0.8991926992874407,-0.010956226156348725,-126340271.0,-1.0
2884,2014-06-17,IBM,114.54192884626592,115.11495266614594,114.32783512687485,114.76861572265624,2574101.0,0.0,0.0,-0.05666351318360796,0.05666351318360796,0.0,36.44056088516721,113.91854765822872,118.16270185018034,20.029151298026342,-79.97084870197367,-1.0020250977980112,-0.9197591789895548,-0.01219437880795271,-128914372.0,-1.0
2885,2014-06-18,IBM,114.6301152602992,115.61873357123063,114.47268568887787,115.61244201660156,4112663.0,0.0,0.0,0.8438262939453267,0.0,0.8438262939453267,48.151571027397395,113.91854765822872,118.16270185018034,39.91123511923887,-60.08876488076113,-0.9284245336618113,-0.9214922499240062,-0.012797013261508727,-124801709.0,1.0
2886,2014-06-19,IBM,115.93987478939655,116.16027014112272,114.83160647665107,115.12126922607422,3714451.0,0.0,0.0,-0.49117279052734375,0.49117279052734375,0.0,42.84902552973622,113.91854765822872,118.16270185018034,28.338309906983937,-71.66169009301606,-0.8993618124728187,-0.9170661624337688,-0.019048085264399495,-128516160.0,-1.0
2887,2014-06-20,IBM,114.97642523996788,115.02679787118534,114.22708712378412,114.32154083251952,11178393.0,0.0,0.0,-0.7997283935547017,0.7997283935547017,0.0,35.503803254964154,113.91854765822872,118.16270185018034,9.495252907045952,-90.50474709295405,-0.9301387339618543,-0.9196806767393859,-0.025077761294508005,-139694553.0,-1.0
2888,2014-06-23,IBM,114.5545346652993,114.76233685436208,113.9752091776829,114.6930694580078,3380358.0,0.0,0.0,0.37152862548828125,0.0,0.37152862548828125,40.93152326475462,113.91854765822872,118.16270185018034,18.249143757496846,-81.75085624250316,-0.9140142238762934,-0.9185473861667673,-0.01166621818258573,-136314195.0,1.0
2889,2014-06-24,IBM,114.29007389694613,115.23462120812836,113.7548394659759,113.89966583251952,4053668.0,0.0,0.0,-0.7934036254882812,0.7934036254882812,0.0,33.90156315472838,113.7548394659759,118.16270185018034,3.2856372073365203,-96.71436279266348,-0.9542564014963375,-0.9256891892326814,-0.0075167571071242945,-140367863.0,-1.0
2890,2014-06-25,IBM,113.50294248686124,113.95632634764937,113.3833024549661,113.79889678955078,2889889.0,0.0,0.0,-0.10076904296873579,0.10076904296873579,0.0,33.06922494899274,113.3833024549661,118.16270185018034,8.695534736034604,-91.3044652639654,-0.9829490124440525,-0.9371411538749557,-0.002759087864325771,-143257752.0,-1.0
2891,2014-06-26,IBM,113.89334547119888,114.20819452307668,112.88583252535214,113.57850646972656,3408391.0,0.0,0.0,-0.22039031982421875,0.22039031982421875,0.0,31.139878131290573,112.88583252535214,118.15637900658209,13.142355291642854,-86.85764470835714,-1.01180827431277,-0.9520745779625187,-0.011995980279423946,-146666143.0,-1.0
2892,2014-06-27,IBM,113.2006628268734,114.8945478322984,113.13139544390928,114.42227935791016,4785973.0,0.0,0.0,0.8437728881835938,0.0,0.8437728881835938,45.25053224858761,112.88583252535214,117.26221282554724,35.107708360937465,-64.89229163906253,-0.9555787103455629,-0.9527754044391276,-0.0035096790585805726,-141880170.0,1.0
2893,2014-06-30,IBM,114.18302789372768,114.56085285136656,113.5092586458583,114.14524841308594,4418095.0,0.0,0.0,-0.27703094482421875,0.27703094482421875,0.0,41.990784658543966,112.88583252535214,116.16027014112272,38.46205167165518,-61.53794832834482,-0.9227337574188255,-0.9467670750350672,-0.005431513708213487,-146298265.0,-1.0
2894,2014-07-01,IBM,114.41597579237178,117.9233958002607,114.41597579237178,117.34407043457033,6948683.0,0.0,0.0,3.198822021484389,0.0,3.198822021484389,70.40008191415511,112.88583252535214,117.9233958002607,88.49988905199618,-11.500110948003831,-0.6313083623018088,-0.8836753324884157,0.014977872517562663,-139349582.0,1.0
2895,2014-07-02,IBM,117.33779320812536,119.0064922196848,117.2307463368882,118.62867736816406,5327278.0,0.0,0.0,1.2846069335937358,0.0,1.2846069335937358,75.87480773715201,112.88583252535214,119.0064922196848,93.82722009736023,-6.172779902639769,-0.29331345846419765,-0.7656029576835721,0.030467073249531573,-134022304.0,1.0
2896,2014-07-03,IBM,118.628660038168,118.89313642583964,117.97377569765185,118.71681213378906,2533830.0,0.0,0.0,0.088134765625,0.0,0.088134765625,76.22294840987404,112.88583252535214,119.0064922196848,95.26717542940732,-4.732824570592683,-0.018129339299804315,-0.6161082340068186,0.038446571567020804,-131488474.0,1.0
2897,2014-07-07,IBM,118.13752666850895,118.55312103952268,118.03047978582975,118.40829467773438,3094800.0,0.0,0.0,-0.3085174560546875,0.3085174560546875,0.0,72.02490367944164,112.88583252535214,119.0064922196848,90.22658386800497,-9.773416131995043,0.1730662771043825,-0.45827333178457835,0.03239276128264068,-134583274.0,-1.0
2898,2014-07-08,IBM,118.16272054118204,118.43348856771568,117.35670801663149,117.89195251464844,3279315.0,0.0,0.0,-0.5163421630859375,0.5163421630859375,0.0,65.10094646863229,112.88583252535214,119.0064922196848,81.79052976808437,-18.20947023191564,0.279701458974273,-0.31067837363280804,0.0350509077699952,-137862589.0,-1.0
2899,2014-07-09,IBM,118.18158315637676,118.94980594000424,117.68411827521696,118.6475601196289,3461842.0,0.0,0.0,0.7556076049804688,0.0,0.7556076049804688,69.97472045859206,112.88583252535214,119.0064922196848,94.13572853285335,-5.864271467146649,0.420336450762818,-0.1644754087536828,0.04260729644018246,-134400747.0,1.0
2900,2014-07-10,IBM,117.40072626328242,118.41454046916868,117.25588991935464,118.19414520263672,3323979.0,0.0,0.0,-0.4534149169921875,0.4534149169921875,0.0,63.80515086867583,112.88583252535214,119.0064922196848,86.72778658483065,-13.272213415169357,0.4895605512272567,-0.033668216757494866,0.040638311564172636,-137724726.0,-1.0
2901,2014-07-11,IBM,118.21306445704975,118.60348248914786,117.5707732255898,118.38308715820312,2513015.0,0.0,0.0,0.18894195556640625,0.0,0.18894195556640625,65.27715654984678,112.88583252535214,119.0064922196848,89.81474068785576,-10.185259312144247,0.5532892127049536,0.08372326913499487,0.034615704411058434,-135211711.0,1.0
2902,2014-07-14,IBM,118.72940151821184,119.9195199981697,118.71679831275756,119.5542984008789,4708151.0,0.0,0.0,1.1712112426757812,0.0,1.1712112426757812,73.10146657884067,112.88583252535214,119.9195199981697,94.80753731663177,-5.192462683368236,0.6903437421934484,0.2050473637466856,0.04738743016457314,-130503560.0,1.0
2903,2014-07-15,IBM,119.35285181526132,119.69288725614038,118.51535134860298,118.69166564941406,5088476.0,0.0,0.0,-0.8626327514648438,0.8626327514648438,0.0,61.35245502126101,112.88583252535214,119.9195199981697,82.5432342067967,-17.456765793203303,0.7210414732463022,0.308246185646609,0.01148413558395478,-135592036.0,-1.0
2904,2014-07-16,IBM,121.05301923395784,121.75827632163666,120.12106518923515,121.12857818603516,8171980.0,0.0,0.0,2.4369125366210938,0.0,2.4369125366210938,74.63882853395852,112.88583252535214,121.75827632163666,92.90276557327759,-7.097234426722407,0.9312729865566496,0.4328515458286172,0.02107332622543412,-127420056.0,1.0
2905,2014-07-17,IBM,121.1286039035387,123.38922209736964,120.9019169487716,121.21046447753906,9280426.0,0.0,0.0,0.08188629150390625,0.0,0.08188629150390625,74.97242579133149,113.13139544390928,123.38922209736964,78.76004641689282,-21.23995358310719,1.0919037283692603,0.5646619823367459,0.021005048054522746,-118139630.0,1.0
2906,2014-07-18,IBM,120.87664476897008,121.808598427095,119.642445377509,121.21669006347656,8542054.0,0.0,0.0,0.0062255859375,0.0,0.0062255859375,75.00127195141766,113.5092586458583,123.38922209736964,78.01072802996308,-21.98927197003693,1.2058073052673848,0.6928910469228737,0.023717894032556197,-109597576.0,1.0
2907,2014-07-21,IBM,120.46107256683298,120.71294573226872,119.17018867386253,120.1777114868164,4345502.0,0.0,0.0,-1.0389785766601562,1.0389785766601562,0.0,61.37864624816692,114.41597579237178,123.38922209736964,64.21015871631086,-35.78984128368914,1.1984251237273043,0.7939978622837599,0.01938859204052923,-113943078.0,-1.0
2908,2014-07-22,IBM,120.6437262043388,122.61468149129924,120.62484148842248,122.2179718017578,5076238.0,0.0,0.0,2.040260314941392,0.0,2.040260314941392,72.63898206069877,117.2307463368882,123.38922209736964,80.9814905316721,-19.01850946832791,1.341739905493469,0.9035462709257018,0.030092584108168285,-108866840.0,1.0
2909,2014-07-23,IBM,122.23055488400992,122.72801986891454,121.89051947107018,121.92829895019533,3749073.0,0.0,0.0,-0.2896728515624716,0.2896728515624716,0.0,69.32766663370055,117.25588991935464,123.38922209736964,76.1805963744959,-23.81940362550409,1.4156252773452422,1.0059620722096099,0.03159339018998475,-112615913.0,-1.0
2910,2014-07-24,IBM,122.12977384654182,123.18136770192694,122.00383223592718,122.94207763671876,3778884.0,0.0,0.0,1.0137786865234375,0.0,1.0137786865234375,74.09613253099911,117.25588991935464,123.38922209736964,92.70959981176838,-7.290400188231614,1.5382514294036866,1.1124199436484252,0.03851048817829161,-108837029.0,1.0
2911,2014-07-25,IBM,122.97987158624548,123.3576863812985,122.02902294476915,122.41313934326172,3531714.0,0.0,0.0,-0.5289382934570455,0.5289382934570455,0.0,67.75478444075962,117.25588991935464,123.38922209736964,84.08560427223065,-15.914395727769342,1.5746016114027128,1.2048562771992828,0.02391248981108829,-112368743.0,-1.0
2912,2014-07-28,IBM,122.3502137605895,123.67257602815808,121.94091091466572,123.28215789794922,3391550.0,0.0,0.0,0.8690185546875,0.0,0.8690185546875,72.25597559685191,117.25588991935464,123.67257602815808,93.91558004258273,-6.084419957417266,1.6544603382841245,1.2947770894162511,0.03867577578778225,-108977193.0,1.0
2913,2014-07-29,IBM,122.97987277010049,123.35138596529032,122.50130266823776,122.52018737792967,3414249.0,0.0,0.0,-0.7619705200195455,0.7619705200195455,0.0,63.31426213113001,117.25588991935464,123.67257602815808,82.04075077558535,-17.95924922441465,1.6373894949185939,1.36329957051672,0.011488694185423531,-112391442.0,-1.0
2914,2014-07-30,IBM,122.9169405752347,123.4144056138059,121.4686365988672,122.16130065917967,4125215.0,0.0,0.0,-0.35888671875,0.35888671875,0.0,59.324489784942514,117.5707732255898,123.67257602815808,75.23231382793458,-24.767686172065428,1.576726053237138,1.4059848670608037,0.007844505717712336,-116516657.0,-1.0
2915,2014-07-31,IBM,121.43079076720922,122.34384972291932,120.61218549309656,120.6940460205078,4401045.0,0.0,0.0,-1.467254638671875,1.467254638671875,0.0,45.73046169239842,118.51535134860298,123.67257602815808,42.24548681273999,-57.75451318726002,1.3941833735842692,1.4036245683654969,-0.004311650835335246,-120917702.0,-1.0
2916,2014-08-01,IBM,119.95729375404812,120.58699162549208,118.92458482270324,119.1072006225586,5419431.0,0.0,0.0,-1.5868453979492045,1.5868453979492045,0.0,35.56159752943712,118.51535134860298,123.67257602815808,11.476119632753221,-88.52388036724678,1.1086915173408016,1.3446379581605579,-0.008907732149444736,-126337133.0,-1.0
2917,2014-08-04,IBM,119.23319616985522,119.6110110435535,118.76091752732604,119.41580200195312,2223691.0,0.0,0.0,0.30860137939453125,0.0,0.30860137939453125,38.624096230992514,118.76091752732604,123.67257602815808,13.333265627407616,-86.66673437259237,0.8969986742830542,1.2551101013850572,-0.022927641152071354,-124113442.0,1.0
2918,2014-08-05,IBM,118.85540752017766,119.13877881234204,117.40081177217456,117.81640625,3460063.0,0.0,0.0,-1.599395751953125,1.599395751953125,0.0,30.076186926705503,117.40081177217456,123.67257602815808,6.62643653145832,-93.37356346854168,0.5933331255859144,1.1227547062252288,-0.03372385849387538,-127573505.0,-1.0
2919,2014-08-06,IBM,117.4110004767077,118.37380147318318,116.82824878047695,117.79737854003906,4023962.0,1.051625,0.0,-0.0190277099609375,0.0190277099609375,0.0,29.985093827379387,116.82824878047695,123.67257602815808,14.159605823793012,-85.84039417620698,0.3471390108481103,0.967631567149805,-0.041846528020144214,-131597467.0,-1.0
2920,2014-08-07,IBM,118.22174656752593,118.24708183245583,116.28347748228018,116.73953247070312,2833196.0,0.0,0.0,-1.0578460693359375,1.0578460693359375,0.0,25.107082415026213,116.28347748228018,123.67257602815808,6.171997647498756,-93.82800235250124,0.06590930276352935,0.7872871142725499,-0.04634802197702892,-134430663.0,-1.0
2921,2014-08-08,IBM,116.80287382594685,118.24073595923036,116.2834705961152,118.21540069580078,2909449.0,0.0,0.0,1.4758682250976562,0.0,1.4758682250976562,40.64996005850184,116.2834705961152,123.67257602815808,26.145656161675074,-73.85434383832494,-0.037445388494518284,0.6223406137191363,-0.04109886855113787,-131521214.0,1.0
2922,2014-08-11,IBM,118.96284463489118,119.31121968094344,117.9937050693316,118.74747467041016,2643451.0,0.0,0.0,0.532073974609375,0.0,0.532073974609375,45.366485269864555,116.2834705961152,123.67257602815808,33.34644629118161,-66.6535537088184,-0.07554991058263738,0.4827625088587815,-0.030792580294397465,-128877763.0,1.0
2923,2014-08-12,IBM,118.73480001289596,119.52024370253848,118.32941559169804,118.66512298583984,1944096.0,0.0,0.0,-0.0823516845703125,0.0823516845703125,0.0,44.73164510939651,116.2834705961152,123.67257602815808,32.2319448765287,-67.7680551234713,-0.11111227838854631,0.36398755140931593,-0.028619355348007414,-130821859.0,-1.0
2924,2014-08-13,IBM,119.08322596286774,119.387269437895,118.68417016562506,119.05155181884766,1877570.0,0.0,0.0,0.3864288330078125,0.0,0.3864288330078125,48.62418378328215,116.2834705961152,123.67257602815808,37.461655516900166,-62.53834448309983,-0.10688206388384458,0.26981362835068384,-0.013608742566978416,-128944289.0,1.0
2925,2014-08-14,IBM,118.8108411373222,119.19089037662027,118.40544652020644,119.00719451904295,2018257.0,0.0,0.0,-0.04435729980470171,0.04435729980470171,0.0,48.174797532207684,116.2834705961152,123.67257602815808,36.861348751586654,-63.138651248413346,-0.10588823810094539,0.19467325506035799,-0.0008396310465943468,-130962546.0,-1.0
2926,2014-08-15,IBM,118.98819776567188,119.64061629849732,118.31677272700117,118.69048309326172,2944281.0,0.0,0.0,-0.3167114257812358,0.3167114257812358,0.0,44.766283876759275,116.2834705961152,123.4144056138059,33.75451453666474,-66.24548546333526,-0.12916762522108627,0.12990507900406914,-0.006073893877793002,-133906827.0,-1.0
2927,2014-08-18,IBM,119.14652974917236,120.229677997651,118.93116989562748,119.94464111328124,2531634.0,0.0,0.0,1.254158020019517,0.0,1.254158020019517,58.26005753917664,116.2834705961152,123.4144056138059,51.3420821825366,-48.6579178174634,-0.045887671935076924,0.09474652881623992,0.018063994065183442,-131375193.0,1.0
2928,2014-08-19,IBM,120.37537978721066,120.50839498773516,119.94464993858662,120.3943862915039,2133945.0,0.0,0.0,0.44974517822267046,0.0,0.44974517822267046,62.09202575016592,116.2834705961152,122.34384972291932,67.83264890486416,-32.16735109513584,0.05576019938007448,0.08694926292900684,0.02204639681843279,-129241248.0,1.0
2929,2014-08-20,IBM,120.26137701758648,120.59709460919656,119.87498888756129,120.41339874267578,2277770.0,0.0,0.0,0.019012451171875,0.0,0.019012451171875,62.26102301563681,116.2834705961152,120.59709460919656,95.74149564348427,-4.258504356515735,0.13628006390135283,0.09681542312347605,0.031470626909480215,-126963478.0,1.0
2930,2014-08-21,IBM,120.92012689735824,121.66122896964912,120.66676411127705,121.12915802001952,2611339.0,0.0,0.0,0.7157592773437358,0.0,0.7157592773437358,68.38364776528167,116.2834705961152,121.66122896964912,90.10608300573469,-9.89391699426532,0.2549099848511247,0.1284343354690058,0.024647865735502483,-124352139.0,1.0
2931,2014-08-22,IBM,120.83779163534076,121.54089086096404,120.53374818048506,120.6097640991211,2029554.0,0.0,0.0,-0.5193939208984233,0.5193939208984233,0.0,60.205391957701345,116.2834705961152,121.66122896964912,80.44789673513974,-19.552103264860264,0.30351556472754737,0.1634505813207141,0.015682770803167045,-126381693.0,-1.0
2932,2014-08-25,IBM,121.23049365513468,121.49652404091503,120.7997638312321,121.08480072021484,1802886.0,0.0,0.0,0.47503662109375,0.0,0.47503662109375,64.6649541241469,116.2834705961152,121.66122896964912,89.28125420675083,-10.718745793249171,0.3760326519005588,0.20596699543668306,0.02039080796017667,-124578807.0,1.0
2933,2014-08-26,IBM,120.99612755198628,122.58601143840023,120.99612755198628,122.24396514892578,3321468.0,0.0,0.0,1.1591644287109375,0.0,1.1591644287109375,73.13996740341733,116.2834705961152,122.58601143840023,94.57288261934625,-5.427117380653757,0.5210317184785822,0.2689799400450629,0.026815386118912654,-121257339.0,1.0
2934,2014-08-27,IBM,122.26926008366728,122.96602006500908,121.33813381889904,121.7751922607422,2290949.0,0.0,0.0,-0.46877288818357954,0.46877288818357954,0.0,65.7782004814884,116.2834705961152,122.96602006500908,82.18003757682644,-17.81996242317356,0.5913023041364198,0.3334444128633343,0.023259079023632667,-123548288.0,-1.0
2935,2014-08-28,IBM,121.28114957828436,121.80689163520064,120.76807515203006,121.61686706542967,1572766.0,0.0,0.0,-0.15832519531252842,0.15832519531252842,0.0,63.2954380568395,117.9937050693316,122.96602006500908,72.8667029190177,-27.1332970809823,0.6269891883831775,0.392153367967303,0.02465559070872203,-125121054.0,-1.0
2936,2014-08-29,IBM,121.7942400214807,122.09194454594972,121.0721344295792,121.8069076538086,3043232.0,0.0,0.0,0.19004058837892046,0.0,0.19004058837892046,65.11886363051204,118.31677272700117,122.96602006500908,75.06881594092317,-24.93118405907683,0.6629637550183105,0.4463154453775045,0.015526050378261935,-122077822.0,1.0
2937,2014-09-02,IBM,122.04759307654338,122.23128889545966,120.93910962198886,121.33816528320312,2802966.0,0.0,0.0,-0.46874237060546875,0.46874237060546875,0.0,57.052489710433974,118.31677272700117,122.96602006500908,64.98670293365277,-35.013297066347235,0.6462012605101677,0.4862926084040372,0.007839061444394169,-124880788.0,-1.0
2938,2014-09-03,IBM,121.863913200209,122.21862711385673,121.52819567953128,121.585205078125,1906649.0,0.0,0.0,0.247039794921875,0.0,0.247039794921875,60.06098605400396,118.31677272700117,122.96602006500908,70.30024676046335,-29.699753239536648,0.6454110132908681,0.5181162893814035,0.009731527784157867,-122974139.0,1.0
2939,2014-09-04,IBM,121.42053033157372,122.05395244335725,120.38805249156349,120.78076934814452,2996790.0,0.0,0.0,-0.804435729980483,0.804435729980483,0.0,47.54674246887035,118.31677272700117,122.96602006500908,52.997753012622354,-47.002246987377646,0.5732652512455019,0.5291460817542232,-0.0028761751304952066,-125970929.0,-1.0
2940,2014-09-05,IBM,120.68576978769462,121.45854605886272,120.40707171255804,121.11016082763672,2364169.0,0.0,0.0,0.3293914794922017,0.0,0.3293914794922017,52.24759188299464,118.93116989562748,122.96602006500908,54.00425890766608,-45.99574109233392,0.5364840998447136,0.5306136853723212,0.004148890699300134,-123606760.0,1.0
2941,2014-09-08,IBM,120.8250858288406,121.11012268652588,120.0396421702456,120.4386978149414,2640313.0,0.0,0.0,-0.6714630126953125,0.6714630126953125,0.0,43.151455481995434,119.87498888756129,122.96602006500908,18.236921435569737,-81.76307856443026,0.4479891785054946,0.5140887839989559,-0.005335953822696249,-126247073.0,-1.0
2942,2014-09-09,IBM,120.56542589212296,120.818798815286,120.21071188757028,120.3437271118164,2514166.0,0.0,0.0,-0.094970703125,0.094970703125,0.0,41.959296035345005,119.87498888756129,122.96602006500908,15.164461221712699,-84.8355387782873,0.36597425038640097,0.48446587727644486,-0.015544636782636845,-128761239.0,-1.0
2943,2014-09-10,IBM,120.42607584858058,121.71192679566786,120.41340821298051,121.3255386352539,2891144.0,0.0,0.0,0.9818115234375,0.0,0.9818115234375,56.34570128960821,120.0396421702456,122.96602006500908,43.941572525862696,-56.058427474137304,0.3758680407623274,0.46274630997362143,-0.0036924895550606296,-125870095.0,1.0
2944,2014-09-11,IBM,121.03410690029732,122.11092619791526,120.42602023294413,121.43949127197266,2404231.0,0.0,0.0,0.11395263671875,0.0,0.11395263671875,57.74822039086256,120.0396421702456,122.96602006500908,47.835554807599415,-52.16444519240058,0.3884264282792884,0.4478823336347549,-0.0014584802070389813,-123465864.0,1.0
2945,2014-09-12,IBM,121.28118284533372,121.36352752214408,120.7111089796514,121.16083526611328,3034446.0,0.0,0.0,-0.278656005859375,0.278656005859375,0.0,52.9483841968805,120.0396421702456,122.96602006500908,38.31333943145104,-61.686660568548966,0.37161013964677636,0.4326278948371592,-0.005304070188954624,-126500310.0,-1.0
2946,2014-09-15,IBM,121.24950985151052,121.92727377852869,120.71743888320742,121.49654388427734,2569394.0,0.0,0.0,0.3357086181640625,0.0,0.3357086181640625,57.82164282671618,120.0396421702456,122.96602006500908,49.785153060332895,-50.214846939667105,0.38098028601733347,0.42229837307319407,0.0013052661601118398,-123930916.0,1.0
2947,2014-09-16,IBM,121.14178935858769,122.61132542907043,120.86942014847136,122.22493743896484,2679329.0,0.0,0.0,0.7283935546875,0.0,0.7283935546875,66.50640918352605,120.0396421702456,122.96602006500908,74.67577145896497,-25.32422854103502,0.4420853818551791,0.42625577482959115,0.0052615970868230555,-121251587.0,1.0
2948,2014-09-17,IBM,122.3896341771564,122.65567464335304,121.8068928314585,122.12360382080078,3358497.0,0.0,0.0,-0.1013336181640625,0.1013336181640625,0.0,64.37853981219055,120.0396421702456,122.65567464335304,79.66115375011995,-20.338846249880053,0.4768381411696936,0.43637224809761166,0.011117949321763465,-124610084.0,-1.0
2949,2014-09-18,IBM,122.11728549503916,122.96606744972958,122.06661496336888,122.72537231445312,3099612.0,0.0,0.0,0.6017684936523438,0.0,0.6017684936523438,70.78370588109036,120.0396421702456,122.96606744972958,91.7751142677767,-8.224885732223303,0.546636357890705,0.4584250700562304,0.013336713251625332,-121510472.0,1.0
2950,2014-09-19,IBM,123.22579211088171,123.51715780835806,122.37067119521063,122.88373565673828,9259192.0,0.0,0.0,0.15836334228515625,0.0,0.15836334228515625,72.29632366068992,120.0396421702456,123.51715780835806,81.78521054865497,-18.214789451345027,0.6077250694311687,0.4882850699312181,0.020301098286148678,-112251280.0,1.0
2951,2014-09-22,IBM,122.70639549628945,122.97243607160644,122.01597395080024,122.32000732421876,3470628.0,0.0,0.0,-0.563728332519517,0.563728332519517,0.0,59.61841522584976,120.0396421702456,123.51715780835806,65.57454778868824,-34.42545221131177,0.6036911722384559,0.5113662903926658,0.01642196282126207,-115721908.0,-1.0
2952,2014-09-23,IBM,122.0919109329391,122.29460310422476,121.31280626497777,121.37614440917967,3453683.0,0.0,0.0,-0.9438629150390909,0.9438629150390909,0.0,44.53188303525704,120.0396421702456,123.51715780835806,38.4326737250707,-61.5673262749293,0.5183571322440343,0.5127644587629395,0.0004171073501508804,-119175591.0,-1.0
2953,2014-09-24,IBM,120.98344945988433,121.90190832015644,120.27401156800036,121.81322479248048,3224400.0,0.0,0.0,0.43708038330080967,0.0,0.43708038330080967,51.138459298158,120.0396421702456,123.51715780835806,51.00142765130895,-48.99857234869105,0.48045958581947446,0.5063034841742465,0.003077528706628252,-115951191.0,1.0
2954,2014-09-25,IBM,121.64856311141544,121.933610150952,119.69762615778768,119.72296142578124,4342364.0,0.0,0.0,-2.090263366699247,2.090263366699247,0.0,30.857700772436402,119.69762615778768,123.51715780835806,0.6633082354421954,-99.3366917645578,0.27854779699437415,0.46075234673827203,-0.011867480421160481,-120293555.0,-1.0
2955,2014-09-26,IBM,119.67228710158604,120.55908211235104,119.46959485421009,120.38805389404295,2608619.0,0.0,0.0,0.6650924682617188,0.0,0.6650924682617188,39.64541190014326,119.46959485421009,123.51715780835806,22.691655453848426,-77.30834454615157,0.17023627561671617,0.4026491325139609,-0.009123633930609554,-117684936.0,1.0
2956,2014-09-29,IBM,119.40623492533317,120.32470398538976,119.15920092955466,120.12200164794922,2443770.0,0.0,0.0,-0.2660522460937358,0.2660522460937358,0.0,37.44856428089441,119.15920092955466,123.51715780835806,22.092938162777873,-77.90706183722213,0.06221326601004762,0.3345619592131783,-0.017205456063872138,-120128706.0,-1.0
2957,2014-09-30,IBM,120.1220205437494,120.88846802621276,119.811648337349,120.24237823486328,3067500.0,0.0,0.0,0.1203765869140625,0.0,0.1203765869140625,39.20722463215177,119.15920092955466,123.51715780835806,24.855163450034848,-75.14483654996515,-0.013526438469398272,0.26494427967666295,-0.015404275071164264,-117061206.0,1.0
2958,2014-10-01,IBM,120.2930416108507,120.60341379877364,118.31676945139866,118.55746459960938,3894467.0,0.0,0.0,-1.6849136352539062,1.6849136352539062,0.0,26.963675888644573,118.31676945139866,123.51715780835806,4.62840718210226,-95.37159281789775,-0.20712158025024507,0.17053110769128133,-0.03396125541313921,-120955673.0,-1.0
2959,2014-10-02,IBM,118.86784047859696,118.94384627608244,117.96837788262928,118.39276885986328,2388123.0,0.0,0.0,-0.16469573974609375,0.16469573974609375,0.0,26.046315185422642,117.96837788262928,123.51715780835806,7.648365639195139,-92.35163436080485,-0.3695764474343548,0.06250959666615408,-0.036546470310928725,-123343796.0,-1.0
2960,2014-10-03,IBM,119.15288491325433,119.95099638649832,118.8044997114912,119.50759887695312,3212789.0,0.0,0.0,1.1148300170898438,0.0,1.1148300170898438,41.57215491143652,117.96837788262928,123.51715780835806,27.739809740637334,-72.26019025936267,-0.4037118953186365,-0.03073470173080407,-0.022992219415186366,-120131007.0,1.0
2961,2014-10-06,IBM,120.15371258815507,120.91382131178094,119.53295797301442,119.7419891357422,2196077.0,0.0,0.0,0.2343902587890767,0.0,0.2343902587890767,44.40367828846529,117.96837788262928,123.51715780835806,31.963986260997203,-68.0360137390028,-0.4071576883123811,-0.1060192990471195,-0.013463562229563464,-117934930.0,1.0
2962,2014-10-07,IBM,118.93749154827049,119.15919025947755,117.52496473298348,117.63264465332033,3128900.0,0.0,0.0,-2.109344482421875,2.109344482421875,0.0,29.539081597275114,117.52496473298348,123.51715780835806,1.7970035174495465,-98.20299648255045,-0.5734842063404102,-0.19951228050577768,-0.03431959170510546,-121063830.0,-1.0
2963,2014-10-08,IBM,117.7973410093768,120.09666280691351,117.5693135238494,119.94464111328124,3122101.0,0.0,0.0,2.311996459960909,0.0,2.311996459960909,50.49717348577401,117.52496473298348,123.51715780835806,40.380480900083455,-59.61951909991654,-0.512828806777577,-0.2621755857601376,0.0018516054469419618,-117941729.0,1.0
2964,2014-10-09,IBM,119.79265223365402,120.03335752694072,117.87338919938796,118.0824203491211,2746168.0,0.0,0.0,-1.862220764160142,1.862220764160142,0.0,39.56105489806041,117.52496473298348,122.97243607160644,10.233291402291854,-89.76670859770815,-0.6080157905086168,-0.33134362670983347,-0.019151680506033553,-120687897.0,-1.0
2965,2014-10-10,IBM,117.72770716706869,118.91854588902198,117.2463167554503,117.77204895019533,5324349.0,0.0,0.0,-0.31037139892576704,0.31037139892576704,0.0,37.97929180127503,117.2463167554503,122.29460310422476,10.414072388596974,-89.58592761140302,-0.7004225042804819,-0.4051594022239632,-0.019563049778683173,-126012246.0,-1.0
2966,2014-10-13,IBM,117.49333133303011,118.22809457497748,116.18214522580205,116.2454833984375,3762148.0,0.0,0.0,-1.5265655517578267,1.5265655517578267,0.0,30.955217376594433,116.18214522580205,121.933610150952,1.1012528713943748,-98.89874712860562,-0.8866162128826431,-0.5014507643556992,-0.0332403175577487,-129774394.0,-1.0
2967,2014-10-14,IBM,117.11327553013211,117.63901776345293,116.28982871160282,116.42284393310548,4105236.0,0.0,0.0,0.17736053466798296,0.0,0.17736053466798296,32.6256398875487,116.18214522580205,121.933610150952,4.184998264544948,-95.81500173545506,-1.0082421674221393,-0.6028090449689874,-0.01800494531249386,-125669158.0,1.0
2968,2014-10-15,IBM,115.5740472410622,116.4165004604317,113.22405466900456,115.12432098388672,7213007.0,0.0,0.0,-1.2985229492187642,1.2985229492187642,0.0,27.089183011642064,113.22405466900456,120.91382131178094,24.711625243754757,-75.28837475624525,-1.1956290945070407,-0.7213730548765981,-0.027606820141568678,-132882165.0,-1.0
2969,2014-10-16,IBM,113.8891544786768,114.95329636924812,113.18605531356184,113.91448974609376,5835216.0,0.0,0.0,-1.2098312377929545,1.2098312377929545,0.0,22.90975866267827,113.18605531356184,120.91382131178094,9.426196816774707,-90.5738031832253,-1.425327565243549,-0.8621639569499884,-0.046801284465752824,-138717381.0,-1.0
2970,2014-10-17,IBM,114.80124899034942,115.81473022935998,114.15515937628167,115.31432342529295,4550309.0,0.0,0.0,1.3998336791991903,0.0,1.3998336791991903,36.07655918929468,113.18605531356184,120.91382131178094,27.54053515882322,-72.45946484117678,-1.4773800614657375,-0.9852071778531382,-0.03697671754416865,-134167072.0,1.0
2971,2014-10-20,IBM,105.6863294387832,107.89063900082353,105.58498838019705,107.11153411865234,24493659.0,0.0,0.0,-8.20278930664061,8.20278930664061,0.0,16.74226984868986,105.58498838019705,120.91382131178094,9.958655986849244,-90.04134401315076,-2.155679254631494,-1.2193015932088096,-0.08944039782217894,-158660731.0,-1.0
2972,2014-10-21,IBM,105.40129483368118,105.57865179989736,102.41155156335948,103.39334869384766,21913491.0,0.0,0.0,-3.7181854248046875,3.7181854248046875,0.0,13.076850574810464,102.41155156335948,120.91382131178094,5.306360483539803,-94.6936395164602,-2.959151485391004,-1.5672715716452488,-0.13799109544045218,-180574222.0,-1.0
2973,2014-10-22,IBM,102.87394087289724,104.77420699658828,102.04415537032656,102.4812240600586,11594701.0,0.0,0.0,-0.9121246337890625,0.9121246337890625,0.0,12.313768331468225,102.04415537032656,120.91382131178094,2.3162502774987805,-97.68374972250122,-3.627692075885008,-1.979355672493201,-0.13212124415248427,-192168923.0,-1.0
2974,2014-10-23,IBM,102.6902584734499,103.1399948540358,102.32287687663948,102.728271484375,7948972.0,0.0,0.0,0.24704742431640625,0.0,0.24704742431640625,13.884221431459878,102.04415537032656,120.91382131178094,3.625480791080226,-96.37451920891978,-4.090428731729588,-2.401570284340479,-0.1277363992553292,-184219951.0,1.0
2975,2014-10-24,IBM,102.66493225097656,102.89296989724424,102.26587647985234,102.66493225097656,6958097.0,0.0,0.0,-0.0633392333984375,0.0633392333984375,0.0,13.811046800533006,102.04415537032656,120.09666280691351,3.438729399949573,-96.56127060005043,-4.411409825648377,-2.803538192602059,-0.11682648435391585,-191178048.0,-1.0
2976,2014-10-27,IBM,102.6142278937951,103.19064047213818,102.4938803478406,102.5318832397461,5218599.0,0.0,0.0,-0.13304901123046875,0.13304901123046875,0.0,13.636850137012331,102.04415537032656,120.09666280691351,2.7017181470927047,-97.2982818529073,-4.623231859379231,-3.167476925957494,-0.11931473432603046,-196396647.0,-1.0
2977,2014-10-28,IBM,102.61424478774131,103.62771606445312,102.4875583506917,103.62771606445312,8258484.0,0.0,0.0,1.0958328247070312,0.0,1.0958328247070312,22.88077587199821,102.04415537032656,120.03335752694072,8.802840061165956,-91.19715993883405,-4.6490860267486624,-3.463798746115728,-0.0998625209788877,-188138163.0,1.0
2978,2014-10-29,IBM,104.09010166352066,104.2737873604579,103.09562695656776,103.53902435302734,4957308.0,0.0,0.0,-0.08869171142578125,0.08869171142578125,0.0,22.65432926421009,102.04415537032656,118.91854588902198,8.858802817468217,-91.14119718253178,-4.623436225721662,-3.6957262420369146,-0.09108117339762922,-193095471.0,-1.0
2979,2014-10-30,IBM,103.56437345117897,104.27380129242798,103.2603300592602,104.102783203125,4075216.0,0.0,0.0,0.5637588500976562,0.0,0.5637588500976562,27.88861192659472,102.04415537032656,118.22809457497748,12.720190101843878,-87.27980989815613,-4.505679279886763,-3.8577168496068848,-0.09722591165729222,-189020255.0,1.0
2980,2014-10-31,IBM,104.81854786377804,104.88822489430574,103.6403772156926,104.13444519042967,6085628.0,0.0,0.0,0.03166198730467329,0.0,0.03166198730467329,28.203471795498572,102.04415537032656,117.63901776345293,13.403708012354324,-86.59629198764569,-4.359547049491681,-3.9580828895838445,-0.027794288941140666,-182934627.0,1.0
2981,2014-11-03,IBM,104.03946143912604,104.22315731724882,103.48838391460242,104.10913848876952,4903857.0,0.0,0.0,-0.02530670166015625,0.02530670166015625,0.0,28.090357887064883,102.04415537032656,116.4165004604317,14.367753525933786,-85.6322464740662,-4.197393306157991,-4.005944972898674,0.006922977193062563,-187838484.0,-1.0
2982,2014-11-04,IBM,104.09644345343668,104.1091110855062,102.76626120740184,103.02596282958984,4442257.0,0.0,0.0,-1.0831756591796733,1.0831756591796733,0.0,23.44628765509684,102.04415537032656,115.81473022935998,7.129749261115411,-92.87025073888458,-4.108923408196816,-4.026540659958302,0.005315498273244845,-192280741.0,-1.0
2983,2014-11-05,IBM,103.33001445264028,103.58971609552223,102.33553954196724,102.50022888183594,4293516.0,0.0,0.0,-0.5257339477539062,0.5257339477539062,0.0,21.459396625004572,102.04415537032656,115.81473022935998,3.311942429260256,-96.68805757073974,-4.03472293801164,-4.02817711556897,-0.0022198621591111856,-196574257.0,-1.0
2984,2014-11-06,IBM,102.85736879903509,103.01681322130985,102.0729315570674,102.97216796875,4254710.0,1.051625,0.0,0.4719390869140625,0.0,0.4719390869140625,27.796972901294254,102.04415537032656,107.89063900082353,15.873004306086685,-84.12699569391332,-3.892961355428838,-4.001133963540943,0.0029926062486689275,-192319547.0,1.0
2985,2014-11-07,IBM,102.94669518053638,103.45051692946286,102.58317113577698,103.36123657226562,3655561.0,0.0,0.0,0.389068603515625,0.0,0.389068603515625,32.94398128522914,102.04415537032656,105.57865179989736,37.2636167042047,-62.73638329579531,-3.7064935448008356,-3.9422058797929216,0.008088735974743466,-188663986.0,1.0
2986,2014-11-10,IBM,103.2527519474335,104.89177984547985,103.06779891732852,104.26677703857422,5186277.0,0.0,0.0,0.9055404663085938,0.0,0.9055404663085938,43.718434136833636,102.04415537032656,104.89177984547985,78.05178272770729,-21.948217272292702,-3.4459244417850527,-3.8429495921913484,0.006166892395115697,-183477709.0,1.0
2987,2014-11-11,IBM,104.40076745979212,104.52831081045451,103.69922813595718,104.14566040039062,3696982.0,0.0,0.0,-0.12111663818359375,0.12111663818359375,0.0,42.660574582855176,102.0729315570674,104.89177984547985,73.53105351017555,-26.46894648982444,-3.2121667915647123,-3.716793032066022,0.005859008727906234,-187174691.0,-1.0
2988,2014-11-12,IBM,103.49510630489117,103.95429271675454,103.16347337060662,103.26551818847656,3533597.0,0.0,0.0,-0.8801422119140625,0.8801422119140625,0.0,35.465070950286105,102.0729315570674,104.89177984547985,42.30758484986841,-57.69241515013158,-3.0626282187919003,-3.5859600694111973,-0.008042676563361106,-190708288.0,-1.0
2989,2014-11-13,IBM,103.31656462547444,103.8267685005458,103.18901111194732,103.82039642333984,3388726.0,0.0,0.0,0.5548782348632812,0.0,0.5548782348632812,42.5178495329966,102.0729315570674,104.89177984547985,61.99215734510496,-38.00784265489504,-2.8663028314304597,-3.4420286218150498,-0.0030158010302502314,-187319562.0,1.0
2990,2014-11-14,IBM,103.38032936614434,104.90456881202712,103.11885027940347,104.69410705566406,5207406.0,0.0,0.0,0.8737106323242188,0.0,0.8737106323242188,52.040500976835645,102.0729315570674,104.90456881202712,92.5674887913546,-7.432511208645397,-2.610124510760386,-3.275647799604117,0.005618801340457225,-182112156.0,1.0
2991,1.0,1.0,1.0,1.0,1.0,1.0,1.0,1.0,1.0,1.0,1.0,1.0,1.0,1.0,1.0,1.0,1.0,1.0,1.0,1.0,1.0,1.0
2992,2014-11-18,IBM,105.05761827512526,105.07037260617705,103.24639129638672,103.24639129638672,5658965.0,0.0,0.0,-1.4477157592773438,1.4477157592773438,0.0,38.11214711247545,102.0729315570674,105.21069315236674,37.39798909761869,-62.60201090238131,-2.2874830073284613,-2.934658391867411,0.007279617057352805,-187771121.0,-1.0
2993,2014-11-19,IBM,103.34844829353776,103.38032903540372,102.65329136370036,102.95303344726562,3977520.0,0.0,0.0,-0.29335784912109375,0.29335784912109375,0.0,35.86762804993958,102.0729315570674,105.21069315236674,28.048717643708,-71.951282356292,-2.2125903209266937,-2.790244777679268,-0.00018582226500452048,-191748641.0,-1.0
2994,2014-11-20,IBM,102.64690836327104,102.99767795354263,101.91348844109314,102.44921112060548,4375523.0,0.0,0.0,-0.503822326660142,0.503822326660142,0.0,32.119176613822276,101.91348844109314,105.21069315236674,16.247783393024864,-83.75221660697514,-2.1688899650927738,-2.6659738151619696,-0.008823670090503333,-196124164.0,-1.0
2995,2014-11-21,IBM,103.20815017084264,103.28467617336752,102.51937543196956,102.62779235839844,4264437.0,0.0,0.0,0.17858123779295454,0.0,0.17858123779295454,34.90161632659033,101.91348844109314,105.21069315236674,21.663923834119107,-78.3360761658809,-2.095689303061704,-2.5519169127419166,-0.01571914589408885,-191859727.0,1.0
2996,2014-11-24,IBM,103.023176009535,104.50277003398902,102.71705170391895,103.4122085571289,6923474.0,0.0,0.0,0.7844161987304688,0.0,0.7844161987304688,46.099374796917175,101.91348844109314,105.21069315236674,45.45426345265838,-54.54573654734162,-1.9518813462661342,-2.4319097994467604,-0.007042557898638724,-184936253.0,1.0
2997,2014-11-25,IBM,103.73108602230222,104.27318071658146,103.03592917694372,103.16348266601562,4249270.0,0.0,0.0,-0.24872589111328125,0.24872589111328125,0.0,43.369943924918154,101.91348844109314,105.21069315236674,37.910725428984804,-62.089274571015196,-1.8368090142072475,-2.312889642398858,-0.0009880889986404462,-189185523.0,-1.0
2998,2014-11-26,IBM,103.27195177827102,103.38036873613012,102.68522171837466,103.28470611572266,4148436.0,0.0,0.0,0.12122344970703125,0.0,0.12122344970703125,45.194733974581375,101.91348844109314,105.21069315236674,41.587277548801666,-58.41272245119833,-1.716050085532558,-2.193521731025598,-0.005159779061455816,-185037087.0,1.0
2999,2014-11-28,IBM,103.79487618671344,104.19029105544584,102.95942155133066,103.42498016357422,2516153.0,0.0,0.0,0.1402740478515625,0.0,0.1402740478515625,47.45538099914775,101.91348844109314,105.21069315236674,45.84160993441139,-54.15839006558861,-1.590692310411427,-2.072955846902764,-0.012122238087527437,-182520934.0,1.0
3000,2014-12-01,IBM,103.0869599366544,104.1583848490219,102.90200686270546,103.02317810058594,4360146.0,0.0,0.0,-0.40180206298828125,0.40180206298828125,0.0,41.76195099162033,101.91348844109314,105.21069315236674,33.65546748427891,-66.3445325157211,-1.5064025678579043,-1.959645191093792,-0.01596010512979229,-186881080.0,-1.0
3001,2014-12-02,IBM,103.61632006624724,103.78213660146316,103.08698971239228,103.7438735961914,3625122.0,0.0,0.0,0.7206954956054688,0.0,0.7206954956054688,53.34609770437268,101.91348844109314,105.21069315236674,55.51323970998601,-44.48676029001399,-1.3657052363746942,-1.8408572001499728,0.0048183989150436535,-183255958.0,1.0
3002,2014-12-03,IBM,103.61633057110724,104.9237365722656,103.31658839753251,104.92373657226562,6724839.0,0.0,0.0,1.1798629760742188,0.0,1.1798629760742188,66.08808609236394,101.91348844109314,105.21069315236674,91.29697409687745,-8.70302590312255,-1.1457885684731082,-1.7018434738145998,0.019141768425982697,-176531119.0,1.0
3003,2014-12-04,IBM,104.59842067574036,104.91092720080076,103.96066347496075,104.62393951416016,4036932.0,0.0,0.0,-0.29979705810546875,0.29979705810546875,0.0,61.18846507681211,101.91348844109314,105.21069315236674,82.20451292573996,-17.795487074260038,-0.9843472000404176,-1.5583442190597634,0.02122738057001272,-180568051.0,-1.0
3004,2014-12-05,IBM,104.34335464685556,104.91095811204757,103.89692243896503,104.1265106201172,3152121.0,0.0,0.0,-0.49742889404295454,0.49742889404295454,0.0,53.58312098200339,101.91348844109314,105.21069315236674,67.11813104771537,-32.88186895228463,-0.8863251029294474,-1.4239403958337002,0.014603434676689897,-183720172.0,-1.0
3005,2014-12-08,IBM,104.1392653238726,104.1392653238726,103.02318490926837,103.22726440429688,2982146.0,0.0,0.0,-0.8992462158203267,0.8992462158203267,0.0,42.55108913351568,101.91348844109314,105.07037260617705,41.61622329176652,-58.38377670823348,-0.8711613334870947,-1.3133845833643794,-0.0017884170100657126,-186702318.0,-1.0
3006,2014-12-09,IBM,102.57677473787,103.96708886250342,102.5512660679014,103.9479522705078,4038815.0,0.0,0.0,0.7206878662109233,0.0,0.7206878662109233,51.739418412510766,101.91348844109314,104.9237365722656,67.58458906914959,-32.41541093085043,-0.7918623529044595,-1.2090801372723954,0.007604140382036606,-182663503.0,1.0
3007,2014-12-10,IBM,103.96069340150947,104.1647830934136,102.06018576080976,102.3663101196289,4260149.0,0.0,0.0,-1.581642150878892,1.581642150878892,0.0,36.82499729519823,101.91348844109314,104.9237365722656,15.042669534335051,-84.95733046566495,-0.8468803333966832,-1.136640176497253,-0.00889188758560977,-186923652.0,-1.0
3008,2014-12-11,IBM,102.56398242203092,103.9096507863806,102.37265728907845,102.72342681884766,4173122.0,0.0,0.0,0.35711669921875,0.0,0.35711669921875,41.23797229946349,102.06018576080976,104.9237365722656,23.161490810100332,-76.83850918989967,-0.8518465890196154,-1.0796814590017254,-0.0067832098552690345,-182750530.0,1.0
3009,2014-12-12,IBM,102.20047496161118,102.35990918909758,99.06270594568164,99.09459686279295,9007838.0,0.0,0.0,-3.6288299560547017,3.6288299560547017,0.0,22.670526364755077,99.06270594568164,104.9237365722656,0.5441179059304677,-99.45588209406954,-1.1355091893323248,-1.0908470050678454,-0.03813298434607926,-191758368.0,-1.0
3010,2014-12-15,IBM,99.4453846503951,99.96196059973266,97.47471290577548,97.61502075195312,6799314.0,0.0,0.0,-1.4795761108398295,1.4795761108398295,0.0,18.70778419712184,97.47471290577548,104.9237365722656,1.8835736394399183,-98.11642636056008,-1.462840555235985,-1.1652457151014735,-0.05907676889041169,-198557682.0,-1.0
3011,2014-12-16,IBM,96.95809529923532,98.7820865283353,95.98233312802402,96.56269073486328,7094600.0,0.0,0.0,-1.0523300170898438,1.0523300170898438,0.0,16.360841884782232,95.98233312802402,104.9237365722656,6.490676888235238,-93.50932311176476,-1.786572760025365,-1.2895111240862518,-0.07968688602358076,-205652282.0,-1.0
3012,2014-12-17,IBM,96.6328842781692,97.77446337680264,96.37140515301812,96.89436340332033,5367026.0,0.0,0.0,0.33167266845704546,0.0,0.33167266845704546,20.010230731734197,95.98233312802402,104.9237365722656,10.200079674110523,-89.79992032588949,-1.9933910807096282,-1.4302871154109271,-0.07387961251252328,-200285256.0,1.0
3013,2014-12-18,IBM,97.94661641661924,100.56141662597656,97.76804563842715,100.56141662597656,7638310.0,0.0,0.0,3.667053222656236,0.0,3.667053222656236,48.61346981899554,95.98233312802402,104.9237365722656,51.21213382784503,-48.78786617215498,-1.8401830568662234,-1.5122663037019866,-0.03423810106483938,-192646946.0,1.0
3014,2014-12-19,IBM,100.44025537204288,102.30249948866528,100.44025537204288,101.09076690673828,9272685.0,0.0,0.0,0.5293502807617188,0.0,0.5293502807617188,51.50200962304562,95.98233312802402,104.9237365722656,57.13234852414787,-42.86765147585213,-1.6569501604396493,-1.5412030750495194,-0.020697027184512495,-183374261.0,1.0
3015,2014-12-22,IBM,100.97600071452406,103.25916899598676,100.97600071452406,102.9594268798828,4897895.0,0.0,0.0,1.868659973144517,0.0,1.868659973144517,60.53744874503846,95.98233312802402,104.9237365722656,78.03130454148281,-21.968695458517193,-1.3454421079977124,-1.5020508816391582,-0.009509811102892396,-178476366.0,1.0
3016,2014-12-23,IBM,103.46326038194049,103.8905662444996,103.0678556264411,103.46964263916016,4229292.0,0.0,0.0,0.510215759277358,0.0,0.510215759277358,62.725268489666135,95.98233312802402,104.91095811204757,83.85736353059478,-16.14263646940522,-1.0453494467062967,-1.410710594652586,0.010778277718927809,-174247074.0,1.0
3017,2014-12-24,IBM,103.87778736669124,103.94794129121418,103.06784137506476,103.20176696777344,1954033.0,0.0,0.0,-0.26787567138671875,0.26787567138671875,0.0,60.687054636149995,95.98233312802402,104.91095811204757,80.85717400683224,-19.142825993167754,-0.8196902990050603,-1.292506535523081,0.004656582862732295,-176201107.0,-1.0
3018,2014-12-26,IBM,103.4887511581938,104.01170930487513,103.32293466392724,103.53338623046876,2000161.0,0.0,0.0,0.3316192626953267,0.0,0.3316192626953267,62.43084023203198,95.98233312802402,104.1647830934136,92.2835230815276,-7.716476918472398,-0.6070966631950085,-1.1554245610574665,0.04479345502380716,-174200946.0,1.0
3019,2014-12-29,IBM,103.31656393997876,103.53339778621024,101.69028973516872,102.3663101196289,3485063.0,0.0,0.0,-1.167076110839858,1.167076110839858,0.0,52.90205789779441,95.98233312802402,104.1647830934136,78.02036087734183,-21.979639122658163,-0.5267163059385211,-1.0296829100336775,0.04867375257491524,-177686009.0,-1.0
3020,2014-12-30,IBM,102.05380805069576,102.56401194510951,101.90712812095288,102.07294464111328,2960075.0,0.0,0.0,-0.293365478515625,0.293365478515625,0.0,50.65943474843995,95.98233312802402,104.1647830934136,74.43505965635651,-25.564940343643478,-0.4811401518905001,-0.919974358405042,0.05706400540742762,-180646084.0,-1.0
3021,2014-12-31,IBM,102.30255682550424,102.99771399354168,102.28343040963814,102.32169342041016,4196447.0,0.0,0.0,0.248748779296875,0.0,0.248748779296875,52.624328061323446,95.98233312802402,104.01170930487513,78.9520898356048,-21.047910164395198,-0.4201060527706204,-0.8200006972781577,0.056012855923297744,-176449637.0,1.0
3022,2015-01-02,IBM,102.87649973957542,104.15201433160924,102.67879233126092,103.35481262207033,5779673.0,0.0,0.0,1.0331192016601705,0.0,1.0331192016601705,60.21663490011891,95.98233312802402,104.15201433160924,90.2419483738354,-9.758051626164601,-0.2850857134101119,-0.7130177005045486,0.027778009596696407,-170669964.0,1.0
3023,2015-01-05,IBM,102.85096780485726,102.85096780485726,101.52443618658047,101.728515625,5104898.0,0.0,0.0,-1.6262969970703267,1.6262969970703267,0.0,46.64043329410366,95.98233312802402,104.15201433160924,70.33545561672958,-29.66454438327043,-0.3057848009890023,-0.6315711206014394,0.0063086742516265115,-175774862.0,-1.0
3024,2015-01-06,IBM,101.83058274649264,102.01553584037563,98.96068482708944,99.53466033935548,6429448.0,0.0,0.0,-2.193855285644517,2.193855285644517,0.0,34.524740707725186,95.98233312802402,104.15201433160924,43.48183390280324,-56.51816609719676,-0.4935257066251353,-0.6039620378061786,-0.033263263445733826,-182204310.0,-1.0
3025,2015-01-07,IBM,100.25532492587026,100.25532492587026,98.23363596267956,98.88414764404295,4918083.0,0.0,0.0,-0.6505126953125284,0.6505126953125284,0.0,31.706788451393848,96.37140515301812,104.15201433160924,32.294932611945356,-67.70506738805464,-0.686884685805154,-0.6205465674059738,-0.04431729808044904,-187122393.0,-1.0
3026,2015-01-08,IBM,99.64304984034972,101.42876790778,99.20300003288652,101.03336334228516,4431693.0,0.0,0.0,2.1492156982422017,0.0,2.1492156982422017,47.91365973984333,97.76804563842715,104.15201433160924,51.14871110419572,-48.85128889580429,-0.6591016116755384,-0.6282575762598868,-0.02101130328674894,-182690700.0,1.0
3027,2015-01-09,IBM,101.03339214472476,102.25787935713352,100.28721786395148,101.47344207763672,4694762.0,0.0,0.0,0.4400787353515625,0.0,0.4400787353515625,50.679019477000274,98.23363596267956,104.15201433160924,54.74144965055808,-45.25855034944192,-0.5947171204442299,-0.6215494850967554,-0.01989642402158609,-177995938.0,1.0
3028,2015-01-12,IBM,101.40327074626715,101.5627151487936,99.33694702154408,99.77061462402344,4380230.0,0.0,0.0,-1.7028274536132812,1.7028274536132812,0.0,40.96807419068754,98.23363596267956,104.15201433160924,25.96959108617853,-74.03040891382146,-0.6733341151188341,-0.6319064111011712,-0.025356931324104992,-182376168.0,-1.0
3029,2015-01-13,IBM,100.29357952605449,102.021908514512,99.28592625675378,100.006591796875,4578865.0,0.0,0.0,0.2359771728515625,0.0,0.2359771728515625,42.72300808580411,98.23363596267956,104.15201433160924,29.956784167486006,-70.043215832514,-0.7084309135097158,-0.6472113115828801,-0.02024388393519505,-177797303.0,1.0
3030,2015-01-14,IBM,98.76297058926406,99.80251480298185,98.04868728662804,99.36246490478516,4906054.0,0.0,0.0,-0.6441268920898438,0.6441268920898438,0.0,39.06525936689841,98.04868728662804,104.15201433160924,21.525597571204138,-78.47440242879587,-0.7792384601819862,-0.6736167413027014,-0.02892083210025065,-182703357.0,-1.0
3031,2015-01-15,IBM,99.93009219281312,100.10866306116571,98.31656194160676,98.57804107666016,4443826.0,0.0,0.0,-0.784423828125,0.784423828125,0.0,34.87023773235839,98.04868728662804,104.15201433160924,8.67320047132996,-91.32679952867005,-0.8884093681068919,-0.7165752666635395,-0.046217214508210924,-187147183.0,-1.0
3032,2015-01-16,IBM,98.09968990985884,100.52953736892854,98.09968990985884,100.217041015625,6020776.0,0.0,0.0,1.6389999389648438,0.0,1.6389999389648438,48.26424060118961,98.04868728662804,104.15201433160924,35.5274051843578,-64.4725948156422,-0.8330713735653319,-0.7398744880438981,-0.014857924546414547,-181126407.0,1.0
3033,2015-01-20,IBM,99.93642657637432,100.33821342337978,98.23361662278305,100.09587097167967,8778869.0,0.0,0.0,-0.12117004394532671,0.12117004394532671,0.0,47.432155039298145,98.04868728662804,104.15201433160924,33.5420938442918,-66.4579061557082,-0.7898876904806542,-0.7498771285312494,0.005638343773021193,-189905276.0,-1.0
3034,2015-01-21,IBM,97.59587544866544,98.53338503186878,96.3458796361212,96.99639129638672,12444367.0,0.0,0.0,-3.0994796752929545,3.0994796752929545,0.0,31.436106956419536,96.3458796361212,104.15201433160924,8.333338914091746,-91.66666108590825,-0.9943046913296314,-0.798762641090926,-0.019090586232807127,-202349643.0,-1.0
3035,2015-01-22,IBM,96.90074544630936,99.31145716197612,96.7859462573126,99.10100555419922,6401625.0,0.0,0.0,2.1046142578125,0.0,2.1046142578125,45.766004020553204,96.3458796361212,104.15201433160924,35.29436815470901,-64.705631845291,-0.9752398971683789,-0.8340580923064166,-0.019125937454337882,-195948018.0,1.0
3036,2015-01-23,IBM,98.87139199087738,100.5104305945646,98.78211166351052,99.4071044921875,5057201.0,0.0,0.0,0.30609893798828125,0.0,0.30609893798828125,47.60374815077875,96.3458796361212,102.85096780485726,47.058929512727836,-52.94107048727216,-0.9247710987447704,-0.8522006935940873,-0.020363333924045657,-190890817.0,1.0
3037,2015-01-26,IBM,100.93135269522078,101.69666360576495,99.34334146249913,99.71961975097656,8250953.0,0.0,0.0,0.3125152587890625,0.0,0.3125152587890625,49.615024747508606,96.3458796361212,102.25787935713352,57.06597215937749,-42.93402784062252,-0.8497613232246408,-0.851712819520198,-0.000511121167680928,-182639864.0,1.0
3038,2015-01-27,IBM,98.81397408838124,98.90963665377409,97.31525377787014,98.0040283203125,5919942.0,0.0,0.0,-1.7155914306640625,1.7155914306640625,0.0,39.91094892880235,96.3458796361212,102.25787935713352,28.04717121852935,-71.95282878147064,-0.9181653873205278,-0.8650033330802639,-0.020024314803467558,-188559806.0,-1.0
3039,2015-01-28,IBM,98.21451052269776,98.552515609849,96.65200805664062,96.65200805664062,4702711.0,0.0,0.0,-1.352020263671875,1.352020263671875,0.0,33.88452581212867,96.3458796361212,102.25787935713352,5.178085841773508,-94.82191415822649,-1.069148360140744,-0.90583233849236,-0.02727847835439512,-193262517.0,-1.0
3040,2015-01-29,IBM,96.54359246434802,99.22217571038668,95.35736812145086,99.15839385986328,8703557.0,0.0,0.0,2.5063858032226562,0.0,2.5063858032226562,50.02546935590143,95.35736812145086,102.25787935713352,55.0832483071291,-44.9167516928709,-0.9753162279321117,-0.9197291163803104,0.0058872419949165256,-184558960.0,1.0
3041,2015-01-30,IBM,98.15711273692104,99.00532168783604,97.6022636243021,97.77445220947266,6865526.0,0.0,0.0,-1.383941650390625,1.383941650390625,0.0,43.29183458990472,95.35736812145086,102.021908514512,36.267828619335354,-63.73217138066464,-1.0010862135213898,-0.9360005358085264,-0.024372988679355556,-191424486.0,-1.0
3042,2015-02-02,IBM,98.21450082537304,98.63541412353516,96.62647967152007,98.63541412353516,4928961.0,0.0,0.0,0.8609619140625,0.0,0.8609619140625,48.28828302143775,95.35736812145086,102.021908514512,49.186377585726184,-50.81362241427381,-0.9411872607841048,-0.937037880803642,-0.014590580350289595,-186495525.0,1.0
3043,2015-02-03,IBM,98.69284843446512,101.14821589074674,98.69284843446512,101.0653076171875,5794212.0,0.0,0.0,2.4298934936523438,0.0,2.4298934936523438,59.81758575973345,95.35736812145086,101.69666360576495,90.04059693794561,-9.959403062054397,-0.6896944434959096,-0.8875691933420956,0.041949151575831456,-180701313.0,1.0
3044,2015-02-04,IBM,100.26171647516686,101.2183525869074,99.93645551481788,100.1022720336914,3847711.0,0.0,0.0,-0.9630355834960938,0.9630355834960938,0.0,54.283048477279976,95.35736812145086,101.69666360576495,74.84907311831893,-25.150926881681073,-0.5616194970846777,-0.8223792540906121,0.01010349465066307,-184549024.0,-1.0
3045,2015-02-05,IBM,100.31274040867858,101.14182305758004,100.22344988693315,100.70814514160156,5495266.0,0.0,0.0,0.6058731079101562,0.0,0.6058731079101562,57.16035138936562,95.35736812145086,101.69666360576495,84.40649333022299,-15.593506669777016,-0.406543898016551,-0.7392121828757999,0.013088004685986032,-179053758.0,1.0
3046,2015-02-06,IBM,101.04849523767516,101.52374657072876,100.33561823809478,100.65030670166016,3406299.0,1.051625,0.0,-0.05783843994140625,0.05783843994140625,0.0,56.766814321485846,95.35736812145086,101.69666360576495,83.4941137119433,-16.5058862880567,-0.2850268352888037,-0.6483751133584007,0.009333037500621533,-182460057.0,-1.0
3047,2015-02-09,IBM,100.18791164783768,101.15125823344876,99.80257711376916,100.02735900878906,3198354.0,0.0,0.0,-0.6229476928710938,0.6229476928710938,0.0,52.292627277872164,95.35736812145086,101.69666360576495,73.66734834956965,-26.332651650430343,-0.23626682334892735,-0.5659534553565061,0.020645382880217777,-185658411.0,-1.0
3048,2015-02-10,IBM,100.66317088412072,101.83203887939452,99.5970738065852,101.83203887939452,4644868.0,0.0,0.0,1.8046798706054545,0.0,1.8046798706054545,62.24071985922756,95.35736812145086,101.83203887939452,100.0,-0.0,-0.05140896877963996,-0.46304455804113287,0.05359465288831089,-181013543.0,1.0
3049,2015-02-11,IBM,101.3182383223296,102.17240747689232,100.93933081244826,101.60082244873048,3793528.0,0.0,0.0,-0.23121643066403408,0.23121643066403408,0.0,60.37944770812476,95.35736812145086,102.17240747689232,91.61288734590427,-8.38711265409573,0.0755639253031859,-0.3553228613722691,0.024631586835895947,-184807071.0,-1.0
3050,2015-02-12,IBM,101.9347760746756,102.43571504320064,101.53017073467927,101.80632781982422,3486423.0,0.0,0.0,0.2055053710937358,0.0,0.2055053710937358,61.5583812680825,95.35736812145086,102.43571504320064,91.10827386204404,-8.891726137955953,0.19057657647753956,-0.24614297380230737,0.04123649398427354,-181320648.0,1.0
3051,2015-02-13,IBM,101.97332836698448,103.27063448083636,101.88342174547712,103.01374816894533,3877417.0,0.0,0.0,1.207420349121108,0.0,1.207420349121108,68.01120629811118,95.35736812145086,103.27063448083636,96.75372595557386,-3.246274044426143,0.3748328230371385,-0.12194781443441818,0.044389067398516335,-177443231.0,1.0
3052,2015-02-17,IBM,102.5962864501128,103.66238347796146,102.58344264860428,103.37338256835938,3027647.0,0.0,0.0,0.3596343994140483,0.0,0.3596343994140483,69.75597724136794,95.35736812145086,103.66238347796146,96.52016405513902,-3.4798359448609864,0.5436103150466636,0.011163811461798205,0.022837460307490787,-174415584.0,1.0
3053,2015-02-18,IBM,103.95140718987336,104.34316884791886,103.16789412422472,104.16334533691406,4558886.0,0.0,0.0,0.7899627685546875,0.0,0.7899627685546875,73.42913479690701,95.35736812145086,104.34316884791886,97.99880370732993,-2.0011962926700755,0.7326653764767599,0.1554641244647906,0.040569242043335674,-169856698.0,1.0
3054,2015-02-19,IBM,104.073425353663,105.64046153434666,103.68166374588183,105.255126953125,3665602.0,0.0,0.0,1.0917816162109375,0.0,1.0917816162109375,77.74031416686486,96.62647967152007,105.64046153434666,95.72514581141142,-4.274854188588568,0.9595296660530295,0.3162772327824384,0.045150089946847105,-166191096.0,1.0
3055,2015-02-20,IBM,105.09455563997004,105.54411944907274,104.09910463460292,105.10098266601562,3507238.0,0.0,0.0,-0.154144287109375,0.154144287109375,0.0,75.73839715906689,96.62647967152007,105.64046153434666,94.01508815370677,-5.984911846293226,1.1140411216946262,0.4758300105648761,0.04421919922755735,-169698334.0,-1.0
3056,2015-02-23,IBM,105.47345921007732,105.58263663462668,104.3624038890437,104.62571716308594,2839262.0,0.0,0.0,-0.4752655029296875,0.4752655029296875,0.0,69.38210279620506,98.69284843446512,105.64046153434666,85.39434541514666,-14.605654584853333,1.1844885625283155,0.6175617209575641,0.04597100433185308,-172537596.0,-1.0
3057,2015-02-24,IBM,104.35598323784788,105.96156083044994,103.7266062519522,105.85881042480467,4917874.0,0.0,0.0,1.2330932617187358,0.0,1.2330932617187358,75.53003170707974,99.5970738065852,105.96156083044994,98.38556657810777,-1.614433421892239,1.3245503953125706,0.7589594558285655,0.03954326742077008,-167619722.0,1.0
3058,2015-02-25,IBM,105.92948079646146,105.94233485180432,104.41381956427468,104.56153869628906,4188812.0,0.0,0.0,-1.2972717285156108,1.2972717285156108,0.0,60.72788872774067,99.5970738065852,105.96156083044994,78.0025926848267,-21.9974073151733,1.31570479427549,0.8703085235179505,0.029140672055608663,-171808534.0,-1.0
3059,2015-02-26,IBM,105.15880900304006,105.41569534538174,102.60915490908134,103.31560516357422,7437897.0,0.0,0.0,-1.2459335327148438,1.2459335327148438,0.0,49.89234575458554,99.5970738065852,105.96156083044994,58.426254041303636,-41.573745958696364,1.194389984080857,0.9351248156305318,0.014824985598351992,-179246431.0,-1.0
3060,2015-02-27,IBM,103.31557238601404,104.22754372558236,102.85959184144956,104.00276184082033,4612860.0,0.0,0.0,0.687156677246108,0.0,0.687156677246108,55.001714703572446,99.5970738065852,105.96156083044994,69.222987142801,-30.77701285719901,1.140547403519733,0.9762093332083722,0.009600792995639651,-174633571.0,1.0
3061,2015-03-02,IBM,104.0027682513337,104.0027682513337,102.6348162828832,103.06510925292967,6190123.0,0.0,0.0,-0.9376525878906534,0.9376525878906534,0.0,47.392997204124676,99.5970738065852,105.96156083044994,54.49041585504813,-45.50958414495187,1.0105668572823419,0.9830808380231663,-0.0029821343538395384,-180823694.0,-1.0
3062,2015-03-03,IBM,102.9302625609498,103.88075527964816,102.7568558366708,103.4183578491211,3383182.0,0.0,0.0,0.35324859619142046,0.0,0.35324859619142046,50.377035102855814,100.93933081244826,105.96156083044994,49.36108118877488,-50.63891881122512,0.9253931907551163,0.9715433085695564,-0.00715210792609744,-177440512.0,1.0
3063,2015-03-04,IBM,103.10366292707342,103.11650673115948,101.93480500214513,102.38436889648438,3800746.0,0.0,0.0,-1.0339889526367188,1.0339889526367188,0.0,42.27760420000384,101.53017073467927,105.96156083044994,19.276076882068015,-80.72392311793199,0.7656324450803709,0.9303611358717194,-0.02727428240069585,-181241258.0,-1.0
3064,2015-03-05,IBM,102.6669292010252,103.72018239368929,102.56416854180245,103.5146713256836,3966118.0,0.0,0.0,1.1303024291992188,0.0,1.1303024291992188,52.00961913104,101.88342174547712,105.96156083044994,39.999851555267504,-60.0001484447325,0.7219051891735404,0.8886699465320838,-0.015093211310620469,-177275140.0,1.0
3065,2015-03-06,IBM,102.87886306234076,103.6816570553366,101.51092128710036,101.79349517822266,4749049.0,0.0,0.0,-1.7211761474609375,1.7211761474609375,0.0,40.12359049773617,101.51092128710036,105.96156083044994,6.349062609317267,-93.65093739068273,0.5421173023929668,0.8193594177042605,-0.027070036523128782,-182024189.0,-1.0
3066,2015-03-09,IBM,101.60084448375912,103.49542344581856,101.60084448375912,103.25138092041016,5432819.0,0.0,0.0,1.4578857421875,0.0,1.4578857421875,51.05564493161802,101.51092128710036,105.96156083044994,39.105832237312924,-60.894167762687076,0.5113784497064273,0.7577632241046939,-0.02463119974550132,-176591370.0,1.0
3067,2015-03-10,IBM,102.49997733215211,102.904582802555,101.35037994384766,101.35037994384766,4812646.0,0.0,0.0,-1.9010009765625,1.9010009765625,0.0,40.05318391557437,101.35037994384766,105.96156083044994,0.0,-100.0,0.32982082682501357,0.6721747446487579,-0.030710706752016925,-181404016.0,-1.0
3068,2015-03-11,IBM,101.83844125684986,102.20451519124744,100.14937388894369,100.70169830322266,5972555.0,0.0,0.0,-0.648681640625,0.648681640625,0.0,36.92053828693767,100.14937388894369,105.96156083044994,9.502867334405341,-90.49713266559466,0.13206950050825128,0.5641536958206567,-0.025300213420935802,-187376571.0,-1.0
3069,2015-03-12,IBM,100.36131448176646,101.93477743600124,100.36131448176646,101.45952606201172,4777396.0,0.0,0.0,0.7578277587890625,0.0,0.7578277587890625,42.936680151179445,100.14937388894369,105.96156083044994,22.541466512577472,-77.45853348742253,0.03608455608360828,0.45853986787324696,-0.024453540788667794,-182599175.0,1.0
3070,2015-03-13,IBM,101.12557762246836,101.1641090284511,98.51812181058892,99.08329010009766,6343049.0,0.0,0.0,-2.3762359619140625,2.3762359619140625,0.0,31.92171235752423,98.51812181058892,105.96156083044994,7.592838310365926,-92.40716168963408,-0.22908582817481715,0.3210147286636341,-0.03863401670744193,-188942224.0,-1.0
3071,2015-03-16,IBM,99.57778272547176,100.88793227745784,99.41723010656648,100.88151550292967,3922082.0,0.0,0.0,1.798225402832017,0.0,1.798225402832017,44.38070010421043,98.51812181058892,105.94233485180432,31.83359204834788,-68.16640795165212,-0.29078155774482184,0.19865547138194292,-0.024529903577587886,-185020142.0,1.0
3072,2015-03-17,IBM,100.31637859268947,101.016412010339,99.78333512140236,100.80447387695312,3464038.0,0.0,0.0,-0.07704162597654829,0.07704162597654829,0.0,43.98278894578581,98.51812181058892,105.41569534538174,33.147193789690846,-66.85280621030915,-0.341950688594153,0.09053423938672372,-0.015431017806327496,-188484180.0,-1.0
3073,2015-03-18,IBM,100.73380589235111,103.20639640909816,100.05947047901246,102.6348114013672,6002785.0,0.0,0.0,1.8303375244140767,0.0,1.8303375244140767,55.0344085766932,98.51812181058892,104.22754372558236,72.10343975398791,-27.896560246012097,-0.2321337585246397,0.02600063980445103,-0.008499857199450789,-182481395.0,1.0
3074,1.0,1.0,1.0,1.0,1.0,1.0,1.0,1.0,1.0,1.0,1.0,1.0,1.0,1.0,1.0,1.0,1.0,1.0,1.0,1.0,1.0,1.0
3075,2015-03-20,IBM,103.36695683195153,104.68353363174192,102.98162228100811,104.60646057128906,9420694.0,0.0,0.0,1.9716491699218608,0.0,1.9716491699218608,64.95121229976559,98.51812181058892,104.68353363174192,98.74991220880932,-1.2500877911906842,0.08494985701875635,0.01067846819988633,0.013124082591432273,-173060701.0,1.0
3076,2015-03-23,IBM,104.53583935195148,106.19279250248206,104.51014149459328,105.73038482666016,6202885.0,0.0,0.0,1.1239242553710938,0.0,1.1239242553710938,69.3913004857065,98.51812181058892,106.19279250248206,93.97488577183702,-6.025114228162976,0.3525848721726419,0.07905974899443746,0.04321646238760235,-166857816.0,1.0
3077,2015-03-24,IBM,105.8331272951678,105.89735655807038,104.61932133177665,104.68354034423828,4546021.0,0.0,0.0,-1.046844482421875,1.046844482421875,0.0,61.07592812327385,98.51812181058892,106.19279250248206,80.33463299164059,-19.66536700835941,0.47474340257384995,0.15819647971032,0.039540962149674064,-171403837.0,-1.0
3078,2015-03-25,IBM,104.7349241545097,104.7349241545097,102.2430725097656,102.24307250976562,5678629.0,0.0,0.0,-2.4404678344726562,2.4404678344726562,0.0,46.18773051435521,98.51812181058892,106.19279250248206,48.535642097470294,-51.4643579025297,0.370360276889528,0.2006292391461616,0.007722748943997715,-177082466.0,-1.0
3079,2015-03-26,IBM,102.28803042311264,103.55964897128176,102.0568214595682,103.13577270507812,4598216.0,0.0,0.0,0.8927001953125,0.0,0.8927001953125,51.207728413743816,98.51812181058892,106.19279250248206,60.167414080279556,-39.832585919720444,0.3555705469693038,0.23161750071079007,0.04089975818209601,-172484250.0,1.0
3080,2015-03-27,IBM,103.2642177045208,103.33486374664017,102.2623395622188,103.01374816894533,3637883.0,0.0,0.0,-0.12202453613279829,0.12202453613279829,0.0,50.465215853482384,98.51812181058892,106.19279250248206,58.57744962406264,-41.42255037593737,0.3301969146967707,0.25133338350798623,0.02113600946006544,-176122133.0,-1.0
3081,2015-03-30,IBM,103.59819625895057,105.06889911169516,103.55966484260182,104.47162628173828,4328348.0,0.0,0.0,1.4578781127929545,0.0,1.4578781127929545,58.717216018851445,98.51812181058892,106.19279250248206,77.57341924049102,-22.42658075950899,0.42285232958128915,0.2856371727226468,0.036378865577548325,-171793785.0,1.0
3082,2015-03-31,IBM,103.4504785349152,104.25327276392711,103.0137686427726,103.07798767089844,4451148.0,0.0,0.0,-1.3936386108398438,1.3936386108398438,0.0,49.602743998470245,98.51812181058892,106.19279250248206,59.41448230640258,-40.585517693597424,0.3794533229471,0.3044004027675375,0.004317991756209727,-176244933.0,-1.0
3083,2015-04-01,IBM,102.90455503611486,103.15502453352164,101.72284332999486,102.23020935058594,3871037.0,0.0,0.0,-0.8477783203125,0.8477783203125,0.0,44.72927748496065,98.51812181058892,106.19279250248206,48.368036740887696,-51.631963259112304,0.2734979580327348,0.298219913820577,-0.003942152231361518,-180115970.0,-1.0
3084,2015-04-02,IBM,102.44858752625466,104.3881249411626,102.04398207298064,103.04586029052734,4886494.0,0.0,0.0,0.8156509399414062,0.0,0.8156509399414062,50.1647676349323,99.41723010656648,106.19279250248206,53.55467150812839,-46.44532849187161,0.2524338814936584,0.2890627073551933,-0.01491877530545227,-175229476.0,1.0
3085,2015-04-06,IBM,102.55774958643674,104.5550889448262,101.92194550552068,104.0669937133789,3625122.0,0.0,0.0,1.0211334228515625,0.0,1.0211334228515625,56.363708115212766,99.78333512140236,106.19279250248206,66.83340472192894,-33.16659527807105,0.31451188509940664,0.294152542904036,-0.015732384933699994,-171604354.0,1.0
3086,2015-04-07,IBM,103.82939946064674,105.223039540466,103.79728482042378,104.08629608154295,3292808.0,0.0,0.0,0.01930236816404829,0.0,0.01930236816404829,56.48177501570845,100.05947047901246,106.19279250248206,65.65488632622831,-34.34511367377169,0.36110410663725645,0.30754285565068007,-0.005705235615182325,-168311546.0,1.0
3087,2015-04-08,IBM,103.86150221076292,105.03678720358393,103.40552152383889,103.94499206542967,2640418.0,0.0,0.0,-0.14130401611328125,0.14130401611328125,0.0,55.21975393753134,101.72284332999486,106.19279250248206,49.71306495188509,-50.28693504811491,0.3822207221505778,0.32247842895065965,0.01664581779368457,-170951964.0,-1.0
3088,2015-04-09,IBM,103.8486518523577,104.34316392166336,103.21926446833436,104.25967407226562,2367621.0,0.0,0.0,0.3146820068359517,0.0,0.3146820068359517,57.651200281313194,101.72284332999486,106.19279250248206,56.75301092650238,-43.24698907349762,0.4195121254809919,0.34188516825672616,0.010897299139856598,-168584343.0,1.0
3089,2015-04-10,IBM,104.25966854978591,104.8954829272118,103.55964540760549,104.5936279296875,2631422.0,0.0,0.0,0.333953857421875,0.0,0.333953857421875,60.29133427321219,101.72284332999486,106.19279250248206,64.22409940055887,-35.77590059944114,0.4705884657138881,0.3676258277481586,0.01533659136595178,-165952921.0,1.0
3090,2015-04-13,IBM,104.27892258020358,105.32575898712054,104.27249555449868,104.28533935546876,4046869.0,0.0,0.0,-0.3082885742187358,0.3082885742187358,0.0,56.5369711693565,101.72284332999486,105.89735655807038,61.38430723467201,-38.615692765327985,0.48064988914143214,0.39023064002681335,-0.0017831341666600942,-169999790.0,-1.0
3091,2015-04-14,IBM,104.3110742432926,104.5165853822194,103.26423746469828,104.23400115966795,2844388.0,0.0,0.0,-0.05133819580080967,0.05133819580080967,0.0,55.868504885988855,101.72284332999486,105.32575898712054,69.69793546808805,-30.30206453191195,0.4789599244792839,0.4079764969173075,0.011214940404738805,-172844178.0,-1.0
3092,2015-04-15,IBM,104.4459093405919,105.94230963446348,104.3624195033934,105.40925598144533,3659745.0,0.0,0.0,1.1752548217773722,0.0,1.1752548217773722,66.37114336543488,101.72284332999486,105.94230963446348,87.36679915055544,-12.633200849444565,0.5659301667293164,0.4395672308797094,0.031096939457076145,-169184433.0,1.0
3093,2015-04-16,IBM,104.88261036650673,105.31290327644128,104.38808820854582,104.76700592041016,3281197.0,0.0,0.0,-0.6422500610351705,0.6422500610351705,0.0,57.710942558721115,101.72284332999486,105.94230963446348,72.14567840466879,-27.85432159533121,0.5763862756833333,0.46693103984043416,0.01670271493711839,-172465630.0,-1.0
3094,2015-04-17,IBM,103.88075544518928,103.9514014903294,102.77612683107432,103.18714904785156,4512862.0,0.0,0.0,-1.5798568725585938,1.5798568725585938,0.0,42.114073920754855,101.72284332999486,105.94230963446348,34.70357652355063,-65.29642347644936,0.4519814108057716,0.46394111403350174,-0.008454598659307977,-176978492.0,-1.0
3095,2015-04-20,IBM,104.10557097061846,107.02129984135962,103.97713289296522,106.71302795410156,10051223.0,0.0,0.0,3.52587890625,0.0,3.52587890625,65.86810123422762,101.72284332999486,107.02129984135962,94.1818549119571,-5.818145088042908,0.6306291198953602,0.49727871520587347,0.02523609707949248,-166927269.0,1.0
3096,2015-04-21,IBM,106.65517512531056,107.49650051248834,105.35787940298611,105.49274444580078,10129046.0,0.0,0.0,-1.2202835083007812,1.2202835083007812,0.0,56.59392513964606,101.72284332999486,107.49650051248834,65.29485552479248,-34.70514447520752,0.6660640637347797,0.5310357849116547,0.014890110140148405,-177056315.0,-1.0
3097,2015-04-22,IBM,105.5762507655318,106.61024358972216,104.6129039868077,106.19921112060548,4209941.0,0.0,0.0,0.7064666748047017,0.0,0.7064666748047017,60.3254869809619,101.92194550552068,107.49650051248834,76.72837759675221,-23.27162240324778,0.74259232639983,0.5733470932092898,0.018602945631649437,-172846374.0,1.0
3098,2015-04-23,IBM,106.11571750849592,110.40581429729824,106.05791526876033,109.33329010009766,8614438.0,0.0,0.0,3.1340789794921733,0.0,3.1340789794921733,72.44929417079848,101.92194550552068,110.40581429729824,87.35807656242804,-12.641923437571952,1.0440997746991627,0.6674976295072644,0.0453150183641815,-164231936.0,1.0
3099,2015-04-24,IBM,109.326835014448,109.72501327579629,108.36990538159516,109.03783416748048,4067266.0,0.0,0.0,-0.2954559326171733,0.2954559326171733,0.0,70.11856858893918,102.77612683107432,110.40581429729824,82.07029926358447,-17.92970073641553,1.244855851822365,0.7829692739702846,0.045572031901936816,-168299202.0,-1.0
3100,2015-04-27,IBM,109.7506996073642,110.13604431598088,109.37178192325482,109.64794921875,3314356.0,0.0,0.0,0.610115051269517,0.0,0.610115051269517,72.24597239107385,102.77612683107432,110.40581429729824,90.06689222981609,-9.933107770183907,1.4366271317002486,0.9137008455162775,0.0519403265618561,-164984846.0,1.0
3101,2015-04-28,IBM,109.71219787329989,112.1912054254062,109.19198801376484,111.69669342041016,6084268.0,0.0,0.0,2.0487442016601562,0.0,2.0487442016601562,78.24663149777706,102.77612683107432,112.1912054254062,94.74765929948,-5.252340700520001,1.7339360521734761,1.0777478868477173,0.05964786849526371,-158900578.0,1.0
3102,2015-04-29,IBM,111.36275079393717,112.4738064659482,110.97740592325682,112.0049819946289,4726246.0,0.0,0.0,0.30828857421875,0.0,0.30828857421875,79.03369965250441,102.77612683107432,112.4738064659482,95.16560157717159,-4.834398422828406,1.9717032573004616,1.2565389609382662,0.06908640760161955,-154174332.0,1.0
3103,2015-04-30,IBM,111.6003556649177,111.92788798075676,109.3718074601618,110.00762176513672,5295793.0,0.0,0.0,-1.9973602294921875,1.9973602294921875,0.0,62.20782293568865,102.77612683107432,112.4738064659482,74.56933211174743,-25.430667888252582,1.9761849722717812,1.4004681632049694,0.06609808275759477,-159470125.0,-1.0
3104,2015-05-01,IBM,111.2343109087187,111.74809385800576,110.73337176438056,111.5361557006836,3464457.0,0.0,0.0,1.528533935546875,0.0,1.528533935546875,68.18810333142623,102.77612683107432,112.4738064659482,90.33118435988837,-9.668815640111639,2.07910999199639,1.5361965289632535,0.04519717825509084,-156005668.0,1.0
3105,2015-05-04,IBM,112.04989816238802,113.22518276886775,111.55538622443044,111.7287826538086,4213288.0,0.0,0.0,0.192626953125,0.0,0.192626953125,68.90361934387315,102.77612683107432,113.22518276886775,85.67908791025995,-14.320912089740048,2.151421943972977,1.6592416119651985,0.05911343231014077,-151792380.0,1.0
3106,2015-05-05,IBM,111.4333557252717,111.89575299876913,110.43789465636392,111.15718841552734,3758906.0,0.0,0.0,-0.57159423828125,0.57159423828125,0.0,63.97675403436994,102.77612683107432,113.22518276886775,80.20879239567822,-19.791207604321777,2.137961717037939,1.754985632979747,0.046685632055131876,-155551286.0,-1.0
3107,2015-05-06,IBM,111.88197726752024,112.62613144228264,109.26772932125624,110.03776550292967,3778780.0,1.24283,0.0,-1.1194229125976705,1.1194229125976705,0.0,55.0774377981389,102.77612683107432,113.22518276886775,69.49564357857979,-30.50435642142021,2.013753025220197,1.806739111427837,0.006443375134755902,-159330066.0,-1.0
3108,2015-05-07,IBM,109.76597646684728,111.28664238778292,109.38420139830212,110.64602661132812,2585712.0,0.0,0.0,0.6082611083984517,0.0,0.6082611083984517,58.680969328508894,103.97713289296522,113.22518276886775,72.11135112646737,-27.888648873532627,1.942012024321059,1.8337936940064814,0.014748939724696708,-156744354.0,1.0
3109,2015-05-08,IBM,111.90784448595808,112.16020951201436,111.45487844082707,111.7396011352539,3234860.0,0.0,0.0,1.0935745239257812,0.0,1.0935745239257812,64.57578564466252,104.6129039868077,113.22518276886775,82.75042330598481,-17.249576694015193,1.9509102104332214,1.8572169972918295,0.019076069652073535,-153509494.0,1.0
3110,2015-05-11,IBM,111.7201764229412,111.9401940927962,110.56188971805273,110.73013305664062,2783406.0,0.0,0.0,-1.0094680786132812,1.0094680786132812,0.0,56.057605711620816,104.6129039868077,113.22518276886775,71.02915760896546,-28.97084239103454,1.8551217606837582,1.8567979499702154,-0.008653437574302592,-156292900.0,-1.0
3111,2015-05-12,IBM,110.36131286621094,110.96958134961616,109.25478992241148,110.36131286621094,3098670.0,0.0,0.0,-0.3688201904296875,0.3688201904296875,0.0,53.10450356982492,106.05791526876033,113.22518276886775,60.04237455049793,-39.95762544950207,1.729511287590114,1.8313406174941953,-0.014674964444856498,-159391570.0,-1.0
3112,2015-05-13,IBM,110.80777769156624,111.77841470865306,110.49070768353732,111.48075103759766,2570545.0,0.0,0.0,1.1194381713867188,0.0,1.1194381713867188,60.408764930855945,108.36990538159516,113.22518276886775,64.07143007229881,-35.9285699277012,1.7006889045351699,1.8052102749023902,0.01339115643828781,-156821025.0,1.0
3113,2015-05-14,IBM,112.27022574256742,112.85261219827672,112.0890413698616,112.62612915039062,2551299.0,0.0,0.0,1.1453781127929688,0.0,1.1453781127929688,66.55815535271903,109.19198801376484,113.22518276886775,85.14692062119764,-14.853079378802352,1.750095389435316,1.7941872978089755,0.00977237778063711,-154269726.0,1.0
3114,2015-05-15,IBM,112.53554530286506,112.85909107752155,111.68786301599732,112.11493682861328,3050764.0,0.0,0.0,-0.5111923217773438,0.5111923217773438,0.0,61.62869542517766,109.19198801376484,113.22518276886775,72.47229534726142,-27.527704652738578,1.7280811922274353,1.7809660766926676,0.003456174547262325,-157320490.0,-1.0
3115,2015-05-18,IBM,112.23138093112102,112.2637385968234,111.49369225239236,111.98548126220705,2061248.0,0.0,0.0,-0.1294555664062358,0.1294555664062358,0.0,60.32322531888034,109.25478992241148,113.22518276886775,68.77635149460872,-31.22364850539129,1.6808134290922538,1.7609355471725847,0.007451545495945622,-159381738.0,-1.0
3116,2015-05-19,IBM,111.92725217353934,112.4319821851614,111.25426849669664,112.25726318359376,2639058.0,0.0,0.0,0.27178192138671875,0.0,0.27178192138671875,62.259806984848154,109.25478992241148,113.22518276886775,75.62156636117523,-24.378433638824767,1.646306321457729,1.7380097020296137,0.02017032671028751,-156742680.0,1.0
3117,2015-05-20,IBM,112.16023709392228,112.87850934348904,111.59726723150555,112.43848419189452,2406114.0,0.0,0.0,0.18122100830075283,0.0,0.18122100830075283,63.62574031509396,109.25478992241148,113.22518276886775,80.18587561995548,-19.81412438004451,1.6149658893981922,1.7134009395033294,0.016199927240612588,-154336566.0,1.0
3118,2015-05-21,IBM,112.15371549451288,112.68433779130034,111.97253117171196,112.16665649414062,2401198.0,0.0,0.0,-0.27182769775389204,0.27182769775389204,0.0,59.87510576286312,109.25478992241148,113.22518276886775,73.33950781036938,-26.66049218963062,1.5503229893666202,1.6807853494759875,0.003821880108286768,-156737764.0,-1.0
3119,2015-05-22,IBM,111.97253704543736,112.19902004282218,111.42250838436172,111.44192504882812,2980786.0,0.0,0.0,-0.7247314453125,0.7247314453125,0.0,50.68388668211373,109.25478992241148,112.87850934348904,60.35608368835222,-39.64391631164777,1.4241960094951054,1.6294674814798114,0.0064281688510516855,-159718550.0,-1.0
3120,2015-05-26,IBM,111.37077292766531,111.37724859348486,109.44243945159197,110.08953094482422,4031493.0,0.0,0.0,-1.3523941040039062,1.3523941040039062,0.0,38.093223209545776,109.25478992241148,112.87850934348904,23.035476134201367,-76.96452386579863,1.201265130820616,1.5438270113479724,-0.0024626557470931454,-163750043.0,-1.0
3121,2015-05-27,IBM,110.7560455261178,111.6102034548408,110.32249605956962,111.29959869384766,2891562.0,0.0,0.0,1.2100677490234375,0.0,1.2100677490234375,50.72952010757105,109.25478992241148,112.87850934348904,56.42845192545636,-43.571548074543635,1.1094441758744011,1.4569504442532584,-0.0016249652255114766,-160858481.0,1.0
3122,2015-05-28,IBM,110.94368748973385,111.19605252588504,110.43248175229266,111.11193084716795,1811044.0,0.0,0.0,-0.1876678466797017,0.1876678466797017,0.0,48.94183918448949,109.25478992241148,112.87850934348904,51.24957837393024,-48.75042162606976,1.009890788350944,1.3675385130727957,-0.01344446723549153,-162669525.0,-1.0
3123,2015-05-29,IBM,110.87897017552092,110.87897017552092,109.77892303466795,109.77892303466795,4280232.0,0.0,0.0,-1.3330078125,1.3330078125,0.0,37.974288936833744,109.25478992241148,112.87850934348904,14.46395405802748,-85.53604594197252,0.8140475875750184,1.2568403279732403,-0.02083588378162604,-166949757.0,-1.0
3124,2015-06-01,IBM,110.14128861474592,110.678366003856,109.37771787647264,110.1218719482422,3122833.0,0.0,0.0,0.34294891357424717,0.0,0.34294891357424717,41.84308094151058,109.25478992241148,112.87850934348904,23.927957026344114,-76.07204297365588,0.6786900349151637,1.141210269361625,-0.01664152614213732,-163826924.0,1.0
3125,2015-06-02,IBM,109.78538837167704,110.29659410001308,108.98947027061055,109.77892303466795,2689684.0,0.0,0.0,-0.34294891357424717,0.34294891357424717,0.0,39.033816918029764,108.98947027061055,112.87850934348904,20.29942999449178,-79.70057000550823,0.5375485628319865,1.0204779280556973,-0.02207732558803388,-166516608.0,-1.0
3126,2015-06-03,IBM,110.32895355500916,111.01486805010396,109.76598375672984,109.95364379882812,2229026.0,0.0,0.0,0.17472076416017046,0.0,0.17472076416017046,41.34859990938528,108.98947027061055,112.87850934348904,24.792076143990354,-75.20792385600966,0.43477956659916117,0.90333825576439,-0.02209955435565647,-164287582.0,1.0
3127,2015-06-04,IBM,109.7012692838411,110.39365938499031,108.66592712871274,108.95711517333984,3220948.0,0.0,0.0,-0.9965286254882812,0.9965286254882812,0.0,33.08231554662967,108.66592712871274,112.87850934348904,6.912340929649208,-93.0876590703508,0.2698126328553201,0.776633131182576,-0.028614041116295952,-167508530.0,-1.0
3128,2015-06-05,IBM,108.87300395897653,109.30008806122586,108.19355479485684,108.3229751586914,3243123.0,0.0,0.0,-0.6341400146484375,0.6341400146484375,0.0,28.847784816130513,108.19355479485684,112.87850934348904,2.7624678636925966,-97.23753213630741,0.08690357951874716,0.6386872208498103,-0.027987221943358898,-170751653.0,-1.0
3129,2015-06-08,IBM,108.17413118623858,108.2453118585846,106.78288573512933,106.98995208740234,3931600.0,0.0,0.0,-1.3330230712890625,1.3330230712890625,0.0,22.013430017687085,106.78288573512933,112.87850934348904,3.39696748974199,-96.60303251025802,-0.16372961131236252,0.47820385441737573,-0.028155073700653288,-174683253.0,-1.0
3130,2015-06-09,IBM,106.98994596690206,107.42997097732226,105.71517993037716,107.20995330810548,3552111.0,0.0,0.0,0.2200012207031392,0.0,0.2200012207031392,25.379910849310335,105.71517993037716,112.87850934348904,20.867019950140264,-79.13298004985974,-0.340678827419552,0.31442731804999013,-0.03674447557525862,-171131142.0,1.0
3131,2015-06-10,IBM,107.7341115635178,109.61067048580284,107.4558645249188,109.3065414428711,4895803.0,0.0,0.0,2.096588134765611,0.0,2.096588134765611,49.39880617385734,105.71517993037716,112.68433779130034,51.532216433653865,-48.46778356634614,-0.30818267740917804,0.1899053189581565,-0.016248384764189994,-166235339.0,1.0
3132,2015-06-11,IBM,109.52655203074912,110.2901228211078,109.0606552830204,109.21595764160156,3623344.0,0.0,0.0,-0.09058380126953125,0.09058380126953125,0.0,48.618643040394,105.71517993037716,112.19902004282218,53.992350991275075,-46.00764900872492,-0.28643673573697015,0.09463690801913115,-0.005128173765091559,-169858683.0,-1.0
3133,2015-06-12,IBM,108.8600414084135,108.90534007599184,107.86352236175787,108.05764770507812,3206095.0,0.0,0.0,-1.1583099365234375,1.1583099365234375,0.0,39.430574565513936,105.71517993037716,111.6102034548408,39.736360083721536,-60.263639916278464,-0.35853587340038473,0.004002351735227951,-0.01874490695303721,-173064778.0,-1.0
3134,2015-06-15,IBM,108.05765375580108,108.05765375580108,106.28462290856956,107.58528137207033,4441002.0,0.0,0.0,-0.4723663330077983,0.4723663330077983,0.0,36.21055417031854,105.71517993037716,111.6102034548408,31.723392348350593,-68.2766076516494,-0.4486195676683451,-0.08652203214548669,-0.0199823572864245,-177505780.0,-1.0
3135,2015-06-16,IBM,107.63055759109442,108.3229475825318,107.35878625704486,107.96057891845705,3399291.0,0.0,0.0,0.37529754638671875,0.0,0.37529754638671875,40.65344580034779,105.71517993037716,111.19605252588504,40.96791065569037,-59.03208934430963,-0.4841472210990787,-0.16604706993620513,-0.018126410471831278,-174106489.0,1.0
3136,2015-06-17,IBM,108.06415248664464,108.61417099824564,107.48176597175085,108.17415618896484,2994698.0,0.0,0.0,0.2135772705077983,0.0,0.2135772705077983,43.2489286821361,105.71517993037716,111.01486805010396,46.398508799692266,-53.60149120030774,-0.48942742689632723,-0.2307231413282296,-0.0071859371747259315,-171111791.0,1.0
3137,2015-06-18,IBM,108.09647411408264,109.17711486542711,108.09647411408264,108.87298583984376,3484121.0,0.0,0.0,0.6988296508789205,0.0,0.6988296508789205,51.291447454981714,105.71517993037716,111.01486805010396,59.58474985938212,-40.41525014061787,-0.4322397250788015,-0.271026458078344,0.005077507152537075,-167627670.0,1.0
3138,2015-06-19,IBM,108.46531505725602,108.9829860821145,107.91528636583966,108.05764770507812,7399404.0,0.0,0.0,-0.8153381347656392,0.8153381347656392,0.0,43.073831157188714,105.71517993037716,111.01486805010396,44.20010615307153,-55.79989384692847,-0.44754995548707655,-0.30633115756009055,0.009979400839469132,-175027074.0,-1.0
3139,2015-06-22,IBM,108.4847578950511,108.93124835800744,108.19355948180473,108.5365219116211,2443247.0,0.0,0.0,0.47887420654296875,0.0,0.47887420654296875,48.64927076526511,105.71517993037716,111.01486805010396,53.2360002608866,-46.7639997391134,-0.41624407445324607,-0.3283137409387217,0.012373558261920437,-172583827.0,1.0
3140,2015-06-23,IBM,108.95712438860676,109.98600129359278,108.4329776015355,109.1124267578125,3871874.0,0.0,0.0,0.5759048461914062,0.0,0.5759048461914062,54.79322385268083,105.71517993037716,110.39365938499031,72.61433678169792,-27.385663218302092,-0.34103202523536424,-0.33085739779805023,-0.0017758743666776988,-168711953.0,1.0
3141,2015-06-24,IBM,109.17063223515576,109.25475389512036,107.95409566950418,108.04469299316406,3711313.0,0.0,0.0,-1.0677337646484375,1.0677337646484375,0.0,43.626786162551525,105.71517993037716,110.2901228211078,50.9189539285127,-49.0810460714873,-0.36339414425044936,-0.3373647470885301,-0.010724299577915875,-172423266.0,-1.0
3142,2015-06-25,IBM,108.58180957461092,108.7953516133226,107.46881103515624,107.46881103515624,2519709.0,0.0,0.0,-0.5758819580078267,0.5758819580078267,0.0,38.716545320868285,105.71517993037716,110.2901228211078,38.3312130154047,-61.6687869845953,-0.42271238065035277,-0.35443427380089465,-0.005449282697037816,-174942975.0,-1.0
3143,2015-06-26,IBM,107.56584309326377,107.94115272449196,106.91875182396709,107.06758880615234,9357516.0,0.0,0.0,-0.40122222900389204,0.40122222900389204,0.0,35.50415591014976,105.71517993037716,110.2901228211078,29.561218753469436,-70.43878124653055,-0.49637587893948876,-0.3828225948286135,-0.00481192742460379,-184300491.0,-1.0
3144,2015-06-29,IBM,106.0710809746996,106.99641931421002,105.40457297311512,105.45633697509766,3467176.0,0.0,0.0,-1.6112518310546875,1.6112518310546875,0.0,25.644657277392483,105.40457297311512,110.2901228211078,1.0595327771305383,-98.94046722286947,-0.67696565040184,-0.4416512059432589,-0.023195892134395213,-187767667.0,-1.0
3145,2015-06-30,IBM,106.116375623681,106.12285128832056,104.90631454527212,105.25575256347656,3762776.0,0.0,0.0,-0.20058441162109375,0.20058441162109375,0.0,24.66094734433213,104.90631454527212,110.2901228211078,6.490536072260081,-93.50946392773992,-0.8267396905041977,-0.5186689028554466,-0.026978751009531732,-191530443.0,-1.0
3146,2015-07-01,IBM,106.1034318379714,107.16466620997276,105.8640078288258,106.4399185180664,3362367.0,0.0,0.0,1.1841659545898438,0.0,1.1841659545898438,40.268558927585254,104.90631454527212,109.98600129359278,30.190916266663333,-69.80908373333668,-0.8401991079902729,-0.5829749438824119,-0.022347759666998535,-188168076.0,1.0
3147,2015-07-02,IBM,106.80230133126004,106.9770203588946,106.39464425614244,106.82819366455078,2983924.0,0.0,0.0,0.388275146484375,0.0,0.388275146484375,44.609895031794636,104.90631454527212,109.98600129359278,37.834599149524934,-62.16540085047507,-0.8101958010818748,-0.6284191153223045,-0.011377760543917259,-185184152.0,1.0
3148,2015-07-06,IBM,106.01286920175468,106.91879111487424,105.81226814927194,106.59524536132812,3221471.0,0.0,0.0,-0.23294830322265625,0.23294830322265625,0.0,42.47291552568205,104.90631454527212,109.98600129359278,33.24871984703312,-66.75128015296688,-0.7960387067402621,-0.6619430336058961,-0.01788592923471155,-188405623.0,-1.0
3149,2015-07-07,IBM,106.73110227866673,106.99641860710678,104.97748827895882,106.76993560791016,3713195.0,0.0,0.0,0.17469024658203125,0.0,0.17469024658203125,44.762517779210654,104.90631454527212,109.98600129359278,36.687716289870544,-63.312283710129456,-0.7619398956998111,-0.6819424060246791,-0.02146860096056491,-184692428.0,1.0
3150,2015-07-08,IBM,106.12289131593276,106.73114958886708,105.26873327018129,105.57933807373048,2904010.0,0.0,0.0,-1.1905975341796733,1.1905975341796733,0.0,34.09202070772635,104.90631454527212,109.98600129359278,13.249311656488667,-86.75068834351133,-0.8215176687428425,-0.7098574585683118,-0.022817917762879447,-187596438.0,-1.0
3151,2015-07-09,IBM,106.98995643915994,107.09996012052888,105.92873230358376,106.02579498291016,4392886.0,0.0,0.0,0.4464569091796733,0.0,0.4464569091796733,40.25427294579873,104.90631454527212,109.98600129359278,22.038375457071886,-77.96162454292812,-0.8232185902665776,-0.7325296849079651,-0.013427300798685038,-183203552.0,1.0
3152,2015-07-10,IBM,107.19703254589976,108.32297212207033,107.10644552336596,108.0317840576172,4747062.0,0.0,0.0,2.0059890747070455,0.0,2.0059890747070455,59.75982532678757,104.90631454527212,109.98600129359278,61.52878449401153,-38.47121550598847,-0.6551478921644929,-0.7170533263592708,0.009005482071801962,-178456490.0,1.0
3153,2015-07-13,IBM,108.66593796216904,109.93422861383848,108.40063189576824,109.60421752929688,4423534.0,0.0,0.0,1.5724334716796733,0.0,1.5724334716796733,68.93336985765592,104.90631454527212,109.98600129359278,92.4841081111523,-7.5158918888476975,-0.39056620910533013,-0.6517559029084827,0.03933268187741712,-174032956.0,1.0
3154,2015-07-14,IBM,109.63656417993144,109.70774485673792,108.86651773738724,109.10594177246094,3164464.0,0.0,0.0,-0.4982757568359375,0.4982757568359375,0.0,63.62963130540564,104.90631454527212,109.93422861383848,83.52623314396219,-16.473766856037813,-0.2185704641301669,-0.5651188151528196,0.036579370867757977,-177197420.0,-1.0
3155,2015-07-15,IBM,109.02181866116636,109.53302439442342,108.71122428138092,109.0541763305664,2089908.0,0.0,0.0,-0.05176544189453125,0.05176544189453125,0.0,63.0481403635511,104.90631454527212,109.93422861383848,82.49667215328894,-17.50332784671106,-0.0854545685414223,-0.4691859658305401,0.0245608776190136,-179287328.0,-1.0
3156,2015-07-16,IBM,109.66246791835974,110.71075128270144,109.46186685051072,110.65251159667967,3692275.0,0.0,0.0,1.598335266113267,0.0,1.598335266113267,72.1240330334247,104.90631454527212,110.71075128270144,98.99663501117668,-1.0033649888233183,0.1473148816358787,-0.34588579633725636,0.035798769977685385,-175595053.0,1.0
3157,2015-07-17,IBM,110.21894587673324,111.6360734917821,110.07011917839158,111.62960815429688,4556794.0,0.0,0.0,0.9770965576172017,0.0,0.9770965576172017,76.24036445679062,104.90631454527212,111.6360734917821,99.90392913718586,-0.0960708628141436,0.405950331452118,-0.19551857077938148,0.047228774378291094,-171038259.0,1.0
3158,2015-07-20,IBM,111.81079559970792,112.45141141316826,111.3901871710692,112.08904266357422,7717179.0,0.0,0.0,0.45943450927734375,0.0,0.45943450927734375,78.00268199399726,104.90631454527212,112.45141141316826,95.19729493287363,-4.802705067126364,0.6406087748521827,-0.028293101653068607,0.04981839714877556,-163321080.0,1.0
3159,2015-07-21,IBM,106.34283410756528,107.64349222282009,104.841585354962,105.52103424072266,14384906.0,0.0,0.0,-6.5680084228515625,6.5680084228515625,0.0,35.08110599645404,104.841585354962,112.45141141316826,8.928573144296095,-91.0714268557039,0.293213905894234,0.03600829985639194,-0.0005522276808281879,-177705986.0,-1.0
3160,2015-07-22,IBM,105.3010432056954,105.52106088804248,103.34036269898506,103.76097106933594,7512163.0,0.0,0.0,-1.7600631713867188,1.7600631713867188,0.0,29.98024224222148,103.34036269898506,112.45141141316826,4.616464948717861,-95.38353505128214,-0.12270692996285959,0.004265253892541622,-0.021361065143998936,-185218149.0,-1.0
3161,2015-07-23,IBM,103.70922390453045,105.31400130923134,103.42450116820622,104.65396881103516,5265773.0,0.0,0.0,0.8929977416992188,0.0,0.8929977416992188,35.47290077374369,103.34036269898506,112.45141141316826,14.417726798071016,-85.58227320192898,-0.37593617604055396,-0.07177503209407753,-0.031266865358629436,-179952376.0,1.0
3162,2015-07-24,IBM,104.36925328921546,104.78338604968216,103.15271635831186,103.37273406982422,3951997.0,0.0,0.0,-1.2812347412109375,1.2812347412109375,0.0,31.39573056387188,103.15271635831186,112.45141141316826,2.3661138494637193,-97.63388615053627,-0.672257745046565,-0.19187157468457505,-0.05685441308685957,-183904373.0,-1.0
3163,2015-07-27,IBM,102.88738718679627,103.6509578478987,102.628556851652,102.93268585205078,3876685.0,0.0,0.0,-0.4400482177734375,0.4400482177734375,0.0,30.027977528086822,102.628556851652,112.45141141316826,3.0961366524787737,-96.90386334752122,-0.9318610230924946,-0.33986946436615906,-0.05658038251742881,-187781058.0,-1.0
3164,2015-07-28,IBM,103.4762590360956,103.657443404444,102.5638615289056,103.56685638427734,2846166.0,0.0,0.0,0.6341705322265625,0.0,0.6341705322265625,34.75449623423533,102.5638615289056,112.45141141316826,10.14401815527766,-89.85598184472235,-1.0740453036278694,-0.48670463221850124,-0.050317375555208765,-184934892.0,1.0
3165,2015-07-29,IBM,103.53449888285348,104.50513606860706,103.13977247429943,104.23983001708984,3533806.0,0.0,0.0,0.6729736328125,0.0,0.6729736328125,39.73869532666219,102.5638615289056,112.45141141316826,16.95029110145644,-83.04970889854356,-1.1195189053770633,-0.6132674868502138,-0.05795333053951446,-181401086.0,1.0
3166,2015-07-30,IBM,103.85802937508738,104.44041573230736,103.37271601741536,104.15569305419922,2086456.0,0.0,0.0,-0.084136962890625,0.084136962890625,0.0,39.30554829653758,102.5638615289056,112.45141141316826,16.099352659926648,-83.90064734007335,-1.1491001014467486,-0.7204340097695209,-0.06695280243004209,-183487542.0,-1.0
3167,2015-07-31,IBM,104.44042191621536,104.86749563065102,103.94215720002389,104.82219696044922,3744889.0,0.0,0.0,0.66650390625,0.0,0.66650390625,44.804606829375,102.5638615289056,112.45141141316826,22.840192544950433,-77.15980745504957,-1.1060126915845814,-0.797549746132533,-0.06483100872701553,-179742653.0,1.0
3168,2015-08-03,IBM,104.63454364799964,104.73160632192052,102.17559847663895,102.69974517822266,4828022.0,0.0,0.0,-2.1224517822265625,2.1224517822265625,0.0,33.614213640048305,102.17559847663895,112.45141141316826,5.100780880512366,-94.89921911948763,-1.2289630090316024,-0.883832398712347,-0.026736745737952705,-184570675.0,-1.0
3169,2015-08-04,IBM,102.49913921258371,102.77092088323694,101.50908552721457,101.9814682006836,5502588.0,0.0,0.0,-0.7182769775390625,0.7182769775390625,0.0,30.627232681001658,101.50908552721457,112.45141141316826,4.317022526951148,-95.68297747304885,-1.3685847772164976,-0.9807828744131772,-0.01715002134534027,-190073263.0,-1.0
3170,2015-08-05,IBM,102.952109861388,103.23682221755732,101.90381646162794,102.17559814453124,3632549.0,0.0,0.0,0.19412994384764204,0.0,0.19412994384764204,32.49781078047731,101.50908552721457,112.45141141316826,6.091142086823152,-93.90885791317685,-1.4468924943511041,-1.0740047984007628,-0.023681573615033202,-186440714.0,1.0
3171,2015-08-06,IBM,102.52138440288002,102.78890321166614,101.90154762380112,101.9928970336914,3143021.0,1.24283,0.0,-0.18270111083982954,0.18270111083982954,0.0,31.573317810293872,101.50908552721457,112.45141141316826,4.421468630338394,-95.5785313696616,-1.5063303386192644,-1.1604699064444632,-0.013348172016044213,-189583735.0,-1.0
3172,2015-08-07,IBM,101.71233897008658,101.94722108533348,100.70101812149038,101.2099380493164,3969465.0,0.0,0.0,-0.782958984375,0.782958984375,0.0,27.679674083919863,100.70101812149038,107.64349222282009,7.330526846741186,-92.66947315325882,-1.5981905590801517,-1.248014036971601,-0.016736644812810453,-193553200.0,-1.0
3173,2015-08-10,IBM,102.28651644740494,102.7432427325961,101.86241644365626,102.27346801757812,4825616.0,0.0,0.0,1.0635299682617188,0.0,1.0635299682617188,39.39384029843008,100.70101812149038,105.52106088804248,32.623152371167826,-67.37684762883217,-1.567107821983555,-1.311832793973992,-0.01248843898380192,-188727584.0,1.0
3174,2015-08-11,IBM,101.75800650196518,101.7775843512549,101.04030129175356,101.4644012451172,3312787.0,0.0,0.0,-0.8090667724609233,0.8090667724609233,0.0,34.49009466907704,100.70101812149038,105.31400130923134,16.548578058023697,-83.4514219419763,-1.5894374106998157,-1.3673537173191568,-0.02662541536682872,-192040371.0,-1.0
3175,2015-08-12,IBM,100.64884548450112,102.1234014515373,100.44657918968028,101.88851928710938,3724074.0,0.0,0.0,0.4241180419921733,0.0,0.4241180419921733,39.07711204522038,100.44657918968028,104.86749563065102,32.61631647379601,-67.38368352620398,-1.5549860775898168,-1.404880189373289,-0.021767161262227663,-188316297.0,1.0
3176,2015-08-13,IBM,101.82327417455676,101.84284161300198,100.68798784969174,101.17733001708984,2649936.0,0.0,0.0,-0.7111892700195312,0.7111892700195312,0.0,34.41467065157188,100.44657918968028,104.86749563065102,16.529396951214654,-83.47060304878534,-1.5670067005098645,-1.4373054916006043,-0.03477189993198326,-190966233.0,-1.0
3177,2015-08-14,IBM,101.13166005725898,101.92113690288664,100.85762221060492,101.62100219726562,3374814.0,0.0,0.0,0.44367218017578125,0.0,0.44367218017578125,39.60194026922019,100.44657918968028,104.86749563065102,26.565148273362695,-73.4348517266373,-1.523174288703757,-1.454479251021235,-0.010503852556644655,-187591419.0,1.0
3178,2015-08-17,IBM,101.26216954058496,102.2343454683066,100.93593789484842,101.98640441894533,2353082.0,0.0,0.0,0.3654022216797017,0.0,0.3654022216797017,43.82413969864174,100.44657918968028,104.86749563065102,34.830453138511125,-65.16954686148888,-1.442325648793414,-1.452048530575671,4.840309076570293e-05,-185238337.0,1.0
3179,2015-08-18,IBM,101.46441782633572,102.12340001011808,101.29477781726789,101.7906494140625,2111142.0,0.0,0.0,-0.1957550048828267,0.1957550048828267,0.0,42.00884918739054,100.44657918968028,104.86749563065102,30.40252495898998,-69.59747504101001,-1.3781617216315993,-1.4372711687868567,-0.00376752118371948,-187349479.0,-1.0
3180,2015-08-19,IBM,101.2295662895649,101.5688464103409,100.0942796042746,100.44007873535156,4399894.0,0.0,0.0,-1.3505706787109375,1.3505706787109375,0.0,31.591534045775404,100.0942796042746,104.86749563065102,7.2445732429896275,-92.75542675701037,-1.4199231237623309,-1.4338015597819516,-0.01522476901334513,-191749373.0,-1.0
3181,2015-08-20,IBM,99.65714648105715,100.42052687124394,99.50055483072993,99.60494232177734,4196029.0,0.0,0.0,-0.8351364135742188,0.8351364135742188,0.0,26.842307603791696,99.50055483072993,104.73160632192052,1.9955355290081447,-98.00446447099186,-1.503081279520103,-1.447657503729582,-0.015858084279796736,-195945402.0,-1.0
3182,2015-08-21,IBM,98.84805267233725,99.95071280441282,97.02115774264796,97.11902618408205,7700757.0,0.0,0.0,-2.4859161376952983,2.4859161376952983,0.0,17.702129816017433,97.02115774264796,103.23682221755732,1.574545116280826,-98.42545488371918,-1.7494112498072099,-1.5080082529451078,-0.05039862178732579,-203646159.0,-1.0
3183,2015-08-24,IBM,93.60877227783205,96.40783239766984,93.30211854585716,93.60877227783205,10658426.0,0.0,0.0,-3.51025390625,3.51025390625,0.0,11.385486524161976,93.30211854585716,103.23682221755732,3.086692287042433,-96.91330771295756,-2.202488760361973,-1.6469043544284812,-0.07742251342229445,-214304585.0,-1.0
3184,2015-08-25,IBM,95.87282021168878,95.98373708129375,91.74925570055392,91.97109985351562,7398567.0,0.0,0.0,-1.6376724243164205,1.6376724243164205,0.0,9.550888157998642,91.74925570055392,102.78890321166614,2.0095220679682533,-97.99047793203175,-2.663004966179571,-1.8501244767786993,-0.09733598547690814,-221703152.0,-1.0
3185,2015-08-26,IBM,94.01329516274608,95.89891310934044,92.74099509854346,95.71622467041016,6508003.0,0.0,0.0,3.7451248168945312,0.0,3.7451248168945312,36.535119097515675,91.74925570055392,102.7432427325961,36.08307848912713,-63.91692151087287,-2.6947042307438807,-2.0190404275717357,-0.053975582729424154,-215195149.0,1.0
3186,2015-08-27,IBM,96.89067406953262,97.1973278600926,95.03768206590344,96.9167709350586,5205524.0,0.0,0.0,1.2005462646484375,0.0,1.2005462646484375,42.84237463999703,91.74925570055392,102.7432427325961,47.00310469208173,-52.996895307918265,-2.593060884367972,-2.133844518930983,-0.04629191958838619,-209989625.0,1.0
3187,2015-08-28,IBM,96.40133703916078,96.69494241289452,96.02943065084575,96.55139923095705,4263810.0,0.0,0.0,-0.3653717041015483,0.3653717041015483,0.0,41.39764523308161,91.74925570055392,102.2343454683066,45.79973692902769,-54.20026307097232,-2.5130216932682288,-2.209679953798432,-0.05329146780841565,-214253435.0,-1.0
3188,2015-08-31,IBM,96.15990229885544,96.82541390102864,95.42913813124784,96.4926528930664,4281383.0,0.0,0.0,-0.05874633789063921,0.05874633789063921,0.0,41.140265784478785,91.74925570055392,102.2343454683066,45.23945238028384,-54.76054761971615,-2.4263608190102133,-2.2530161268407887,-0.05204796856580585,-218534818.0,-1.0
3189,2015-09-01,IBM,94.548313909772,94.59397820506015,92.55177927877058,93.09331512451172,5514512.0,0.0,0.0,-3.3993377685546875,3.3993377685546875,0.0,29.07220228011188,91.74925570055392,102.2343454683066,12.818768877797412,-87.18123112220259,-2.601985530755343,-2.3228100076236995,-0.07314573727284457,-224049330.0,-1.0
3190,2015-09-02,IBM,94.43740501327072,94.6592491801518,93.419564855971,94.6396713256836,4447592.0,0.0,0.0,1.546356201171875,0.0,1.546356201171875,38.53579213731776,91.74925570055392,102.2343454683066,27.56691348527379,-72.43308651472621,-2.5865749323908602,-2.375562992577132,-0.04984964481032739,-219601738.0,1.0
3191,2015-09-03,IBM,95.29211602920724,96.58399382898148,95.10942760680234,95.7684097290039,3769261.0,0.0,0.0,1.1287384033203125,0.0,1.1287384033203125,44.74508337841732,91.74925570055392,102.2343454683066,38.332089829226454,-61.66791017077355,-2.4549826544057822,-2.391446924942862,-0.013906816286626933,-215832477.0,1.0
3192,2015-09-04,IBM,94.32648568179052,94.86803203254247,93.51091185812956,93.75884246826172,4394351.0,0.0,0.0,-2.0095672607421875,2.0095672607421875,0.0,37.055107592618114,91.74925570055392,102.12340001011808,19.371108669224103,-80.6288913307759,-2.4842136408367423,-2.4100002681216384,0.0016031637503401974,-220226828.0,-1.0
3193,2015-09-08,IBM,95.1681598463336,96.13380618121542,95.03766512820742,96.0620346069336,4114232.0,0.0,0.0,2.303192138671875,0.0,2.303192138671875,48.71174097247734,91.74925570055392,101.5688464103409,43.92014936102399,-56.07985063897601,-2.2950748568548534,-2.3870151858682815,0.04448065490065556,-216112596.0,1.0
3194,2015-09-09,IBM,97.04725797891255,97.2429948685852,94.50917659465102,94.6396713256836,3564559.0,0.0,0.0,-1.42236328125,1.42236328125,0.0,43.03311002040621,91.74925570055392,100.42052687124394,33.33323993948711,-66.6667600605129,-2.2341993778023266,-2.356452024255091,-0.011247344412439686,-219677155.0,-1.0
3195,2015-09-10,IBM,95.16162861132146,96.01635806432562,94.28733171990956,95.3899917602539,3620938.0,0.0,0.0,0.7503204345703125,0.0,0.7503204345703125,46.80748193695852,91.74925570055392,99.95071280441282,44.391332096182914,-55.608667903817086,-2.1011893310256085,-2.3053994856091946,-0.01575350850089452,-216056217.0,1.0
3196,2015-09-11,IBM,95.20076825903423,96.23818608694306,95.044176692298,96.1533660888672,3258395.0,0.0,0.0,0.7633743286132955,0.0,0.7633743286132955,50.64616100945118,91.74925570055392,97.2429948685852,80.1659899316175,-19.834010068382508,-1.9121380450174144,-2.226747197490839,-0.0041224999871594115,-212797822.0,1.0
3197,2015-09-14,IBM,96.15335803224612,96.15335803224612,94.87452874667744,95.03112030029295,3375128.0,0.0,0.0,-1.1222457885742472,1.1222457885742472,0.0,45.122548372643585,91.74925570055392,97.2429948685852,59.73826749614535,-40.26173250385465,-1.8317540742133218,-2.1477485728353356,-0.015146568665628135,-216172950.0,-1.0
3198,2015-09-15,IBM,95.6509782901259,96.51874573324557,95.10290258381252,96.2577667236328,2842087.0,0.0,0.0,1.2266464233398438,0.0,1.2266464233398438,51.758145318734435,92.55177927877058,97.2429948685852,78.99844664799696,-21.001553352003047,-1.6500483530694652,-2.0482085288821614,0.03399225384646187,-213330863.0,1.0
3199,2015-09-16,IBM,96.46002577213078,97.14511522073124,96.26428890503098,96.8319320678711,2927963.0,0.0,0.0,0.5741653442382955,0.0,0.5741653442382955,54.7154853746636,92.55177927877058,97.2429948685852,91.2376058434281,-8.762394156571897,-1.4430799873557305,-1.9271828205768753,0.023164289472680677,-210402900.0,1.0
3200,2015-09-17,IBM,96.62969537070218,97.66058404544654,96.10771640317029,96.65579223632812,4187138.0,0.0,0.0,-0.17613983154296875,0.17613983154296875,0.0,53.55341364353313,92.55177927877058,97.66058404544654,80.33215487754521,-19.667845122454796,-1.2785309695850913,-1.7974524503785185,0.009265920879706124,-214590038.0,-1.0
3201,2015-09-18,IBM,95.2921453549474,95.51397913318952,93.94154400130309,94.287353515625,8342687.0,0.0,0.0,-2.368438720703125,2.368438720703125,0.0,40.28041386422199,92.55177927877058,97.66058404544654,33.972216910212225,-66.02778308978777,-1.3239759280307624,-1.7027571459089674,0.005636919499536042,-222932725.0,-1.0
3202,2015-09-21,IBM,94.8614988969823,95.89891684114494,94.55484515072897,95.57268524169922,4000950.0,0.0,0.0,1.2853317260742188,0.0,1.2853317260742188,48.3035415136299,92.55177927877058,97.66058404544654,59.131364397277366,-40.868635602722634,-1.2419593227041332,-1.6105975812680007,-0.005094097446891377,-218931775.0,1.0
3203,2015-09-22,IBM,94.35908031475194,94.64616653649952,93.80448571864817,94.23511505126952,3728049.0,0.0,0.0,-1.3375701904297017,1.3375701904297017,0.0,41.59381353262496,93.419564855971,97.66058404544654,19.230051996047862,-80.76994800395214,-1.2702486719246195,-1.5425277993993247,-0.004274700754421268,-222659824.0,-1.0
3204,2015-09-23,IBM,94.09157721870226,94.326459331832,93.13897951094144,93.73271942138672,2797213.0,0.0,0.0,-0.5023956298827983,0.5023956298827983,0.0,39.232010461288965,93.13897951094144,97.66058404544654,13.131177348977632,-86.86882265102237,-1.3180140678922925,-1.4976250530979185,-0.01737365008933489,-225457037.0,-1.0
3205,2015-09-24,IBM,93.04115321448924,94.65273370095328,92.61705308647238,94.22211456298828,3431194.0,0.0,0.0,0.4893951416015625,0.0,0.4893951416015625,42.87772093942294,92.61705308647238,97.66058404544654,31.824162269886507,-68.17583773011349,-1.3013769273073734,-1.4583754279398096,-0.02008511614761377,-222025843.0,1.0
3206,2015-09-25,IBM,94.9659082747033,95.43568308452708,94.30039656422451,94.88108825683594,3634222.0,0.0,0.0,0.6589736938476562,0.0,0.6589736938476562,47.748130392032884,92.61705308647238,97.66058404544654,44.88988347211523,-55.11011652788477,-1.2209439221853984,-1.4108891267889274,-0.0015787674919849337,-218391621.0,1.0
3207,2015-09-28,IBM,94.22861890743258,94.8549852801726,92.95631872139958,92.98894500732422,4515896.0,0.0,0.0,-1.8921432495117188,1.8921432495117188,0.0,37.2309767474715,92.61705308647238,97.66058404544654,7.373642074906169,-92.62635792509383,-1.294952921869296,-1.3877018858050012,-0.03395904380052517,-222907517.0,-1.0
3208,2015-09-29,IBM,92.6431309161583,93.08027938799395,92.0950655742116,92.95631408691406,4982621.0,0.0,0.0,-0.03263092041015625,0.03263092041015625,0.0,37.06850787366978,92.0950655742116,97.66058404544654,15.474722025517895,-84.52527797448211,-1.3407829190119713,-1.3783180924463954,-0.04002417279292281,-227890138.0,-1.0
3209,2015-09-30,IBM,93.75231936713566,95.07029418985346,93.73274151403156,94.58747100830078,4127725.0,0.0,0.0,1.6311569213867188,0.0,1.6311569213867188,49.723109454068755,92.0950655742116,97.66058404544654,44.78298737073702,-55.217012629262975,-1.2312892544517382,-1.3489123248474642,-0.02139883373952589,-223762413.0,1.0
3210,2015-10-01,IBM,94.80930305113354,95.0441852154258,92.3821491696915,93.68706512451172,4059421.0,0.0,0.0,-0.9004058837890625,0.9004058837890625,0.0,44.077764374740305,92.0950655742116,97.66058404544654,28.604694396906133,-71.39530560309387,-1.2032990834381252,-1.3197896765655965,-0.006366584369279171,-227821834.0,-1.0
3211,2015-10-02,IBM,92.0298237373092,94.33954208065778,91.71012152066407,94.33302307128906,3194902.0,0.0,0.0,0.6459579467773438,0.0,0.6459579467773438,48.881955472721934,91.71012152066407,97.66058404544654,44.078952513374155,-55.92104748662585,-1.116127243346213,-1.27905718992172,-0.012970883545597833,-224626932.0,1.0
3212,2015-10-05,IBM,95.1420737134739,97.79759102007796,95.1420737134739,97.24299621582033,5367863.0,0.0,0.0,2.909973144531264,0.0,2.909973144531264,64.6620535899416,91.71012152066407,97.79759102007796,90.88956742516689,-9.110432574833112,-0.8029762090284578,-1.1838409937430676,0.03191889947727389,-219259069.0,1.0
3213,2015-10-06,IBM,97.25604508972388,97.96723149387172,96.88414915800428,97.07335662841795,3156933.0,0.0,0.0,-0.16963958740237217,0.16963958740237217,0.0,63.34669085638541,91.71012152066407,97.96723149387172,85.71425355665386,-14.285746443346131,-0.5620117337400217,-1.0594751417424584,0.0356400329325024,-222416002.0,-1.0
3214,2015-10-07,IBM,97.89546666749472,98.34566363584614,97.12556747323164,97.92809295654295,3117917.0,0.0,0.0,0.854736328125,0.0,0.854736328125,67.22299758770122,91.71012152066407,98.34566363584614,93.70706007052861,-6.292939929471386,-0.2986331159999338,-0.9073067365939534,0.03933236279766561,-219298085.0,1.0
3215,2015-10-08,IBM,97.66707556390767,99.83977960136956,97.40609656735464,99.3569564819336,5014942.0,0.0,0.0,1.4288635253906392,0.0,1.4288635253906392,72.77637716581879,91.71012152066407,99.83977960136956,94.06096646817323,-5.939033531826769,0.025104294408805572,-0.7208245303934017,0.047173449496930475,-214283143.0,1.0
3216,2015-10-09,IBM,99.47442380300134,99.9246207379566,98.69798482927116,99.42874908447266,3693531.0,0.0,0.0,0.0717926025390625,0.0,0.0717926025390625,73.0411819499875,91.71012152066407,99.9246207379566,93.96345850955741,-6.036541490442591,0.2841856720608291,-0.5198224899025555,0.06925343734829137,-210589612.0,1.0
3217,2015-10-12,IBM,99.43524702521768,99.55269330119197,98.42393649155136,98.61314392089844,3376070.0,0.0,0.0,-0.8156051635742188,0.8156051635742188,0.0,64.78123416873571,91.71012152066407,99.9246207379566,84.03461023774469,-15.965389762255313,0.4188685540721764,-0.33208428110760907,0.06085471320103375,-213965682.0,-1.0
3218,2015-10-13,IBM,98.37827524679392,98.37827524679392,97.33433829053878,97.62141418457033,4095822.0,0.0,0.0,-0.9917297363281108,0.9917297363281108,0.0,55.91041897346388,91.71012152066407,99.9246207379566,71.96169246035421,-28.03830753964579,0.44050355612245085,-0.17756671366159707,0.032075529073013254,-218061504.0,-1.0
3219,2015-10-14,IBM,97.60835370009168,98.29344310076849,97.22992842258712,97.87586212158205,3507238.0,0.0,0.0,0.25444793701171875,0.0,0.25444793701171875,57.62811231407208,91.71012152066407,99.9246207379566,75.05923900921839,-24.940760990781623,0.47273191388786984,-0.047506988151703664,0.044710515709968535,-214554266.0,1.0
3220,2015-10-15,IBM,98.46310994541722,98.67842470837977,96.94286858556404,97.92809295654295,3636105.0,0.0,0.0,0.05223083496090908,0.0,0.05223083496090908,58.01552543347759,91.71012152066407,99.9246207379566,75.695076125752,-24.304923874248008,0.4967613557934243,0.06134668063732196,0.0381104068141338,-210918161.0,1.0
3221,2015-10-16,IBM,98.16294747262262,98.65230001529916,97.38651907405956,98.1238021850586,3643950.0,0.0,0.0,0.1957092285156392,0.0,0.1957092285156392,59.6120675357153,91.71012152066407,99.9246207379566,78.07756133073744,-21.92243866926257,0.5255388757344122,0.15418511965674003,0.009057783115643758,-207274211.0,1.0
3222,2015-10-19,IBM,97.77150241887504,97.8497930169441,96.8123853168852,97.3604507446289,8320616.0,0.0,0.0,-0.7633514404296875,0.7633514404296875,0.0,50.90086780702897,91.71012152066407,99.9246207379566,68.78482880697337,-31.215171193026634,0.48120218669966164,0.2195885330653244,0.0029574965385188445,-215594827.0,-1.0
3223,2015-10-20,IBM,92.96935647326087,93.22381648123664,91.52088700612909,91.76229858398438,16762778.0,0.0,0.0,-5.598152160644531,5.598152160644531,0.0,22.758648857309893,91.52088700612909,99.9246207379566,2.8726704767071416,-97.12732952329286,-0.005594561817147792,0.17455191408882995,-0.06296246752497003,-232357605.0,-1.0
3224,2015-10-21,IBM,91.50782841178344,93.0802629972772,90.8879916017807,91.94497680664062,7312168.0,0.0,0.0,0.18267822265625,0.0,0.18267822265625,24.333810047674916,90.8879916017807,99.9246207379566,11.69667570652589,-88.3033242934741,-0.3723516483142504,0.06517120160821385,-0.07459950402809201,-225045437.0,1.0
3225,2015-10-22,IBM,92.48001890247684,94.65271279733244,92.40171790411404,94.01329803466795,5840027.0,0.0,0.0,2.0683212280273295,0.0,2.0683212280273295,40.251535449416416,90.8879916017807,99.9246207379566,34.58486993093329,-65.4151300690667,-0.4904593343788548,-0.045954905589199915,-0.054465645999466905,-219205410.0,1.0
3226,2015-10-23,IBM,94.3525949305889,94.9267676420618,93.75885477634073,94.39826965332033,5617438.0,0.0,0.0,0.38497161865237217,0.0,0.38497161865237217,42.83423446097923,90.8879916017807,99.9246207379566,38.844994064070875,-61.15500593592913,-0.5466945794158562,-0.14610284035453122,-0.04274150584793268,-213587972.0,1.0
3227,2015-10-26,IBM,94.44390559527147,94.60701614893814,93.43911417653725,93.73271942138672,3649912.0,0.0,0.0,-0.665550231933608,0.665550231933608,0.0,39.43393478587623,90.8879916017807,99.9246207379566,31.479966442551664,-68.52003355744833,-0.6376157206171342,-0.24440541640705185,-0.03983444406809511,-217237884.0,-1.0
3228,2015-10-27,IBM,93.6348717750678,93.84365707902036,89.60265677802415,89.94845581054688,15698891.0,0.0,0.0,-3.7842636108398438,3.7842636108398438,0.0,25.92965612713367,89.60265677802415,99.9246207379566,3.350128268854982,-96.64987173114503,-1.0034625355783788,-0.3962168402413173,-0.08099449792010716,-232936775.0,-1.0
3229,2015-10-28,IBM,89.9876051191439,92.14725040802914,89.71356726773291,91.88626098632812,8902924.0,0.0,0.0,1.93780517578125,0.0,1.93780517578125,38.3947520200344,89.60265677802415,99.9246207379566,22.123737470586125,-77.87626252941388,-1.1240764360061775,-0.5417887593942895,-0.061696616239590996,-224033851.0,1.0
3230,2015-10-29,IBM,91.57961746075382,91.87975220499116,90.70532050411845,91.70358276367188,3881078.0,0.0,0.0,-0.18267822265625,0.18267822265625,0.0,37.70456034475903,89.60265677802415,99.55269330119197,21.11475652130415,-78.88524347869584,-1.2203371400175769,-0.6774984355189471,-0.06542978643732511,-227914929.0,-1.0
3231,2015-10-30,IBM,91.63179375107768,92.21248527544756,91.27946534922684,91.39691162109376,4167264.0,0.0,0.0,-0.3066711425781108,0.3066711425781108,0.0,36.435854757482986,89.60265677802415,98.67842470837977,19.76973030643927,-80.23026969356073,-1.3063118894057482,-0.8032611262963074,-0.0612521724984324,-232082193.0,-1.0
3232,2015-11-02,IBM,91.67097113640456,91.68401956817094,91.0641826111344,91.58615112304688,3998021.0,0.0,0.0,0.1892395019531108,0.0,0.1892395019531108,37.92310399956553,89.60265677802415,98.67842470837977,21.854837631849872,-78.14516236815014,-1.3436882497175162,-0.9113465509805493,-0.001919606021816067,-228084172.0,1.0
3233,2015-11-03,IBM,91.35778830119342,93.17163487503896,91.27948729653872,92.57136535644533,4549472.0,0.0,0.0,0.9852142333984517,0.0,0.9852142333984517,45.57295673508344,89.60265677802415,98.67842470837977,32.71027422915662,-67.28972577084339,-1.279066447870548,-0.9848905303585491,0.006812645688322849,-223534700.0,1.0
3234,2015-11-04,IBM,93.0084772523931,93.07372979955004,92.1929037229182,92.40821838378906,3678677.0,0.0,0.0,-0.1631469726562642,0.1631469726562642,0.0,44.52457578494779,89.60265677802415,98.65230001529916,31.0019028618603,-68.9980971381397,-1.226875148539989,-1.0332874539948371,-0.017072900158092597,-227213377.0,-1.0
3235,2015-11-05,IBM,92.3952101864276,92.89760086678793,91.10333207246084,91.2729721069336,5331357.0,0.0,0.0,-1.1352462768554688,1.1352462768554688,0.0,37.58294248732957,89.60265677802415,97.8497930169441,20.25327678020976,-79.74672321979024,-1.2625640027903842,-1.0791427637539466,-0.033107572393693774,-232544734.0,-1.0
3236,2015-11-06,IBM,91.27954700837913,91.9051981370323,90.79878550115966,91.04904174804688,4963165.0,1.24283,0.0,-0.22393035888671875,0.22393035888671875,0.0,36.295048673662826,89.60265677802415,94.9267676420618,27.166695190224193,-72.8333048097758,-1.294000552524082,-1.1221143215079736,-0.028631172656743753,-237507899.0,-1.0
3237,2015-11-09,IBM,90.8317348863271,90.9371015315694,88.82964248947835,89.11283111572266,8447078.0,0.0,0.0,-1.9362106323242188,1.9362106323242188,0.0,27.047859999467846,88.82964248947835,94.9267676420618,4.64462544490035,-95.35537455509964,-1.4583394319307956,-1.189359343592538,-0.009290039359700075,-245954977.0,-1.0
3238,2015-11-10,IBM,89.14573587553382,89.39599209201778,88.32909207030637,89.21817016601562,4728757.0,0.0,0.0,0.10533905029296875,0.0,0.10533905029296875,28.196262399610006,88.32909207030637,94.9267676420618,13.475626166211994,-86.524373833788,-1.56207259632086,-1.2639019941382026,-0.029036885293542314,-241226220.0,1.0
3239,2015-11-11,IBM,89.62648513377361,89.69892992583566,88.57933623864595,88.92179870605469,3310381.0,0.0,0.0,-0.2963714599609375,0.2963714599609375,0.0,26.8253901349415,88.32909207030637,94.9267676420618,8.983567459510802,-91.0164325404892,-1.6491857892008852,-1.3409587531507392,-0.03033451882448357,-244536601.0,-1.0
3240,2015-11-12,IBM,88.71106767790262,88.71106767790262,87.598064499737,87.6178207397461,4917664.0,0.0,0.0,-1.3039779663085938,1.3039779663085938,0.0,21.514978926769714,87.598064499737,94.60701614893814,0.2818715408222162,-99.71812845917778,-1.8026637605451867,-1.4332997546296289,-0.04134812450791259,-249454265.0,-1.0
3241,2015-11-13,IBM,87.55855410922679,87.59148643438822,86.70239774650781,86.76825714111328,4826035.0,0.0,0.0,-0.8495635986328125,0.8495635986328125,0.0,18.727925313412413,86.70239774650781,93.84365707902036,0.9222378230352869,-99.07776217696471,-1.970138312793651,-1.5406674662624336,-0.05260504915705766,-254280300.0,-1.0
3242,2015-11-16,IBM,86.79459613817404,88.30933588911691,86.79459613817404,88.05907440185547,4383577.0,0.0,0.0,1.2908172607421875,0.0,1.2908172607421875,33.769102105836566,86.70239774650781,93.17163487503896,20.97119997911858,-79.02880002088142,-1.9759276726693713,-1.6277195075438213,-0.048743917054861585,-249896723.0,1.0
3243,2015-11-17,IBM,88.39494780649018,88.79009363397242,87.79563839613958,88.13151550292969,2944595.0,0.0,0.0,0.07244110107421875,0.0,0.07244110107421875,34.55342622501827,86.70239774650781,93.17163487503896,22.090978086412456,-77.90902191358755,-1.952167024364698,-1.6926090109079972,-0.046280546856746096,-246952128.0,1.0
3244,2015-11-18,IBM,88.77035026293137,89.50795867387563,88.42129704366691,89.44868469238281,4340063.0,0.0,0.0,1.317169189453125,0.0,1.317169189453125,47.577745874610244,86.70239774650781,93.17163487503896,42.45148061991891,-57.54851938008109,-1.8062308885073577,-1.7153333864278693,-0.019987159094737028,-242612065.0,1.0
3245,2015-11-19,IBM,89.70553508506364,90.71317178666736,89.57382680045265,90.0545883178711,4972266.0,0.0,0.0,0.6059036254882812,0.0,0.6059036254882812,52.58598188589831,86.70239774650781,93.17163487503896,51.81740141475385,-48.18259858524615,-1.6229754399931977,-1.696861797140935,-0.010922173491157205,-237639799.0,1.0
3246,2015-11-20,IBM,90.46949262713429,91.4902896111708,90.39045714761072,91.21369171142578,5414514.0,0.0,0.0,1.1591033935546875,0.0,1.1591033935546875,60.843342328632914,86.70239774650781,93.17163487503896,69.73455873215558,-30.26544126784443,-1.368439698908034,-1.6311773774943548,0.023575287300376946,-232225285.0,1.0
3247,2015-11-23,IBM,91.23344293129026,91.4573574937512,90.30483133653458,91.18733978271484,5374243.0,0.0,0.0,-0.0263519287109375,0.0263519287109375,0.0,60.566644258936485,86.70239774650781,93.07372979955004,70.3925332861208,-29.60746671387921,-1.1555245034945045,-1.536046802694385,0.0220713965892263,-237599528.0,-1.0
3248,2015-11-24,IBM,90.65390508224934,91.76690850091438,90.4299904689953,91.27955627441406,3564454.0,0.0,0.0,0.09221649169921875,0.0,0.09221649169921875,61.2776914144049,86.70239774650781,92.89760086678793,73.88229956371947,-26.117700436280515,-0.9681859322116679,-1.4224746285978418,0.026514955867608103,-234035074.0,1.0
3249,2015-11-25,IBM,91.12806784809857,91.16758032857632,90.47606461876232,90.88439178466795,3387157.0,0.0,0.0,-0.39516448974610796,0.39516448974610796,0.0,56.26161564298145,86.70239774650781,91.9051981370323,80.37967487233468,-19.620325127665332,-0.8419003335827853,-1.3063597695948306,0.037282039399549216,-237422231.0,-1.0
3250,2015-11-27,IBM,90.88438974963408,91.41784501415816,90.364105311641,91.18733978271484,1480927.0,0.0,0.0,0.3029479980468892,0.0,0.3029479980468892,59.21487490201121,86.70239774650781,91.76690850091438,88.55627431148679,-11.443725688513215,-0.7091975275925222,-1.186927321194369,0.050929715395973796,-235941304.0,1.0
3251,2015-11-30,IBM,91.28614285730828,92.13570862468544,91.2268688714102,91.81958770751952,4754698.0,0.0,0.0,0.6322479248046733,0.0,0.6322479248046733,64.91887565218406,86.70239774650781,92.13570862468544,94.18179956468923,-5.818200435310775,-0.5467103377001479,-1.0588839244955248,0.04270443825588077,-231186606.0,1.0
3252,2015-12-01,IBM,91.92496166386292,93.12358063489675,91.92496166386292,93.0445556640625,4388075.0,0.0,0.0,1.224967956542983,0.0,1.224967956542983,73.27464554620856,86.70239774650781,93.12358063489675,98.76930820679239,-1.2306917932076138,-0.3154570005080899,-0.9101985396980378,0.05574668871964983,-226798531.0,1.0
3253,2015-12-02,IBM,92.8140510610258,92.99845317239046,91.87227900563522,92.00399780273438,3896768.0,0.0,0.0,-1.040557861328125,1.040557861328125,0.0,59.40603513426435,86.70239774650781,93.12358063489675,82.5642276256162,-17.43577237438381,-0.21368812411874671,-0.7708964565821795,0.028567363725239492,-230695299.0,-1.0
3254,2015-12-03,IBM,92.26741148106018,92.68231879921257,91.0095186999501,91.4902801513672,6181442.0,0.0,0.0,-0.5137176513671733,0.5137176513671733,0.0,53.624434276630375,86.70239774650781,93.12358063489675,74.56386912008134,-25.43613087991866,-0.1724998071236854,-0.6512171266904807,0.01594246179249037,-236876741.0,-1.0
3255,2015-12-04,IBM,90.9436824743682,92.87332984047993,90.87781781670024,92.4847640991211,4781894.0,0.0,0.0,0.994483947753892,0.0,0.994483947753892,61.90573150901176,86.79459613817404,93.12358063489675,89.90649232737962,-10.093507672620369,-0.05893189561585643,-0.5327600804755559,0.01393510517825125,-232094847.0,1.0
3256,2015-12-07,IBM,92.30693367734132,92.47158479498526,91.41785548323,91.90519714355467,3430252.0,0.0,0.0,-0.5795669555664205,0.5795669555664205,0.0,55.26913294428592,87.79563839613958,93.12358063489675,77.13219406773659,-22.867805932263412,-0.015515860028244788,-0.42931123638609364,0.007872335814931963,-235525099.0,-1.0
3257,2015-12-08,IBM,91.06880529346628,91.58249913840652,90.5748729469604,90.9173355102539,4084839.0,0.0,0.0,-0.987861633300767,0.987861633300767,0.0,45.64524347642977,88.42129704366691,93.12358063489675,53.08141072653122,-46.91858927346878,-0.060127405628577435,-0.3554744702345904,-0.003968257285029031,-239609938.0,-1.0
3258,2015-12-09,IBM,90.47606674635472,92.09618359838126,89.71869688460116,89.96896362304688,4827290.0,0.0,0.0,-0.9483718872070312,0.9483718872070312,0.0,38.26458026334438,89.57382680045265,93.12358063489675,11.131386598138674,-88.86861340186132,-0.17004785650999565,-0.31838914748967145,-0.010072446364497889,-244437228.0,-1.0
3259,2015-12-10,IBM,90.2455761015944,90.78561157290837,89.38282907226093,90.08092498779295,4416526.0,0.0,0.0,0.11196136474607954,0.0,0.11196136474607954,39.595064412252064,89.38282907226093,93.12358063489675,18.661916030588444,-81.33808396941156,-0.2452986096537586,-0.3037710399224889,-0.012133425512338647,-240020702.0,1.0
3260,2015-12-11,IBM,89.06011127257567,89.19841019346305,88.19077373718997,88.62544250488281,5579155.0,0.0,0.0,-1.455482482910142,1.455482482910142,0.0,29.922192813938636,88.19077373718997,93.12358063489675,8.811793705018427,-91.18820629498157,-0.41756719141272924,-0.326530270220537,-0.0347871873789205,-245599857.0,-1.0
3261,2015-12-14,IBM,89.11280152645303,89.65942760717398,88.2632254183787,89.5211181640625,5380415.0,0.0,0.0,0.8956756591796875,0.0,0.8956756591796875,40.28117973072988,88.19077373718997,93.12358063489675,26.969318979240676,-73.03068102075933,-0.47632694286866695,-0.356489604750163,-0.037868282296079525,-240219442.0,1.0
3262,2015-12-15,IBM,90.48926968058952,91.52323767038686,90.41023418747923,90.7461166381836,4433471.0,0.0,0.0,1.2249984741210938,0.0,1.2249984741210938,51.5770713233059,88.19077373718997,93.12358063489675,51.803019132607396,-48.1969808673926,-0.41921488191002254,-0.36903466018213493,-0.013672027244379104,-235785971.0,1.0
3263,2015-12-16,IBM,91.62201334221112,91.97106658200768,90.74610593055073,91.73397064208984,4545393.0,0.0,0.0,0.98785400390625,0.0,0.98785400390625,58.82406509598433,88.19077373718997,93.12358063489675,71.82922377413703,-28.17077622586296,-0.29088841923014286,-0.35340541199173653,0.002663566996619293,-231240578.0,1.0
3264,2015-12-17,IBM,91.7734851760178,91.87227163806126,89.77139325725895,90.06117248535156,4277617.0,0.0,0.0,-1.6727981567382812,1.6727981567382812,0.0,45.51470319903596,88.19077373718997,93.12358063489675,37.91753431562712,-62.08246568437288,-0.3204753636027533,-0.34681940231393993,-0.026205306759197966,-235518195.0,-1.0
3265,2015-12-18,IBM,89.83723623324845,90.19946022336076,88.42787377328705,88.84278106689453,10487301.0,0.0,0.0,-1.2183914184570312,1.2183914184570312,0.0,38.24287047478794,88.19077373718997,93.12358063489675,13.217775259105972,-86.78222474089404,-0.4371974945567416,-0.3648950207625003,-0.03332146790215451,-246005496.0,-1.0
3266,2015-12-21,IBM,89.45527999622819,89.45527999622819,88.26324116923135,89.23794555664062,5875905.0,0.0,0.0,0.39516448974609375,0.0,0.39516448974609375,41.72703207060958,88.19077373718997,92.99845317239046,21.781232163350044,-78.21876783664995,-0.4921410567254725,-0.39034422795509477,-0.018471614287727034,-240129591.0,1.0
3267,2015-12-22,IBM,89.48820630315275,91.00952625504694,89.33672601691805,90.83829498291016,4459935.0,0.0,0.0,1.6003494262695312,0.0,1.6003494262695312,53.884495368927986,88.19077373718997,92.87332984047993,56.54008595561817,-43.45991404438183,-0.401916359956104,-0.3926586543552967,0.009662569455680448,-235669656.0,1.0
3268,2015-12-23,IBM,91.08197555855094,91.74714969402442,90.95684743306816,91.2400360107422,5402485.0,0.0,0.0,0.40174102783204546,0.0,0.40174102783204546,56.51246244904278,88.19077373718997,92.87332984047993,65.11961002260763,-34.880389977392376,-0.2945995342276291,-0.3730468303297632,0.012867441393461743,-230267171.0,1.0
3269,2015-12-24,IBM,91.1675897131172,91.4639491143579,90.95684595077503,91.04904174804688,1563979.0,0.0,0.0,-0.1909942626953267,0.1909942626953267,0.0,54.79940915924027,88.19077373718997,92.47158479498526,66.76931012061469,-33.2306898793853,-0.22239815002032515,-0.34291709426787564,0.027346540391383956,-231831150.0,-1.0
3270,2015-12-28,IBM,90.7131714876005,90.91074442530096,89.92286922536341,90.62755584716795,3287996.0,0.0,0.0,-0.42148590087892046,0.42148590087892046,0.0,50.872755977714704,88.19077373718997,92.09618359838126,62.39504166240515,-37.60495833759485,-0.19691846901609722,-0.31371736921751997,0.012359515897441442,-235119146.0,-1.0
3271,2015-12-29,IBM,91.04904963386754,92.24108852331716,91.01612781627948,92.0566864013672,4125110.0,0.0,0.0,1.4291305541992472,0.0,1.4291305541992472,61.629501012356165,88.19077373718997,92.24108852331716,95.44721505149285,-4.552784948507147,-0.06070695428731199,-0.2631152862314784,0.014442158097067948,-230994036.0,1.0
3272,2015-12-30,IBM,91.9249748434413,92.49135208326294,91.68788938551144,91.76691436767578,3126912.0,0.0,0.0,-0.28977203369142046,0.28977203369142046,0.0,58.62630638847372,88.19077373718997,92.49135208326294,83.15487691908528,-16.84512308091471,0.023587568288803595,-0.20577471532742198,0.00035912242057500876,-234120948.0,-1.0
3273,2015-12-31,IBM,91.5891011512801,91.6088521407252,90.6012258244889,90.63414764404295,3621357.0,0.0,0.0,-1.1327667236328267,1.1327667236328267,0.0,48.062247319984664,88.19077373718997,92.49135208326294,56.815007429968745,-43.18499257003126,-0.0010016762309845717,-0.1648201075081345,0.006362066391980337,-237742305.0,-1.0
3274,2016-01-04,IBM,89.30380410760995,89.5474802164895,88.40813515922251,89.53430938720703,5469952.0,0.0,0.0,-1.0998382568359233,1.0998382568359233,0.0,39.989513165639124,88.2632254183787,92.49135208326294,30.062580182023357,-69.93741981797665,-0.10799172389317846,-0.15345443078514331,0.0077837311260191555,-243212257.0,-1.0
3275,2016-01-05,IBM,90.06776195732122,90.15337760070808,88.8098689642628,89.46845245361328,4105341.0,0.0,0.0,-0.06585693359375,0.06585693359375,0.0,39.53076704123899,88.26324116923135,92.49135208326294,28.504722531811215,-71.49527746818877,-0.19583870495344513,-0.16193128561880368,0.0025830592079951753,-247317598.0,-1.0
3276,2016-01-06,IBM,88.50033300915422,89.29062473624184,87.99981000999573,89.0206069946289,4509201.0,0.0,0.0,-0.447845458984375,0.447845458984375,0.0,36.26635634611672,87.99981000999573,92.49135208326294,22.727093901864244,-77.27290609813576,-0.29815847083185076,-0.1891767226614131,-0.020010150879903876,-251826799.0,-1.0
3277,2016-01-07,IBM,88.05251744361294,88.92184488841802,87.2161170778842,87.49930572509766,7348987.0,0.0,0.0,-1.52130126953125,1.52130126953125,0.0,27.39830488966929,87.2161170778842,92.49135208326294,5.368265999992517,-94.63173400000748,-0.496283078467485,-0.25059799382262754,-0.040998781337658885,-259175786.0,-1.0
3278,2016-01-08,IBM,87.71003415226599,88.13152694382273,86.4850682631865,86.6892318725586,4981784.0,0.0,0.0,-0.8100738525390625,0.8100738525390625,0.0,23.819670559210095,86.4850682631865,92.49135208326294,3.3991668640375727,-96.60083313596243,-0.710474539028823,-0.34257330286386667,-0.0478841928677608,-264157570.0,-1.0
3279,2016-01-11,IBM,86.80778656008575,88.13153910147004,86.77485948421784,87.74297332763672,5203222.0,0.0,0.0,1.053741455078125,0.0,1.053741455078125,36.30635390609551,86.4850682631865,92.49135208326294,20.943150575828195,-79.0568494241718,-0.7861326380489402,-0.43128516990088145,-0.03182897842236554,-258954348.0,1.0
3280,2016-01-12,IBM,88.01955704028987,88.1051726691932,86.3599277687994,87.52561950683594,5312320.0,0.0,0.0,-0.21735382080078125,0.21735382080078125,0.0,34.94319047380016,86.3599277687994,92.49135208326294,19.01176102405388,-80.98823897594613,-0.8537889162847279,-0.5157859191776508,-0.049220399643495893,-264266668.0,-1.0
3281,2016-01-13,IBM,87.92078529388874,88.43447389753192,86.34018597354533,86.38628387451172,4916305.0,0.0,0.0,-1.1393356323242188,1.1393356323242188,0.0,28.476474102667424,86.34018597354533,92.49135208326294,0.7494172672976901,-99.25058273270231,-0.9879533566117402,-0.6102194066644687,-0.05863366476076426,-269182973.0,-1.0
3282,2016-01-14,IBM,86.88679113220803,88.11175682842492,86.41920051441437,87.5322036743164,5972242.0,0.0,0.0,1.1459197998046875,0.0,1.1459197998046875,41.12170905910509,86.34018597354533,92.49135208326294,19.378727212193574,-80.62127278780643,-0.9903968132184389,-0.6862548879752628,-0.034224892607906954,-263210731.0,1.0
3283,2016-01-15,IBM,85.62232721822461,86.19529505454068,84.87154268369284,85.635498046875,9422891.0,0.0,0.0,-1.8967056274414062,1.8967056274414062,0.0,30.741668712681246,84.87154268369284,92.49135208326294,10.025911714081246,-89.97408828591875,-1.132328781544146,-0.7754696666890395,-0.043545444947488576,-272633622.0,-1.0
3284,2016-01-19,IBM,85.68819212666135,86.99877375312487,84.33809801170615,84.37102508544922,10438662.0,0.0,0.0,-1.2644729614257812,1.2644729614257812,0.0,25.74309437233559,84.33809801170615,92.49135208326294,0.4038519277589551,-99.59614807224104,-1.3314946478783725,-0.8866746629269062,-0.05697457850639509,-283072284.0,-1.0
3285,2016-01-20,IBM,78.01569774741753,81.65765772923834,77.71274767689012,80.25487518310547,16901059.0,0.0,0.0,-4.11614990234375,4.11614990234375,0.0,15.982266871005734,77.71274767689012,92.49135208326294,17.201404383753154,-82.79859561624686,-1.8007163912288746,-1.0694830085873002,-0.09846856932858616,-299973343.0,-1.0
3286,2016-01-21,IBM,79.88607581856417,82.38869099213906,79.4118944417654,80.94639587402344,9258774.0,0.0,0.0,0.6915206909179688,0.0,0.6915206909179688,21.734767465126495,77.71274767689012,91.6088521407252,23.270177664171708,-76.72982233582829,-2.0926552359889,-1.2741174540676203,-0.07489099252583709,-290714569.0,1.0
3287,2016-01-22,IBM,82.10547740003848,82.15158054602175,80.19559203465454,80.67635345458984,9663366.0,0.0,0.0,-0.27004241943359375,0.27004241943359375,0.0,21.084308661701613,77.71274767689012,90.15337760070808,23.821991296644978,-76.17800870335503,-2.319076173621937,-1.4831091979784838,-0.0693613069130461,-300377935.0,-1.0
3288,2016-01-25,IBM,80.41294347348627,81.81572615640397,80.10999862913636,80.39977264404297,5696516.0,0.0,0.0,-0.276580810546875,0.276580810546875,0.0,20.364084559520066,77.71274767689012,90.15337760070808,21.59878546028011,-78.40121453971989,-2.4921067031088455,-1.6849086990045563,-0.08368990022909151,-306074451.0,-1.0
3289,2016-01-26,IBM,80.51172163492805,81.40739575746707,80.50513622088654,80.73564147949219,4830219.0,0.0,0.0,0.33586883544921875,0.0,0.33586883544921875,24.001627650666734,77.71274767689012,89.29062473624184,26.10922353990975,-73.89077646009025,-2.5724789008407214,-1.8624227393717894,-0.07757703476538591,-301244232.0,1.0
3290,2016-01-27,IBM,80.82784708238927,81.24933988336394,79.45799679315103,79.66215515136719,5257614.0,0.0,0.0,-1.073486328125,1.073486328125,0.0,20.541405091519977,77.71274767689012,88.92184488841802,17.391297779737496,-82.60870222026251,-2.691766809559809,-2.0282915534093933,-0.0778379208082649,-306501846.0,-1.0
3291,2016-01-28,IBM,79.85971456389997,80.89368745199893,79.69506873089038,80.49195098876953,4123855.0,0.0,0.0,0.8297958374023438,0.0,0.8297958374023438,29.59441677066799,77.71274767689012,88.43447389753192,25.921229983739053,-74.07877001626095,-2.6883560523297376,-2.1603044531934623,-0.08043042891667329,-302377991.0,1.0
3292,2016-01-29,IBM,81.19007145262317,82.18453216552734,80.97932766557652,82.18453216552734,8627513.0,0.0,0.0,1.6925811767578125,0.0,1.6925811767578125,44.48167485317312,77.71274767689012,88.43447389753192,41.707691435246765,-58.292308564753235,-2.520026549774755,-2.232248872509721,-0.040298310397618886,-293750478.0,1.0
3293,2016-02-01,IBM,81.92767500876725,82.5138136485401,81.47325516127219,82.21086883544922,3739345.0,0.0,0.0,0.026336669921875,0.0,0.026336669921875,44.69164503243709,77.71274767689012,88.43447389753192,41.95332977164796,-58.046670228352035,-2.357325278664973,-2.257264153740772,-0.025603058014433744,-290011133.0,1.0
3294,2016-02-02,IBM,81.4469151455291,81.75644537889637,80.76857018406874,80.96614837646484,3438516.0,0.0,0.0,-1.244720458984375,1.244720458984375,0.0,37.05027001326426,77.71274767689012,88.43447389753192,30.344000887759837,-69.65599911224017,-2.3022826068179825,-2.266267844356214,0.008862678955472436,-293449649.0,-1.0
3295,2016-02-03,IBM,81.65766853802269,82.61919693379812,80.53807967198206,82.13843536376953,6509781.0,0.0,0.0,1.1722869873046875,0.0,1.1722869873046875,46.91388554330084,77.71274767689012,88.11175682842492,42.55874403405273,-57.44125596594727,-2.1394053964768887,-2.2408953547803487,0.014726282459829987,-286939868.0,1.0
3296,2016-02-04,IBM,82.37550549453451,84.62785349395733,82.32281693236652,84.06806182861328,5508759.0,0.0,0.0,1.92962646484375,0.0,1.92962646484375,59.08892473068322,77.71274767689012,86.99877375312487,68.43954668604684,-31.56045331395316,-1.8334840419317686,-2.1594130922106327,0.042040923130375774,-281431109.0,1.0
3297,2016-02-05,IBM,83.78488430161885,84.7200762413093,82.88262994628947,84.6739730834961,7507874.0,0.0,0.0,0.6059112548828125,0.0,0.6059112548828125,62.22760869333662,77.71274767689012,86.99877375312487,74.96452572345757,-25.03547427654242,-1.5245728630019784,-2.0324450463689017,0.053161847339748824,-273923235.0,1.0
3298,2016-02-08,IBM,83.8290333663372,84.8336519949749,82.5849022732729,84.48103332519531,7702744.0,1.24283,0.0,-0.19293975830078125,0.19293975830078125,0.0,60.52161347753784,77.71274767689012,84.8336519949749,95.04811953610933,-4.951880463890675,-1.280565591135101,-1.8820691553221416,0.046390810515260394,-281625979.0,-1.0
3299,2016-02-09,IBM,83.90885977118616,84.44775876291226,82.34537893206904,82.54497528076172,6231231.0,0.0,0.0,-1.9360580444335938,1.9360580444335938,0.0,45.93937160850262,79.4118944417654,84.8336519949749,57.787180784977,-42.212819215022996,-1.2292418393294327,-1.7515036921235998,0.036188076055899465,-287857210.0,-1.0
3300,2016-02-10,IBM,83.16371076911149,83.35664912544345,79.7307152011548,79.96356964111328,6766679.0,0.0,0.0,-2.5814056396484375,2.5814056396484375,0.0,33.51574344025683,79.45799679315103,84.8336519949749,9.404860039957976,-90.59513996004202,-1.3809465652732342,-1.6773922667535266,-0.006564399808497212,-294623889.0,-1.0
3301,2016-02-11,IBM,79.02549774477,79.61097091099263,77.77471392104879,78.4067611694336,7643750.0,0.0,0.0,-1.5568084716796875,1.5568084716796875,0.0,28.207458873539025,77.77471392104879,84.8336519949749,8.95385738995822,-91.04614261004178,-1.6082561110865754,-1.6635650356201366,-0.045966934367710044,-302267639.0,-1.0
3302,2016-02-12,IBM,79.34481675902632,80.53572067239173,78.73938578350209,80.52906799316406,5163579.0,0.0,0.0,2.1223068237304688,0.0,2.1223068237304688,42.52597050602776,77.77471392104879,84.8336519949749,39.01938284866311,-60.980617151336894,-1.5987191013711026,-1.6505958487703303,-0.02045715932830483,-297104060.0,1.0
3303,2016-02-16,IBM,81.05466421907353,81.89295492380182,80.72866168841242,81.66009521484375,4248224.0,0.0,0.0,1.1310272216796875,0.0,1.1310272216796875,48.80456690186781,77.77471392104879,84.8336519949749,55.04200848774342,-44.95799151225658,-1.4828036703617897,-1.6170374130886223,0.00857082684917021,-292855836.0,1.0
3304,2016-02-17,IBM,82.30546952737109,84.20825316393969,81.99942495351348,83.89556121826172,5042766.0,0.0,0.0,2.2354660034179688,0.0,2.2354660034179688,59.0152750579844,77.77471392104879,84.8336519949749,86.71059631223787,-13.289403687762121,-1.1967609173569258,-1.5329821139422832,0.02139224891136937,-287813070.0,1.0
3305,2016-02-18,IBM,86.49026207448402,89.15149902883353,86.32393443299954,88.12026977539062,10409374.0,0.0,0.0,4.224708557128906,0.0,4.224708557128906,71.43746136269667,77.77471392104879,89.15149902883353,90.93567080969765,-9.06432919030234,-0.6220012582533059,-1.350785942804488,0.0482015150419246,-277403696.0,1.0
3306,2016-02-19,IBM,88.06038630126321,88.91863514122737,87.04911519786943,88.5394058227539,5361064.0,0.0,0.0,0.41913604736328125,0.0,0.41913604736328125,72.39524215063514,77.77471392104879,89.15149902883353,94.61980515338392,-5.380194846616083,-0.13116729639378377,-1.1068622135223471,0.04565077790132932,-272042632.0,1.0
3307,2016-02-22,IBM,88.53943768319027,89.35777073642026,88.09368140230234,88.99850463867188,4662440.0,0.0,0.0,0.45909881591796875,0.0,0.45909881591796875,73.51758605465858,77.77471392104879,89.35777073642026,96.89834813491012,-3.101651865089871,0.2915072778017702,-0.8271883152575236,0.05347320144732759,-267380192.0,1.0
3308,2016-02-23,IBM,88.5793435265936,88.75897654390995,87.82754274079387,88.0870132446289,3597926.0,0.0,0.0,-0.9114913940429688,0.9114913940429688,0.0,67.2535858660162,77.77471392104879,89.35777073642026,89.02916982928912,-10.970830170710885,0.5466289865179306,-0.5524248549024328,0.06713961625183074,-270978118.0,-1.0
3309,2016-02-24,IBM,87.52148078920203,88.81218037081544,86.2773552777331,88.35311889648438,4312240.0,0.0,0.0,0.26610565185546875,0.0,0.26610565185546875,68.16724496496539,77.77471392104879,89.35777073642026,91.3265396522734,-8.673460347726602,0.7615090782638703,-0.2896380682691721,0.1049171428067115,-266665878.0,1.0
3310,2016-02-25,IBM,88.67910889596757,89.49078884793941,87.07571233891561,89.484130859375,4558782.0,0.0,0.0,1.131011962890625,0.0,1.131011962890625,71.99866819585823,77.77471392104879,89.49078884793941,99.94317219200151,-0.05682780799849425,1.0114074368906785,-0.029428967237201908,0.1412807967670504,-262107096.0,1.0
3311,2016-02-26,IBM,89.49079874496746,89.76357454904604,87.78760119329814,87.84082794189453,4587965.0,0.0,0.0,-1.6433029174804688,1.6433029174804688,0.0,59.90988193125144,77.77471392104879,89.76357454904604,83.96222404436521,-16.037775955634785,1.064581047105392,0.18937303563131697,0.09079653013432543,-266695061.0,-1.0
3312,2016-02-29,IBM,87.82087430841561,88.72569191414185,87.0890316981532,87.17552185058594,4631688.0,0.0,0.0,-0.6653060913085938,0.6653060913085938,0.0,55.55261167734727,77.77471392104879,89.76357454904604,78.41285524317219,-21.58714475682781,1.0410364546950746,0.3597057194440686,0.06754127118308362,-271326749.0,-1.0
3313,2016-03-01,IBM,87.98055339495085,89.57729760471544,87.84083648467332,89.39765930175781,3962771.0,0.0,0.0,2.222137451171875,0.0,2.222137451171875,65.28344409877883,77.77471392104879,89.76357454904604,96.9478730411319,-3.0521269588681057,1.1879906994278286,0.5253627154408207,0.06558270787630716,-267363978.0,1.0
3314,2016-03-02,IBM,88.95191358606482,91.4401756841652,88.6325636447938,90.68171691894533,5457191.0,0.0,0.0,1.2840576171875142,0.0,1.2840576171875142,69.70554270253113,77.77471392104879,91.4401756841652,94.44981239297029,-5.550187607029709,1.3920193825761231,0.6986940488678812,0.029067627120111572,-261906787.0,1.0
3315,2016-03-03,IBM,91.29378793396542,91.78611811068691,90.52868194886624,91.6796646118164,5393594.0,0.0,0.0,0.9979476928710795,0.0,0.9979476928710795,72.81119660830885,78.73938578350209,91.78611811068691,99.18406006806244,-0.8159399319375614,1.6156158091740167,0.8820784009291085,0.035467357837807745,-256513193.0,1.0
3316,1.0,1.0,1.0,1.0,1.0,1.0,1.0,1.0,1.0,1.0,1.0,1.0,1.0,1.0,1.0,1.0,1.0,1.0,1.0,1.0,1.0,1.0
3317,2016-03-07,IBM,91.33371492749886,93.48266356067936,91.06093908652709,93.24315643310548,5408866.0,0.0,0.0,1.5634918212890767,0.0,1.5634918212890767,77.60085890375392,81.99942495351348,93.48266356067936,97.91428937630528,-2.0857106236947263,1.9997376073728503,1.248059557031163,0.05853465793144008,-251104327.0,1.0
3318,2016-03-08,IBM,92.95039751576232,93.37620085296324,91.42684367622572,92.52460479736328,5835739.0,0.0,0.0,-0.7185516357422017,0.7185516357422017,0.0,70.9709760763096,86.2773552777331,93.48266356067936,86.70343133570513,-13.296568664294858,2.097752210524945,1.4179980877299194,0.04721379338930043,-256940066.0,-1.0
3319,2016-03-09,IBM,92.68430032480364,94.58708385940923,92.63106825906908,93.4161376953125,4609199.0,0.0,0.0,0.8915328979492188,0.0,0.8915328979492188,74.1346063001694,86.2773552777331,94.58708385940923,85.90873152368901,-14.091268476310978,2.221757703879092,1.578750010959754,0.043940828370079066,-252330867.0,1.0
3320,2016-03-10,IBM,93.96834703429175,94.12136400306696,91.87261983391208,93.26976776123048,4205548.0,0.0,0.0,-0.14636993408201704,0.14636993408201704,0.0,72.63505285117489,86.2773552777331,94.58708385940923,84.14730294460428,-15.852697055395726,2.281917594769638,1.7193835277217309,0.061804287898186816,-256536415.0,-1.0
3321,2016-03-11,IBM,94.29432510434025,95.08604174782312,93.48264511299732,94.71347045898438,4625307.0,0.0,0.0,1.443702697753892,0.0,1.443702697753892,77.7557829527581,86.2773552777331,95.08604174782312,95.77041037725873,-4.229589622741272,2.4182138202765344,1.8591495862326914,0.08646863762190105,-251911108.0,1.0
3322,2016-03-14,IBM,94.48062635102146,95.26569575406316,93.83527916846916,94.992919921875,4235045.0,0.0,0.0,0.279449462890625,0.0,0.279449462890625,78.64815527710206,86.2773552777331,95.26569575406316,96.96522586225468,-3.0347741377453215,2.5197328849324805,1.9912662459726493,0.06258844654120788,-247676063.0,1.0
3323,2016-03-15,IBM,94.3010013685965,95.35883601534128,94.16793713428017,95.1126708984375,3878045.0,0.0,0.0,0.1197509765625,0.0,0.1197509765625,79.06345128087511,87.07571233891561,95.35883601534128,97.0281125029633,-2.971887497036711,2.5801084934350627,2.1090346954651324,0.048862704964582004,-243798018.0,1.0
3324,2016-03-16,IBM,94.8864780711773,96.39007963733545,94.54717539145403,96.3302001953125,4416107.0,0.0,0.0,1.217529296875,0.0,1.217529296875,82.95314116663373,87.0890316981532,96.39007963733545,99.3562075755927,-0.6437924244073016,2.695133219010458,2.2262544001741977,0.05072592273528764,-239381911.0,1.0
3325,2016-03-17,IBM,96.32353177535094,98.01341885660996,96.10398800344409,97.82713317871094,6089394.0,0.0,0.0,1.4969329833984375,0.0,1.4969329833984375,86.50887274401167,87.0890316981532,98.01341885660996,98.29477228152963,-1.705227718470369,2.8739519944872285,2.355793919036804,0.06705378551419994,-233292517.0,1.0
3326,2016-03-18,IBM,98.06663106767074,98.13981584975838,96.80919503231236,97.86038208007812,12645826.0,0.0,0.0,0.0332489013671875,0.0,0.0332489013671875,86.58060925517032,87.84083648467332,98.13981584975838,97.28678192493938,-2.7132180750606354,2.9839529190355165,2.4814257190365465,0.04951811825766672,-220646691.0,1.0
3327,2016-03-21,IBM,98.00011430659772,98.93820069394324,97.61423758624106,98.88497924804688,3892794.0,0.0,0.0,1.02459716796875,0.0,1.02459716796875,88.71435288344566,88.6325636447938,98.93820069394324,99.4835695683581,-0.5164304316418935,3.1178650651260114,2.6087135882544397,0.06874251951265675,-216753897.0,1.0
3328,2016-03-22,IBM,98.50574255183491,99.31742263523428,98.3593729677331,98.53236389160156,4269667.0,0.0,0.0,-0.3526153564453125,0.3526153564453125,0.0,83.44558826850476,90.52868194886624,99.31742263523428,91.0674490049479,-8.932550995052098,3.1591219025445554,2.718795251112463,0.05476811954029004,-221023564.0,-1.0
3329,2016-03-23,IBM,98.46583375727822,98.48579710887977,96.5563922706116,96.73603057861328,4983353.0,0.0,0.0,-1.7963333129882812,1.7963333129882812,0.0,61.8528311572297,91.06093908652709,99.31742263523428,68.73497002213254,-31.26502997786745,3.0121470020210523,2.777465601294181,0.03716384098067427,-226006917.0,-1.0
3330,2016-03-24,IBM,96.45659551308324,98.61220208743596,96.13059823313296,98.43256378173828,5276547.0,0.0,0.0,1.696533203125,0.0,1.696533203125,70.24370092342429,91.06093908652709,99.31742263523428,89.28286057525602,-10.71713942474397,2.9980052471363052,2.821573530462606,0.03926678332797939,-220730370.0,1.0
3331,2016-03-28,IBM,98.29951330839624,98.89828644223844,97.95355266605073,98.73196411132812,3415295.0,0.0,0.0,0.29940032958984375,0.0,0.29940032958984375,71.51935327193254,91.42684367622572,99.31742263523428,92.58028432453939,-7.419715675460608,2.976644009662408,2.852587626302567,0.03936129337352967,-217315075.0,1.0
3332,2016-03-29,IBM,98.19305957964,99.63678158298856,98.13318014262676,99.35070037841795,3282871.0,0.0,0.0,0.6187362670898295,0.0,0.6187362670898295,74.16075492003813,91.87261983391208,99.63678158298856,96.31536263905585,-3.6846373609441527,2.975344007196739,2.8771389024814016,0.04455799043332376,-214032204.0,1.0
3333,2016-03-30,IBM,99.7631858567756,100.0692304072368,98.67872987813504,98.73860931396484,3484435.0,0.0,0.0,-0.6120910644531108,0.6120910644531108,0.0,67.06144880668606,91.87261983391208,100.0692304072368,83.7662033426064,-16.233796657393594,2.891590655312015,2.8800292530475247,0.025001599848949008,-217516639.0,-1.0
3334,2016-03-31,IBM,99.65673789027164,101.858907829575,99.37064608712043,100.76114654541016,7092508.0,0.0,0.0,2.0225372314453125,0.0,2.0225372314453125,75.86885583115652,93.48264511299732,101.858907829575,86.89437853958141,-13.105621460418593,2.9543613336337273,2.8948956691647654,0.029991815883425144,-210424131.0,1.0
3335,2016-04-01,IBM,100.13575861759888,101.76577691286155,99.96277829780168,101.47303771972656,4106073.0,0.0,0.0,0.7118911743164062,0.0,0.7118911743164062,78.2326719389142,93.83527916846916,101.858907829575,95.19082791407176,-4.809172085928242,3.0266617441317294,2.9212488841581585,0.03691642688143437,-206318058.0,1.0
3336,2016-04-04,IBM,101.35325741396018,102.13832667724424,101.06717627153016,101.1736297607422,4112035.0,0.0,0.0,-0.2994079589843608,0.2994079589843608,0.0,74.68247758216262,94.16793713428017,102.13832667724424,87.89648973488843,-12.103510265111565,3.0249310975757595,2.941985326841679,0.02314457190666319,-210430093.0,-1.0
3337,2016-04-05,IBM,100.7478471366092,100.8609480190746,99.5635956281995,99.79645538330078,3490502.0,0.0,0.0,-1.3771743774414205,1.3771743774414205,0.0,60.18679465343628,94.54717539145403,102.13832667724424,69.14998521598193,-30.85001478401807,2.879242964351974,2.9294368543437384,0.012829200901846693,-213920595.0,-1.0
3338,2016-04-06,IBM,99.72995937106896,99.89628175104023,98.33945840126114,99.8097915649414,4387552.0,0.0,0.0,0.013336181640625,0.0,0.013336181640625,60.272952874632935,96.10398800344409,102.13832667724424,61.41192534630434,-38.588074653695664,2.7333518093433753,2.8902198453436663,0.031774727244263,-209533043.0,1.0
3339,2016-04-07,IBM,99.17773100623792,99.53033905819107,98.46584629254345,98.6321792602539,3831498.0,0.0,0.0,-1.1776123046875,1.1776123046875,0.0,49.384236952595465,96.13059823313296,102.13832667724424,41.63938251192055,-58.36061748807945,2.4939597312921507,2.8109678225333634,0.0020279414743096247,-213364541.0,-1.0
3340,2016-04-08,IBM,99.17109282748176,99.78982950385966,98.54570877759848,99.3640365600586,3445315.0,0.0,0.0,0.7318572998046875,0.0,0.7318572998046875,55.18931144222092,96.13059823313296,102.13832667724424,53.821312947242525,-46.17868705275747,2.336362420765866,2.716046742179864,0.0064019029138098205,-209919226.0,1.0
3341,2016-04-11,IBM,99.96943097382696,101.09380299273926,99.27750973141936,99.2974624633789,4023021.0,0.0,0.0,-0.0665740966796875,0.0665740966796875,0.0,54.532853343329656,96.13059823313296,102.13832667724424,52.71317203676341,-47.28682796323658,2.1809527775042454,2.609027949244741,-0.000535858477456852,-213942247.0,-1.0
3342,2016-04-12,IBM,99.53697997847716,99.869635238042,98.85170610862822,99.55028533935548,3761207.0,0.0,0.0,0.2528228759765767,0.0,0.2528228759765767,56.78524091799134,96.13059823313296,102.13832667724424,56.92146604220222,-43.07853395779778,2.0545071294141906,2.498123785278631,0.008220452273230983,-210181040.0,1.0
3343,2016-04-13,IBM,100.29542671680304,100.61477661132812,99.55028404211347,100.61477661132812,3314146.0,0.0,0.0,1.064491271972642,0.0,1.064491271972642,65.16816325971908,96.13059823313296,102.13832667724424,74.64016424694626,-25.35983575305375,2.01694352221422,2.401887732665749,-0.0014526426018393046,-206866894.0,1.0
3344,2016-04-14,IBM,100.7944038731431,101.63269459978672,100.0492506612364,100.56819152832033,3322619.0,0.0,0.0,-0.04658508300779829,0.04658508300779829,0.0,64.5360161236743,97.95355266605073,102.13832667724424,62.47981026635886,-37.52018973364114,1.9608120453108882,2.313672595194777,-0.008917109527217137,-210189513.0,-1.0
3345,2016-04-15,IBM,100.48839691735208,101.19362369619928,100.43517546047492,100.94081115722656,3825850.0,0.0,0.0,0.3726196289062358,0.0,0.3726196289062358,67.45008193531623,98.13318014262676,102.13832667724424,70.10058159752086,-29.89941840247913,1.9242135988143474,2.235780795918691,-0.0023011787168871756,-206363663.0,1.0
3346,2016-04-18,IBM,100.94080441922785,101.88553830976556,100.78777681271156,101.47969818115234,6884458.0,0.0,0.0,0.5388870239257812,0.0,0.5388870239257812,71.37505276646921,98.33945840126114,102.13832667724424,82.66250766693275,-17.337492333067242,1.9165993808317694,2.1719445129013066,0.0168667593592029,-199479205.0,1.0
3347,2016-04-19,IBM,97.44792742126214,97.76727737410764,94.87982243536328,95.80460357666016,13796949.0,0.0,0.0,-5.6750946044921875,5.6750946044921875,0.0,28.95253598227032,94.87982243536328,102.13832667724424,12.740657172327142,-87.25934282767285,1.436078137543106,2.0247712378296665,-0.04012820711758791,-213276154.0,-1.0
3348,2016-04-20,IBM,95.96423585348052,97.9335561468372,95.80456094810566,97.20836639404295,7064998.0,0.0,0.0,1.4037628173827983,0.0,1.4037628173827983,39.25678403697079,94.87982243536328,102.13832667724424,32.08021764655275,-67.91978235344726,1.155216896609133,1.8508603695855597,-0.014435581540320985,-206211156.0,1.0
3349,2016-04-21,IBM,97.52109143499162,99.8762782521578,97.4412486544012,99.33072662353516,6294514.0,0.0,0.0,2.1223602294922017,0.0,2.1223602294922017,51.522236435193754,94.87982243536328,102.13832667724424,61.31985378599815,-38.68014621400185,1.0913091404339212,1.698950123755232,-0.00033523131382962035,-199916642.0,1.0
3350,2016-04-22,IBM,99.4238945949861,100.46177661805028,98.13318943822912,98.79850006103516,5430727.0,0.0,0.0,-0.5322265625,0.5322265625,0.0,48.67813504430558,94.87982243536328,101.88553830976556,55.93543466400157,-44.06456533599844,0.9863455698928192,1.5564292129827495,-0.005024926014879472,-205347369.0,-1.0
3351,2016-04-25,IBM,98.57226427203985,99.0645943878517,97.87368517340911,99.00471496582033,2979949.0,0.0,0.0,0.20621490478517046,0.0,0.20621490478517046,49.91418639774537,94.87982243536328,101.88553830976556,58.878958330707,-41.121041669293,0.9093189407065267,1.427007158527505,-0.005480349671277862,-202367420.0,1.0
3352,2016-04-26,IBM,98.8982755158592,99.6567341441625,98.3992979594516,99.18435668945312,3116871.0,0.0,0.0,0.1796417236327983,0.0,0.1796417236327983,51.09803313120563,94.87982243536328,101.88553830976556,61.44317484838193,-38.55682515161807,0.8529382269534267,1.3121933722126895,-0.014216797671784076,-199250549.0,1.0
3353,2016-04-27,IBM,99.36399583313008,100.31538750262813,99.11117274859323,100.10913848876952,3254315.0,0.0,0.0,0.924781799316392,0.0,0.924781799316392,57.118506226630636,94.87982243536328,101.88553830976556,74.6435645857875,-25.3564354142125,0.8728169767851881,1.2243180931271893,-0.0045645947548090815,-195996234.0,1.0
3354,2016-04-28,IBM,99.6301084287126,99.9162002085433,97.62088231228144,97.84708404541016,3965909.0,0.0,0.0,-2.262054443359361,2.262054443359361,0.0,42.38947917627381,94.87982243536328,101.88553830976556,42.35486655815938,-57.64513344184062,0.6979960761656088,1.1190536897348733,-0.030648922634449405,-199962143.0,-1.0
3355,2016-04-29,IBM,97.46123807897766,98.0267532087463,95.9310256661006,97.0953140258789,4420187.0,0.0,0.0,-0.75177001953125,0.75177001953125,0.0,38.575017899980814,94.87982243536328,101.88553830976556,31.62405713041635,-68.37594286958365,0.4931035048780785,0.9938636527635143,-0.04320454469076995,-204382330.0,-1.0
3356,2016-05-02,IBM,97.50777199679938,97.80051115057414,96.09067153432292,96.64952850341795,3663510.0,0.0,0.0,-0.4457855224609517,0.4457855224609517,0.0,36.33773041605883,94.87982243536328,101.88553830976556,25.260888391447395,-74.7391116085526,0.2913944856402111,0.8533698193388538,0.00881925184400667,-208045840.0,-1.0
3357,2016-05-03,IBM,96.23702043240206,96.40335334104223,95.07273254712725,95.89105987548828,3749178.0,0.0,0.0,-0.7584686279296733,0.7584686279296733,0.0,32.623216391694754,94.87982243536328,101.88553830976556,14.434462633860068,-85.56553736613994,0.06953499898777693,0.6966028552686384,-0.01355136977834659,-211795018.0,-1.0
3358,2016-05-04,IBM,95.37877588022388,96.46987897156664,95.34550717513612,95.9709014892578,2695647.0,0.0,0.0,0.07984161376951704,0.0,0.07984161376951704,33.449511238408064,94.87982243536328,101.88553830976556,15.57412651976279,-84.42587348023721,-0.09870982619688107,0.5375403189755346,-0.03382463059000007,-209099371.0,1.0
3359,2016-05-05,IBM,97.1019534916298,98.00011316528904,96.7692982210436,97.44791412353516,6800255.0,0.0,0.0,1.477012634277358,0.0,1.477012634277358,47.256438374625176,94.87982243536328,101.88553830976556,36.6570916407737,-63.3429083592263,-0.1115763044340099,0.4077169942936256,-0.013670105686479528,-202299116.0,1.0
3360,2016-05-06,IBM,97.30685125095752,99.39592503900676,97.0448767470444,98.93915557861328,5121007.0,1.338432,0.0,1.491241455078125,0.0,1.491241455078125,57.52273853832609,94.87982243536328,100.46177661805028,72.72243752627774,-27.27756247372225,-0.0014259214006386856,0.3258884111547728,-0.0006621844952503508,-197178109.0,1.0
3361,2016-05-09,IBM,99.21455865611316,99.55042421185868,98.7510669767173,98.97274017333984,4500310.0,0.0,0.0,0.0335845947265625,0.0,0.0335845947265625,57.73651009087453,95.07273254712725,100.46177661805028,72.36919154651868,-27.630808453481325,0.0875695990327614,0.2782246487303705,-0.0021335674614078037,-192677799.0,1.0
3362,2016-05-10,IBM,99.57729712938072,100.78641105123772,99.24143155546038,100.73938751220705,4176364.0,0.0,0.0,1.7666473388672017,0.0,1.7666473388672017,67.62553830529677,95.07273254712725,100.78641105123772,99.17700061358289,-0.822999386417109,0.2972266224268765,0.2820250434696717,0.006295619290622723,-188501435.0,1.0
3363,2016-05-11,IBM,100.5647220112847,101.49171599558836,99.91314697453984,100.05420684814452,3235278.0,0.0,0.0,-0.6851806640625284,0.6851806640625284,0.0,61.21560450628667,95.07273254712725,101.49171599558836,77.60534578433172,-22.394654215668286,0.40344233852351863,0.3063085024804411,0.02255685822696618,-191736713.0,-1.0
3364,2016-05-12,IBM,100.22887215975496,100.34978676819355,98.81824103933526,99.98033142089844,3398663.0,0.0,0.0,-0.07387542724607954,0.07387542724607954,0.0,60.50216600019318,95.07273254712725,101.49171599558836,76.45445596136776,-23.545544038632237,0.4761689499468531,0.34028059197372357,0.029713250572016126,-195135376.0,-1.0
3365,2016-05-13,IBM,99.94673613674472,100.66547998482724,99.02646440023295,99.2279815673828,2508308.0,0.0,0.0,-0.7523498535156392,0.7523498535156392,0.0,53.21444582489234,95.07273254712725,101.49171599558836,64.73375501928936,-35.266244980710646,0.4677055495001241,0.36576558347900373,0.02667838223208352,-197643684.0,-1.0
3366,2016-05-16,IBM,99.1809988603457,100.7528462766445,99.0399389295344,100.39683532714844,3210279.0,0.0,0.0,1.1688537597656392,0.0,1.1688537597656392,61.52276018102494,95.07273254712725,101.49171599558836,82.94308316525706,-17.056916834742935,0.548986597798077,0.4024097863428185,0.0469884831548506,-194433405.0,1.0
3367,2016-05-17,IBM,100.22885997471715,100.42366562893184,98.93914361952966,99.41606903076172,3651168.0,0.0,0.0,-0.9807662963867188,0.9807662963867188,0.0,52.49690956034733,95.07273254712725,101.49171599558836,67.66393025480912,-32.336069745190876,0.5281743060371582,0.42756269028168653,0.03589804292803844,-198084573.0,-1.0
3368,2016-05-18,IBM,99.40936432368096,99.76537516557724,98.3144428263762,98.97274017333984,2605691.0,0.0,0.0,-0.443328857421875,0.443328857421875,0.0,48.76549627447483,95.07273254712725,101.49171599558836,60.75740274961423,-39.24259725038577,0.4704840340536549,0.43614695903608025,0.015647600705661624,-200690264.0,-1.0
3369,2016-05-19,IBM,98.39501912874468,98.69729483178294,96.70225803768624,97.35384368896484,3855138.0,0.0,0.0,-1.618896484375,1.618896484375,0.0,37.526676551026945,95.07273254712725,101.49171599558836,35.536953166384464,-64.46304683361554,0.2907807221044294,0.40707371164975004,-0.016023099048877665,-204545402.0,-1.0
3370,2016-05-20,IBM,97.8778206340884,99.08693451470457,97.77033979443868,98.91228485107422,3840389.0,0.0,0.0,1.558441162109375,0.0,1.558441162109375,50.259796999687424,95.07273254712725,101.49171599558836,59.815581934043834,-40.184418065956166,0.2709938812628536,0.3798577455723708,-0.0006108280134483612,-200705013.0,1.0
3371,2016-05-23,IBM,99.154093982034,99.38247868329734,98.51595268995366,98.58984375,2200575.0,0.0,0.0,-0.32244110107421875,0.32244110107421875,0.0,47.927760899773375,95.34550717513612,101.49171599558836,52.78598026262892,-47.214019737371075,0.22668132403616426,0.3492224612651295,-0.0213376695579629,-202905588.0,-1.0
3372,2016-05-24,IBM,98.66374779811458,99.91988526298005,98.66374779811458,99.62432098388672,3064048.0,0.0,0.0,1.0344772338867188,0.0,1.0344772338867188,55.56082598798359,96.70225803768624,101.49171599558836,61.01030579837057,-38.98969420162943,0.27190264601721026,0.3337584982155457,-0.004296529629286394,-199841540.0,1.0
3373,2016-05-25,IBM,100.04078270620586,102.16345686302658,99.75194068900824,101.89476013183594,4555644.0,0.0,0.0,2.2704391479492188,0.0,2.2704391479492188,67.59147010493231,96.70225803768624,102.16345686302658,95.07989473036812,-4.920105269631872,0.4853515038613665,0.3640770993447099,0.01914805325937663,-195285896.0,1.0
3374,2016-05-26,IBM,101.80071196860423,102.4455647503329,101.46484645422755,102.39855194091795,3203793.0,0.0,0.0,0.503791809082017,0.0,0.503791809082017,69.69218299669878,96.70225803768624,102.4455647503329,99.18143307040472,-0.8185669295952818,0.6872409641063655,0.42870987229704105,0.031952382014161174,-192082103.0,1.0
3375,2016-05-27,IBM,102.3381006658619,102.72770125464191,102.20375230795436,102.66724395751952,2570127.0,0.0,0.0,0.2686920166015625,0.0,0.2686920166015625,70.85477247165895,96.70225803768624,102.72770125464191,98.99663319451307,-1.0033668054869338,0.859018782271022,0.5147716542918372,0.022614344595353275,-189511976.0,1.0
3376,2016-05-31,IBM,102.4791364452878,103.31879472251065,102.28433083606964,103.27178192138672,6105084.0,0.0,0.0,0.6045379638672017,0.0,0.6045379638672017,73.49430848933049,96.70225803768624,103.31879472251065,99.2894651180314,-0.7105348819686085,1.0320384057880574,0.6182250045910813,0.038783598347988946,-183406892.0,1.0
3377,2016-06-01,IBM,102.77473356987124,102.95609475545528,101.79400441100977,102.4455795288086,2785916.0,0.0,0.0,-0.826202392578125,0.826202392578125,0.0,64.30994512478836,96.70225803768624,103.31879472251065,86.8025337831974,-13.197466216802592,1.089926086277643,0.7125652209283937,0.03508884718546201,-186192808.0,-1.0
3378,2016-06-02,IBM,102.49933706841963,103.11061096191406,102.1836167559471,103.11061096191406,2764160.0,0.0,0.0,0.6650314331054688,0.0,0.6650314331054688,68.0215090640448,96.70225803768624,103.31879472251065,96.85358412545236,-3.1464158745476345,1.1759098125354086,0.8052341392497968,0.059132408694015925,-183428648.0,1.0
3379,2016-06-03,IBM,102.37168216083708,102.80159477215923,101.9014789788436,102.70083618164062,2435402.0,0.0,0.0,-0.4097747802734375,0.4097747802734375,0.0,63.33846519468847,96.70225803768624,103.31879472251065,90.6603927355627,-9.339607264437316,1.1971867117464825,0.8836246537491341,0.03830213139116734,-185864050.0,-1.0
3380,2016-06-06,IBM,102.8352130503703,103.41289722565789,102.33140923683445,102.5933837890625,2488120.0,0.0,0.0,-0.107452392578125,0.107452392578125,0.0,62.04601263413545,96.70225803768624,103.41289722565789,87.78784831608431,-12.21215168391569,1.1916417927831588,0.9452280815559391,0.04060803716470551,-188352170.0,-1.0
3381,2016-06-07,IBM,102.98295444071393,103.39943328196232,102.54633031442444,102.99639892578124,4670390.0,0.0,0.0,0.4030151367187358,0.0,0.4030151367187358,65.12569425480228,96.70225803768624,103.41289722565789,93.79346306350081,-6.206536936499199,1.2058668752392236,0.9973558402925959,0.033847939023242235,-183681780.0,1.0
3382,2016-06-08,IBM,103.13071383836323,103.5068913053572,102.8015706161808,103.4464340209961,3070010.0,0.0,0.0,0.45003509521485796,0.0,0.45003509521485796,68.42666586876213,96.70225803768624,103.5068913053572,99.1115276608904,-0.8884723391096061,1.2391700457249044,1.0457186813790578,0.015228201010067055,-180611770.0,1.0
3383,2016-06-09,IBM,102.72095826417925,103.28521910916332,102.59333217452144,103.05682373046876,2114803.0,0.0,0.0,-0.38961029052732954,0.38961029052732954,0.0,62.515714812051876,97.77033979443868,103.5068913053572,92.15438797975035,-7.845612020249653,1.220060654174759,1.0805870759381981,0.006428526351921704,-182726573.0,-1.0
3384,2016-06-10,IBM,102.6336440834507,102.99638783047295,102.0089366101548,102.35152435302734,3264148.0,0.0,0.0,-0.7052993774414205,0.7052993774414205,0.0,52.959855190820846,98.51595268995366,103.5068913053572,76.85070802586016,-23.14929197413984,1.1349218853390113,1.0914540378183608,-0.0030751736612585345,-185990721.0,-1.0
3385,2016-06-13,IBM,101.85448415413724,102.43889057664076,100.94764586257776,101.61937713623048,3776478.0,0.0,0.0,-0.7321472167968608,0.7321472167968608,0.0,44.764191530914836,98.66374779811458,103.5068913053572,61.02708568713565,-38.97291431286434,0.9968792327991025,1.072539076814509,-0.016000544915687587,-189767199.0,-1.0
3386,2016-06-14,IBM,101.6193626510633,101.96193976230118,101.02824478957608,101.4715805053711,2997627.0,0.0,0.0,-0.1477966308593892,0.1477966308593892,0.0,43.206780418711986,99.75194068900824,103.5068913053572,45.796602726959634,-54.203397273040366,0.8655756657229716,1.0311463945962016,-0.009507477315442436,-192764826.0,-1.0
3387,2016-06-15,IBM,101.74028053096232,101.9619430353345,101.16258569550467,101.2163314819336,2364378.0,0.0,0.0,-0.2552490234375,0.2552490234375,0.0,40.405476562703306,100.94764586257776,103.5068913053572,10.498626464839274,-89.50137353516072,0.7324766450247466,0.9714124446819106,-0.018371334068422507,-195129204.0,-1.0
3388,2016-06-16,IBM,100.88717416617082,101.62607417335025,100.0878168520008,101.4715805053711,2561759.0,0.0,0.0,0.2552490234375,0.0,0.2552490234375,44.55340363222593,100.0878168520008,103.5068913053572,40.47187834742517,-59.528121652574825,0.6402112187687123,0.9051721994992711,-0.011969285956887621,-192567445.0,1.0
3389,2016-06-17,IBM,101.40439895037235,102.58664524626268,101.16256975275827,102.09627532958984,4878439.0,0.0,0.0,0.62469482421875,0.0,0.62469482421875,53.66133945789673,100.0878168520008,103.5068913053572,58.742753484569555,-41.25724651543045,0.6104608426508946,0.8462299281295959,-0.004845424150301314,-187689006.0,1.0
3390,2016-06-20,IBM,102.50601788705454,103.89650341886816,102.4522828377427,103.1844711303711,3736417.0,0.0,0.0,1.08819580078125,0.0,1.08819580078125,65.1632452468019,100.0878168520008,103.89650341886816,81.30504372055181,-18.694956279448196,0.6670029669211743,0.8103845358879116,0.0018260075745499815,-183952589.0,1.0
3391,2016-06-21,IBM,103.5539478390883,103.82935613426862,103.23823824440692,103.48005676269533,2887274.0,0.0,0.0,0.29558563232423296,0.0,0.29558563232423296,67.67774804186476,100.0878168520008,103.89650341886816,89.06587221443733,-10.93412778556267,0.7272806592622629,0.793763760562782,0.0003250256233329196,-181065315.0,1.0
3392,2016-06-22,IBM,103.2785318346263,103.92339546363532,102.2843688601176,102.7209930419922,2964050.0,0.0,0.0,-0.759063720703125,0.759063720703125,0.0,55.75353647291604,100.0878168520008,103.92339546363532,68.65134199059695,-31.348658009403053,0.7056665811342384,0.7761443246770734,-0.0032586943427916903,-184029365.0,-1.0
3393,2016-06-23,IBM,103.07700410228824,104.44061157061935,102.50603160247738,104.35328674316406,4151992.0,0.0,0.0,1.6322937011718608,0.0,1.6322937011718608,69.21281394784012,100.0878168520008,104.44061157061935,97.99382159967782,-2.0061784003221947,0.8109021532797271,0.7830958903976043,0.019557719367542692,-179877373.0,1.0
3394,2016-06-24,IBM,100.73936299883722,101.16927554620636,98.19350964406073,98.46891784667967,9500609.0,0.0,0.0,-5.884368896484389,5.884368896484389,0.0,30.5535196625289,98.19350964406073,104.44061157061935,4.408575461976869,-95.59142453802313,0.41470228041742985,0.7094171684015694,-0.031002544773791718,-189377982.0,-1.0
3395,2016-06-27,IBM,98.19352692371469,98.4756574176137,95.72156418549244,96.39329528808594,5248723.0,0.0,0.0,-2.075622558593736,2.075622558593736,0.0,24.894223762555924,95.72156418549244,104.44061157061935,7.7041799742864905,-92.29582002571351,-0.06601340562083635,0.5543310535970883,-0.050046379409812713,-194626705.0,-1.0
3396,2016-06-28,IBM,97.25309771356082,97.89124975687876,96.87693087454578,97.87109375,4181594.0,0.0,0.0,1.4777984619140625,0.0,1.4777984619140625,34.81337250807671,95.72156418549244,104.44061157061935,24.653261641567187,-75.34673835843282,-0.3240031580551346,0.37866421126664374,-0.03305037520087062,-190445111.0,1.0
3397,2016-06-29,IBM,98.40848006230895,99.73850853271448,98.37490101132909,99.7250747680664,3522614.0,0.0,0.0,1.8539810180664062,0.0,1.8539810180664062,45.275516946026585,95.72156418549244,104.44061157061935,45.91683478407534,-54.08316521592466,-0.3745436161216702,0.22802264578898093,-0.01721177228743609,-186922497.0,1.0
3398,2016-06-30,IBM,99.9937529858436,102.04252500999378,99.86611616340276,101.9552001953125,4149587.0,0.0,0.0,2.2301254272460938,0.0,2.2301254272460938,55.245056949088976,95.72156418549244,104.44061157061935,71.49446188873218,-28.505538111267825,-0.2319707943009348,0.13602395777099777,-0.0013817853180434492,-182772910.0,1.0
3399,2016-07-01,IBM,101.95522276790568,102.75458003917284,101.6999597877882,102.3381118774414,2780582.0,0.0,0.0,0.38291168212890625,0.0,0.38291168212890625,56.80408304156639,95.72156418549244,104.44061157061935,75.88613067105905,-24.113869328940954,-0.08707923795475381,0.09140331862584744,-0.008202389794296994,-179992328.0,1.0
3400,2016-07-05,IBM,101.55889984520093,102.10300485737427,101.27005781302432,101.88805389404295,2578599.0,0.0,0.0,-0.4500579833984517,0.4500579833984517,0.0,54.241590832887546,95.72156418549244,104.44061157061935,70.72435136743734,-29.275648632562675,-0.00846991769302008,0.07142867136207394,-0.01538463466736606,-182570927.0,-1.0
3401,2016-07-06,IBM,102.00222508962408,102.37839187770776,100.70578661420214,102.35152435302734,2687592.0,0.0,0.0,0.4634704589843892,0.0,0.4634704589843892,56.56956763193182,95.72156418549244,104.44061157061935,76.03996026956331,-23.960039730436687,0.090187106792186,0.07518035844809635,-0.003596817729495827,-179883335.0,1.0
3402,2016-07-07,IBM,102.60680871963588,103.23823863265535,102.02912459410204,102.50605010986328,2236766.0,0.0,0.0,0.1545257568359375,0.0,0.1545257568359375,57.40326940602141,95.72156418549244,104.44061157061935,77.81223824914547,-22.187761750854538,0.17878156405051016,0.09590059956857913,-0.017701758046655747,-177646569.0,1.0
3403,2016-07-08,IBM,103.44644487617973,103.849479185843,102.8284489281692,103.75543212890624,3180468.0,0.0,0.0,1.2493820190429545,0.0,1.2493820190429545,63.873057536677685,95.72156418549244,104.44061157061935,92.14157910321823,-7.858420896781765,0.34582158121015993,0.14588479589689532,0.05368713699543126,-174466101.0,1.0
3404,2016-07-11,IBM,103.84949219313414,104.81678752301556,103.78232337353684,104.33985137939452,2964050.0,0.0,0.0,0.5844192504882812,0.0,0.5844192504882812,66.61024296241678,95.72156418549244,104.81678752301556,94.7561909595622,-5.243809040437799,0.5193727419159586,0.22058238510070804,0.08243888817743072,-171502051.0,1.0
3405,2016-07-12,IBM,104.7899235943364,105.54226808304072,104.46750249492771,105.48853302001952,4020615.0,0.0,0.0,1.148681640625,0.0,1.148681640625,71.50628522275304,95.72156418549244,105.54226808304072,99.45283898606675,-0.5471610139332506,0.7410598193060736,0.32467787194178116,0.07783134915685475,-167481436.0,1.0
3406,2016-07-13,IBM,105.9654284039666,106.36175118436093,105.50193681387768,106.14678955078124,2872734.0,0.0,0.0,0.6582565307617188,0.0,0.6582565307617188,74.02474554491366,95.72156418549244,106.36175118436093,97.97971940152415,-2.020280598475858,0.9588116422872304,0.4515046260108711,0.0643941836859987,-164608702.0,1.0
3407,2016-07-14,IBM,106.67750661495934,108.41729210875198,106.52301292548628,107.66494750976562,4850930.0,0.0,0.0,1.5181579589843892,0.0,1.5181579589843892,78.97098061687879,95.72156418549244,108.41729210875198,94.07403337930705,-5.92596662069295,1.2395949118092489,0.6091226831705467,0.0560025119220513,-159757772.0,1.0
3408,2016-07-15,IBM,107.40966909416848,107.4634041520053,106.46924125434158,107.3290557861328,4682733.0,0.0,0.0,-0.3358917236328267,0.3358917236328267,0.0,75.3099967119915,95.72156418549244,108.41729210875198,91.42832668440028,-8.571673315599728,1.4186605847710752,0.7710302634906525,0.04876916152868316,-164440505.0,-1.0
3409,2016-07-18,IBM,107.00661208499196,107.98062958818328,106.62373375860456,107.3827896118164,7039266.0,0.0,0.0,0.05373382568360796,0.0,0.05373382568360796,75.51947900104987,96.87693087454578,108.41729210875198,91.0357875638307,-8.964212436169301,1.5470735900262156,0.9262389287977653,0.05392914583968422,-157401239.0,1.0
3410,2016-07-19,IBM,108.67252039237044,108.91434960051564,106.05948696773912,107.19470977783205,7447520.0,0.0,0.0,-0.1880798339843608,0.1880798339843608,0.0,73.01743405130395,98.37490101132909,108.91434960051564,83.68377806360822,-16.31622193639178,1.6150480821444546,1.0640007594671033,0.047319133304744465,-164848759.0,-1.0
3411,2016-07-20,IBM,107.4567011683015,108.62550309680104,107.20816042413796,108.39039611816406,4577610.0,0.0,0.0,1.195686340332017,0.0,1.195686340332017,78.29290045998712,99.86611616340276,108.91434960051564,94.20932841760595,-5.790671582394063,1.7452817303872905,1.2002569536511407,0.05740486539081435,-160271149.0,1.0
3412,2016-07-21,IBM,107.9806493227728,108.71954930594094,107.4029545246322,107.77912139892578,3680769.0,0.0,0.0,-0.6112747192382812,0.6112747192382812,0.0,70.19703207557666,100.70578661420214,108.91434960051564,86.17019564224981,-13.8298043577502,1.7786647338247974,1.3159385096858722,0.038780516715698266,-163951918.0,-1.0
3413,2016-07-22,IBM,108.00080318254128,108.9345089203168,107.79928596398064,108.86734008789062,2636025.0,0.0,0.0,1.0882186889648438,0.0,1.0882186889648438,75.41834604929161,100.70578661420214,108.9345089203168,99.18372707295926,-0.8162729270407414,1.8713592930869822,1.4270226663660943,0.043391749639680066,-161315893.0,1.0
3414,2016-07-25,IBM,108.82028813147282,109.41140586632817,108.652350012333,109.25691223144533,2933612.0,0.0,0.0,0.3895721435547017,0.0,0.3895721435547017,77.07719796775933,100.70578661420214,109.41140586632817,98.22535731912339,-1.7746426808766154,1.9537341838114202,1.5323649698551596,0.03572311703975117,-158382281.0,1.0
3415,2016-07-26,IBM,109.25693866145322,109.89508008174086,108.39712401649082,108.90091705322266,3027752.0,0.0,0.0,-0.35599517822267046,0.35599517822267046,0.0,71.95714372107054,102.02912459410204,109.89508008174086,87.36119178298799,-12.63880821701201,1.9676096630813475,1.6194139085003973,0.025946404164431502,-161410033.0,-1.0
3416,2016-07-27,IBM,108.9008877530004,109.20317421499,108.26946874635324,108.70609283447266,2262184.0,0.0,0.0,-0.19482421875,0.19482421875,0.0,69.0603078566262,102.8284489281692,109.89508008174086,83.17462421019023,-16.825375789809772,1.9405163298104213,1.6836343927624025,0.009670234823758062,-163672217.0,-1.0
3417,2016-07-28,IBM,108.4038474879714,108.6926895470544,107.95377878976996,108.39712524414062,2448058.0,0.0,0.0,-0.30896759033203125,0.30896759033203125,0.0,64.3219580598545,103.78232337353684,109.89508008174086,75.4946105479741,-24.5053894520259,1.872528225827395,1.721413159375401,0.009951354273870505,-166120275.0,-1.0
3418,2016-07-29,IBM,108.39039657480387,108.59863602326502,107.49700291775724,107.89332580566406,3710685.0,0.0,0.0,-0.5037994384765625,0.5037994384765625,0.0,56.967983617507905,104.46750249492771,109.89508008174086,63.11882706310339,-36.88117293689661,1.7577327107961054,1.7286770696595417,0.004754357711260981,-169830960.0,-1.0
3419,2016-08-01,IBM,107.91346866535008,108.5851998145199,107.3693636469894,108.45085144042967,2953486.0,0.0,0.0,0.5575256347656108,0.0,0.5575256347656108,62.44986276258582,105.50193681387768,109.89508008174086,67.12539170128964,-32.874608298710356,1.6922370421255835,1.72138906415275,0.011718317678186319,-166877474.0,1.0
3420,2016-08-02,IBM,108.32994222320744,108.45084610478727,107.71866840851617,107.86643981933594,3222621.0,0.0,0.0,-0.5844116210937358,0.5844116210937358,0.0,54.11235744199904,106.05948696773912,109.89508008174086,47.11012867868027,-52.88987132131974,1.575018288725218,1.6921149090672436,-0.004833973466218611,-170100095.0,-1.0
3421,2016-08-03,IBM,107.56416206095264,108.0545319850717,107.34248886686709,107.92689514160156,2993338.0,0.0,0.0,0.060455322265625,0.0,0.060455322265625,54.83213418573789,106.05948696773912,109.89508008174086,48.6862948795459,-51.3137051204541,1.4700539544900266,1.6477027181518002,0.0013710794888448508,-167106757.0,1.0
3422,2016-08-04,IBM,108.0545137751126,108.6187639475558,107.55743241321792,108.51800537109376,2603599.0,0.0,0.0,0.5911102294922017,0.0,0.5911102294922017,61.623395629352295,106.05948696773912,109.89508008174086,64.0974767208723,-35.9025232791277,1.418218281251086,1.6018058307716578,-0.0032088109851388102,-164503158.0,1.0
3423,2016-08-05,IBM,108.82029946224836,109.83460763971206,108.53145744623424,109.82789611816406,3987770.0,0.0,0.0,1.3098907470702983,0.0,1.3098907470702983,72.2801731355818,106.05948696773912,109.89508008174086,98.24840744104108,-1.7515925589589212,1.4659369640210542,1.5746320574215373,0.005226066479978808,-160515388.0,1.0
3424,2016-08-08,IBM,110.25475673798144,110.62062268430807,109.47559517487063,109.78726196289062,3179108.0,1.338432,0.0,-0.0406341552734375,0.0406341552734375,0.0,71.56881671014735,107.20816042413796,110.62062268430807,75.57890291874159,-24.421097081258416,1.4833760909669422,1.5563808641306185,0.00813900317510452,-163694496.0,-1.0
3425,2016-08-09,IBM,109.90918019667151,110.2818263067792,109.52298430200308,109.6042938232422,2863425.0,0.0,0.0,-0.1829681396484233,0.1829681396484233,0.0,68.08731642438588,107.34248886686709,110.62062268430807,68.99672442721541,-31.003275572784577,1.4655389047449745,1.5382124722534898,0.008262655434937205,-166557921.0,-1.0
3426,2016-08-10,IBM,109.8888831873245,110.2073302550354,109.733055211037,109.8143539428711,2580168.0,0.0,0.0,0.21006011962889204,0.0,0.21006011962889204,70.01928737819813,107.34248886686709,110.62062268430807,75.40464220382624,-24.595357796173754,1.4516195358549169,1.5208938849737754,0.01307441221839123,-163977753.0,1.0
3427,2016-08-11,IBM,109.92950497556974,111.75884493556984,109.8820861341678,110.79674530029295,9171956.0,0.0,0.0,0.9823913574218608,0.0,0.9823913574218608,77.40174551715398,107.34248886686709,111.75884493556984,78.21508002728844,-21.784919972711567,1.502538776366677,1.517222863252356,0.026910093585014616,-154805797.0,1.0
3428,2016-08-12,IBM,110.566436593631,110.74937499535464,109.43495874004309,109.7262954711914,2660083.0,0.0,0.0,-1.0704498291015483,1.0704498291015483,0.0,59.10374188539042,107.34248886686709,111.75884493556984,53.976775586949714,-46.023224413050286,1.4399178100430845,1.5017618526105019,0.011760571851870738,-157465880.0,-1.0
3429,2016-08-15,IBM,110.03116437394814,110.41734954354794,109.61108851434146,109.67884826660156,3107038.0,0.0,0.0,-0.04744720458984375,0.04744720458984375,0.0,58.39768321148652,107.34248886686709,111.75884493556984,52.90242370381949,-47.097576296180506,1.370661517428644,1.4755417855741304,0.01680233861710101,-160572918.0,-1.0
3430,2016-08-16,IBM,109.15715090045606,109.7127246740244,108.8725837124412,108.87936401367188,2311869.0,0.0,0.0,-0.7994842529296875,0.7994842529296875,0.0,47.39074472571731,107.34248886686709,111.75884493556984,34.799620386048844,-65.20037961395116,1.237004293437991,1.4278342871469027,0.008825129925406072,-162884787.0,-1.0
3431,2016-08-17,IBM,109.06229455145474,109.19103376734068,108.29668281306692,108.70320892333984,3374291.0,0.0,0.0,-0.17615509033203125,0.17615509033203125,0.0,45.22368891356022,107.34248886686709,111.75884493556984,30.810922745014334,-69.18907725498566,1.1041379222115495,1.3630950141598321,0.0017066619646457504,-166259078.0,-1.0
3432,2016-08-18,IBM,109.00808659161592,109.76014848030896,108.70320014394372,109.32652282714844,3819992.0,0.0,0.0,0.6233139038085938,0.0,0.6233139038085938,53.84134624138917,107.34248886686709,111.75884493556984,44.924682915436556,-55.075317084563444,1.037180616030696,1.297912134534005,-0.004565081447760799,-162439086.0,1.0
3433,2016-08-19,IBM,108.97419859828848,109.02162825920531,108.07985859673704,108.4321746826172,2944699.0,0.0,0.0,-0.8943481445312358,0.8943481445312358,0.0,42.71556945529266,107.34248886686709,111.75884493556984,24.673866844033622,-75.32613315596637,0.9015574544616669,1.2186411985195376,-0.012342846119356321,-165383785.0,-1.0
3434,2016-08-22,IBM,108.40509033203124,108.7912863462099,107.8156366726673,108.40509033203124,2133108.0,0.0,0.0,-0.02708435058596592,0.02708435058596592,0.0,42.4093479055449,107.34248886686709,111.75884493556984,24.060593136827276,-75.93940686317272,0.7828652576931745,1.131486010354265,-0.010941209047383715,-167516893.0,-1.0
3435,2016-08-23,IBM,108.62865982318571,109.31296188889856,108.56091089079491,108.58123016357422,2968653.0,0.0,0.0,0.17613983154298296,0.0,0.17613983154298296,45.349249132627904,107.55743241321792,111.75884493556984,24.36794161272174,-75.63205838727826,0.6950022951321984,1.0441892673098516,-0.011229167545240837,-164548240.0,1.0
3436,2016-08-24,IBM,108.33053701705995,108.5270251311496,107.26681935990293,107.76141357421876,3813507.0,0.0,0.0,-0.8198165893554545,0.8198165893554545,0.0,35.5917747456553,107.26681935990293,111.75884493556984,11.01049417427701,-88.98950582572299,0.5528450632611168,0.9459204265001047,-0.027395495398781944,-168361747.0,-1.0
3437,2016-08-25,IBM,107.72753204079235,108.09339787796496,107.3345666325514,107.47684478759766,2693450.0,0.0,0.0,-0.28456878662110796,0.28456878662110796,0.0,32.76796605209718,107.26681935990293,111.75884493556984,4.675517183883116,-95.32448281611688,0.41246744205605523,0.8392298296112947,-0.020500561637792125,-171055197.0,-1.0
3438,2016-08-26,IBM,107.64626142486496,108.70320985565962,106.94839862526494,107.266845703125,2613849.0,0.0,0.0,-0.20999908447265625,0.20999908447265625,0.0,30.69437787428693,106.94839862526494,111.75884493556984,6.619907121255722,-93.38009287874428,0.2810324279111711,0.72759034927127,-0.021991501566588245,-173669046.0,-1.0
3439,2016-08-29,IBM,107.61235162486572,108.54734088018166,107.38876394654562,108.2153549194336,2589791.0,0.0,0.0,0.9485092163085938,0.0,0.9485092163085938,47.88250678318171,106.94839862526494,111.75884493556984,26.337603882088604,-73.66239611791138,0.25051818134465975,0.632175915685948,-0.006098576165038061,-171079255.0,1.0
3440,2016-08-30,IBM,108.2424650174934,108.50670207742316,107.5988123044146,107.9985580444336,1896712.0,0.0,0.0,-0.216796875,0.216796875,0.0,44.94295491084125,106.94839862526494,111.75884493556984,21.83081051999288,-78.16918948000712,0.20646176245243453,0.5470330850392453,-0.006482337420261275,-172975967.0,-1.0
3441,2016-08-31,IBM,108.17472967944056,108.17472967944056,107.2261796134813,107.64625549316406,2430486.0,0.0,0.0,-0.35230255126953125,0.35230255126953125,0.0,40.30358879918971,106.94839862526494,110.74937499535464,18.359937025408307,-81.64006297459169,0.14148787732219148,0.46592404349583455,-0.015369256156083644,-175406453.0,-1.0
3442,2016-09-01,IBM,107.2668491500342,108.14763953733306,107.11779065158696,108.09342956542967,2466886.0,0.0,0.0,0.4471740722656108,0.0,0.4471740722656108,48.1434657132232,106.94839862526494,110.41734954354794,33.00798907617516,-66.99201092382484,0.12464202006670178,0.397667638810008,-0.0031240276991496563,-172939567.0,1.0
3443,2016-09-02,IBM,108.32376926875251,108.79126391908102,107.82916423262742,108.10018157958984,2421908.0,0.0,0.0,0.006752014160170461,0.0,0.006752014160170461,48.26184523826711,106.94839862526494,109.76014848030896,40.96320845393523,-59.03679154606477,0.11056189918626558,0.34024649088525954,-0.0028126792893903296,-170517659.0,1.0
3444,2016-09-06,IBM,108.32379091832226,108.98777381859576,107.8020862060082,108.64222717285156,3131829.0,0.0,0.0,0.5420455932617188,0.0,0.5420455932617188,57.29264409758064,106.94839862526494,109.76014848030896,60.24108241876678,-39.75891758123321,0.14151060509070135,0.3004993137263479,0.0005617638443169426,-167385830.0,1.0
3445,2016-09-07,IBM,108.5337828136486,109.5975111689967,108.40505445615004,109.5162124633789,2999196.0,0.0,0.0,0.8739852905273438,0.0,0.8739852905273438,67.76162829630641,106.94839862526494,109.76014848030896,91.32440545902575,-8.675594540974256,0.23386513454404678,0.2871724778898877,0.016284111640309407,-164386634.0,1.0
3446,2016-09-08,IBM,108.77771780003678,109.22488237956068,107.56493081161608,107.7275390625,4145507.0,0.0,0.0,-1.7886734008789062,1.7886734008789062,0.0,42.9179585232602,106.94839862526494,109.5975111689967,29.411375484164775,-70.58862451583522,0.16087134490555854,0.26191225129302187,0.0023325421898807708,-168532141.0,-1.0
3447,2016-09-09,IBM,107.07035454767298,107.32104185929292,105.45783236841662,105.48493194580078,5424556.0,0.0,0.0,-2.2426071166992188,2.2426071166992188,0.0,28.04365623608065,105.45783236841662,109.5975111689967,0.6546299529414199,-99.34537004705858,-0.0770482471109375,0.19412015161222998,-0.01661197125396885,-173956697.0,-1.0
3448,2016-09-12,IBM,105.19360348921076,107.40912928698457,104.90903627668224,107.24652099609376,4568405.0,0.0,0.0,1.761589050292983,0.0,1.761589050292983,45.24374227702895,104.90903627668224,109.5975111689967,49.85597178398505,-50.14402821601496,-0.1220488209226005,0.1308863571052639,-0.00895283228577981,-169388292.0,1.0
3449,2016-09-13,IBM,106.7993449616822,107.00261343469396,105.3562112562844,105.56623840332033,3803988.0,0.0,0.0,-1.6802825927734375,1.6802825927734375,0.0,35.82018303668701,104.90903627668224,109.5975111689967,14.01739673844464,-85.98260326155535,-0.28995444802281156,0.04671819607964877,-0.02252177885664497,-173192280.0,-1.0
3450,2016-09-14,IBM,105.491699504341,105.6068781130565,103.92660702106272,104.37377166748048,4038188.0,0.0,0.0,-1.1924667358398438,1.1924667358398438,0.0,30.600985751054267,103.92660702106272,109.5975111689967,7.885244305895587,-92.11475569410442,-0.5133256681480987,-0.06529057676590075,-0.03040034983744877,-177230468.0,-1.0
3451,2016-09-15,IBM,104.54315992855246,105.91854455558456,103.80464779811535,105.464599609375,3813298.0,0.0,0.0,1.090827941894517,0.0,1.090827941894517,39.851365701724006,103.80464779811535,109.5975111689967,28.65511759872724,-71.34488240127276,-0.5954641310792113,-0.1713252876285629,-0.024319979175639217,-173417170.0,1.0
3452,2016-09-16,IBM,105.0445093795286,105.28841632624469,103.98078095445118,104.2314682006836,6760926.0,0.0,0.0,-1.2331314086914062,1.2331314086914062,0.0,33.94890559357482,103.80464779811535,109.5975111689967,7.368038485314754,-92.63196151468524,-0.751401168757539,-0.28734046385435813,-0.0357882227612899,-180178096.0,-1.0
3453,2016-09-19,IBM,104.9293212890625,105.82366109780104,104.7125031184374,104.9293212890625,2562805.0,0.0,0.0,0.6978530883789062,0.0,0.6978530883789062,39.773675363017695,103.80464779811535,109.5975111689967,19.41481127624167,-80.58518872375832,-0.8093418930079821,-0.391740749685083,-0.03417553174680199,-177615291.0,1.0
3454,2016-09-20,IBM,105.60684121523316,106.0811160867108,104.64475250244142,104.6447525024414,2258419.0,0.0,0.0,-0.28456878662109375,0.28456878662109375,0.0,38.18911249095181,103.80464779811535,109.5975111689967,14.502408403915714,-85.49759159608429,-0.8682144218462327,-0.487035484117313,-0.04448163291408991,-179873710.0,-1.0
3455,2016-09-21,IBM,104.95646838849348,105.47816234073606,104.25183604954007,105.37653350830078,2587699.0,0.0,0.0,0.731781005859375,0.0,0.731781005859375,44.723381313099395,103.80464779811535,109.5975111689967,27.13486594706745,-72.86513405293255,-0.8460697482823463,-0.5588423369503197,-0.02182362629517831,-177286011.0,1.0
3456,2016-09-22,IBM,105.79660349551456,106.52155507188064,105.48493671375395,105.76949310302734,2814891.0,0.0,0.0,0.3929595947265625,0.0,0.3929595947265625,48.12146736853225,103.80464779811535,109.5975111689967,33.91837816836081,-66.0816218316392,-0.7877309081810893,-0.6046200511964737,0.002697647445729645,-174471120.0,1.0
3457,2016-09-23,IBM,105.43746310411916,105.72203018867984,104.82091009913232,105.00383758544922,2826501.0,0.0,0.0,-0.765655517578125,0.765655517578125,0.0,42.278352956622285,103.80464779811535,109.5975111689967,20.70115779636306,-79.29884220363694,-0.7941247823452358,-0.6425209974262261,-0.020911479363757035,-177297621.0,-1.0
3458,2016-09-26,IBM,104.65158368329124,104.65158368329124,103.9740616567368,104.32637786865234,2649832.0,0.0,0.0,-0.677459716796875,0.677459716796875,0.0,37.61532219076804,103.80464779811535,109.5975111689967,9.00642803280222,-90.99357196719778,-0.844126743416652,-0.6828421466243114,-0.011744858521254176,-179947453.0,-1.0
3459,2016-09-27,IBM,104.55671527578092,106.21666717529298,104.21116861842786,106.21666717529295,3124611.0,0.0,0.0,1.8902893066406108,0.0,1.8902893066406108,53.96282983661421,103.80464779811535,109.22488237956068,44.50027652741231,-55.49972347258769,-0.722890081693123,-0.6908517336380738,0.017656691699172056,-176822842.0,1.0
3460,2016-09-28,IBM,106.36573059288465,107.47687823573968,105.85080614071022,107.24652099609376,3462260.0,0.0,0.0,1.0298538208008097,0.0,1.0298538208008097,60.47390535730805,103.80464779811535,107.47687823573968,93.72704835497913,-6.272951645020863,-0.5375124484077531,-0.6601838765920097,0.01689591951535152,-173360582.0,1.0
3461,2016-09-29,IBM,107.47685833236724,111.79274132272266,106.68414711627923,107.12454223632812,3530041.0,0.0,0.0,-0.12197875976563921,0.12197875976563921,0.0,59.327193114376335,103.80464779811535,111.79274132272266,41.56053541418665,-58.43946458581335,-0.3958785632975719,-0.6073228139331222,0.027756243729334384,-176890623.0,-1.0
3462,2016-09-30,IBM,107.65978013839153,108.2966524825252,107.0906567200567,107.62590026855467,3762357.0,0.0,0.0,0.5013580322265483,0.0,0.5013580322265483,62.6830557642293,103.80464779811535,111.79274132272266,47.836851918019704,-52.163148081980296,-0.24040603463421917,-0.5339394580733415,0.025699003351632888,-173128266.0,1.0
3463,2016-10-03,IBM,107.09067147374408,107.30069857959298,106.38602847898449,106.78577423095705,2330279.0,0.0,0.0,-0.8401260375976278,0.8401260375976278,0.0,54.058985290691446,103.80464779811535,111.79274132272266,37.31962355796582,-62.68037644203418,-0.18287600481022537,-0.4637267674207183,0.020459905320772576,-175458545.0,-1.0
3464,2016-10-04,IBM,106.82646704453936,107.4091405063317,105.57303025755398,106.00664520263672,3016769.0,0.0,0.0,-0.7791290283203267,0.7791290283203267,0.0,47.12161117568275,103.80464779811535,111.79274132272266,27.565994285596624,-72.43400571440338,-0.19787130558552235,-0.4105556750536791,0.005979620636185512,-178475314.0,-1.0
3465,2016-10-05,IBM,106.4198935896494,106.93481786684887,106.18275612876973,106.42667388916016,1761987.0,0.0,0.0,0.4200286865234375,0.0,0.4200286865234375,51.0306421245998,103.9740616567368,111.79274132272266,31.368624079755147,-68.63137592024485,-0.1738582550676,-0.36321619105646336,0.006213330203754142,-176713327.0,1.0
3466,2016-10-06,IBM,106.264045759487,106.66379138116436,105.62039323695664,106.29114532470705,2039805.0,0.0,0.0,-0.1355285644531108,0.1355285644531108,0.0,49.663762388879476,103.9740616567368,111.79274132272266,29.63522956504303,-70.36477043495697,-0.16387471629833783,-0.3233478961048383,0.012259625637113025,-178753132.0,-1.0
3467,2016-10-07,IBM,106.46733568327898,106.84675133946402,104.92256267120322,105.47136688232422,2794807.0,0.0,0.0,-0.8197784423828267,0.8197784423828267,0.0,41.84168665092173,103.9740616567368,111.79274132272266,19.1503590062815,-80.8496409937185,-0.2195807686059652,-0.30259447060506367,0.010975067255890147,-181547939.0,-1.0
3468,2016-10-10,IBM,106.1760126058184,107.38201947589825,106.14213272772976,106.38603973388672,2595440.0,0.0,0.0,0.9146728515625,0.0,0.9146728515625,51.64627825504057,103.9740616567368,111.79274132272266,30.848917978350187,-69.15108202164981,-0.18775741096044385,-0.27962705867613974,0.001594594926559445,-178952499.0,1.0
3469,2016-10-11,IBM,106.18953775698884,106.33859620934258,104.26534928945615,104.8751220703125,3034760.0,0.0,0.0,-1.5109176635742188,1.5109176635742188,0.0,39.086818825181076,103.9740616567368,111.79274132272266,11.524457479638798,-88.4755425203612,-0.2812139396889819,-0.2799444348787082,-0.02211166295890976,-181987259.0,-1.0
3470,2016-10-12,IBM,104.99708686264913,104.99708686264913,103.71655097411552,104.53636169433594,3100344.0,0.0,0.0,-0.3387603759765625,0.3387603759765625,0.0,36.77334411202453,103.71655097411552,111.79274132272266,10.150958370635797,-89.8490416293642,-0.37825376923012755,-0.29960630174899205,-0.024160481696924196,-185087603.0,-1.0
3471,2016-10-13,IBM,104.13663928714584,104.48896624571506,103.16776988924492,104.15019989013672,3043755.0,0.0,0.0,-0.38616180419921875,0.38616180419921875,0.0,34.11730898005948,103.16776988924492,111.79274132272266,11.390530490089553,-88.60946950991044,-0.480776471692991,-0.3358403357377919,-0.03229427460997003,-188131358.0,-1.0
3472,2016-10-14,IBM,104.6583022861516,105.3764840782863,104.40084558178434,104.6447525024414,4558677.0,0.0,0.0,0.4945526123046875,0.0,0.4945526123046875,40.47092435340195,103.16776988924492,111.79274132272266,17.12449281238881,-82.87550718761119,-0.5161701017385525,-0.37190628893794403,-0.020049690550400623,-183572681.0,1.0
3473,2016-10-17,IBM,104.64478011397064,105.62042968178078,104.57025087696252,104.86158752441406,6161358.0,0.0,0.0,0.21683502197265625,0.0,0.21683502197265625,43.24013370331819,103.16776988924492,111.79274132272266,19.63853037929614,-80.36146962070386,-0.5207204927366575,-0.40166912969768676,-0.010801753758302834,-177411323.0,1.0
3474,2016-10-18,IBM,101.6433320312198,102.30731498811528,100.13243854786413,102.11760711669922,13358048.0,0.0,0.0,-2.7439804077148438,2.7439804077148438,0.0,25.74975444521864,100.13243854786413,111.79274132272266,17.025017335874253,-82.97498266412575,-0.7372445011969262,-0.46878420399753473,-0.04048859759489132,-190769371.0,-1.0
3475,2016-10-19,IBM,102.49020607003544,103.28969745442278,102.19209998615555,102.48343658447266,4846013.0,0.0,0.0,0.3658294677734375,0.0,0.3658294677734375,30.09925686956781,100.13243854786413,108.2966524825252,28.79637960768513,-71.20362039231487,-0.8693011941431621,-0.5488876020266602,-0.0358233861212266,-185923358.0,1.0
3476,2016-10-20,IBM,102.49698344556586,103.59458088252218,102.32082543171332,102.65959167480467,4208163.0,0.0,0.0,0.17615509033201704,0.0,0.17615509033201704,32.30258012772144,100.13243854786413,107.4091405063317,34.7293752219687,-65.2706247780313,-0.9488055908791893,-0.6288711997971661,-0.02665913309587309,-181715195.0,1.0
3477,2016-10-21,IBM,102.02271915193069,102.4089150882682,101.33163680926774,101.37906646728516,4617253.0,0.0,0.0,-1.280525207519517,1.280525207519517,0.0,25.548051454968828,100.13243854786413,107.4091405063317,17.131771048701335,-82.86822895129866,-1.1024329200798633,-0.7235835438537056,-0.04706419450452304,-186332448.0,-1.0
3478,2016-10-24,IBM,101.9007516096548,102.65958273745736,101.9007516096548,102.01593017578124,2789368.0,0.0,0.0,0.6368637084960795,0.0,0.6368637084960795,33.52476497257973,100.13243854786413,107.38201947589825,25.98069663080317,-74.01930336919683,-1.1594289315099786,-0.8107526213849602,-0.02726282304219252,-183543080.0,1.0
3479,2016-10-25,IBM,102.015955563583,102.41569049517716,101.5145810101289,102.22598266601562,2769285.0,0.0,0.0,0.2100524902343892,0.0,0.2100524902343892,36.129004067187324,100.13243854786413,107.38201947589825,28.878139839170103,-71.1218601608299,-1.1741147368965414,-0.8834250444872764,-0.022101199916215286,-180773795.0,1.0
3480,2016-10-26,IBM,102.11079445741072,103.62168746198624,101.80590806216456,102.85608673095705,2941038.0,0.0,0.0,0.6301040649414205,0.0,0.6301040649414205,43.75562902499805,100.13243854786413,107.38201947589825,37.56973279049242,-62.43026720950758,-1.121975773122628,-0.9311351902143468,-0.012425450556453832,-177832757.0,1.0
3481,2016-10-27,IBM,103.5404091930872,104.38055013123385,102.99838522322295,103.89950561523438,4423848.0,0.0,0.0,1.0434188842773295,0.0,1.0434188842773295,54.204038840272005,100.13243854786413,107.38201947589825,51.962549349618335,-48.037450650381665,-0.9851044144614178,-0.9419290350637609,-0.0071216842640020595,-173408909.0,1.0
3482,2016-10-28,IBM,104.37377115682426,104.63800825101204,103.1067956532749,103.39813232421876,3822607.0,0.0,0.0,-0.5013732910156108,0.5013732910156108,0.0,49.142539984773556,100.13243854786413,106.33859620934258,52.62021937703514,-47.37978062296486,-0.9066383485319705,-0.9348708977574028,-0.013956065655162608,-177231516.0,-1.0
3483,2016-10-31,IBM,103.49976452497808,104.56348242372756,103.49976452497808,104.12986755371094,3716647.0,0.0,0.0,0.7317352294921733,0.0,0.7317352294921733,56.05314364933953,100.13243854786413,105.62042968178078,72.8395674902255,-27.16043250977449,-0.7764579840006007,-0.9031883150060425,0.019705323046907308,-173514869.0,1.0
3484,2016-11-01,IBM,104.00113590307949,104.2789227860392,102.8086788269798,103.52008056640624,3338727.0,0.0,0.0,-0.6097869873047017,0.6097869873047017,0.0,49.57571812744928,100.13243854786413,105.62042968178078,61.72827061629068,-38.27172938370932,-0.714260273067282,-0.8654027066182906,0.010115234387940486,-176853596.0,-1.0
3485,2016-11-02,IBM,103.31003937148616,103.89949293507097,102.76123516755789,102.95094299316406,3215822.0,0.0,0.0,-0.5691375732421733,0.5691375732421733,0.0,44.08892062177395,100.13243854786413,105.62042968178078,51.357671259363634,-48.642328740636366,-0.702791442445772,-0.8328804537837867,0.0028380330917572305,-180069418.0,-1.0
3486,2016-11-03,IBM,103.33035265075412,104.1637239516904,102.84930822136528,103.23550415039062,3011225.0,0.0,0.0,0.2845611572265625,0.0,0.2845611572265625,47.444549688207594,100.13243854786413,105.62042968178078,56.54283191802304,-43.45716808197696,-0.6630968367675933,-0.7989237303805482,0.018311844326407645,-177058193.0,1.0
3487,2016-11-04,IBM,103.25583110674764,104.0959719561555,102.89674553640567,103.27616119384766,2584038.0,0.0,0.0,0.04065704345703125,0.0,0.04065704345703125,47.95945337696261,100.13243854786413,104.63800825101204,69.77414296325503,-30.225857036744962,-0.6211971184616942,-0.7633784079967775,0.012353276747023134,-174474155.0,1.0
3488,2016-11-07,IBM,104.3331295804266,105.76949376674578,104.2315007530658,105.50525665283205,3979925.0,0.0,0.0,2.229095458984389,0.0,2.229095458984389,67.87216720335739,101.33163680926774,105.76949376674578,94.04583977253972,-5.954160227460279,-0.4034709536197312,-0.6913969171213683,0.032078674142269614,-170494230.0,1.0
3489,2016-11-08,IBM,105.66932739375468,106.60596814971598,104.64380855683316,106.08637237548828,4102307.0,1.338432,0.0,0.5811157226562358,0.0,0.5811157226562358,71.18835093529312,101.33163680926774,106.60596814971598,90.14859437739575,-9.851405622604245,-0.18193300666702328,-0.5895041350304994,0.031405877349589995,-166391923.0,1.0
3490,2016-11-09,IBM,104.57545128710596,106.35301301319284,103.23543818037226,105.84024810791016,5652270.0,0.0,0.0,-0.246124267578125,0.246124267578125,0.0,67.76986729082542,101.33163680926774,106.60596814971598,85.48213996466998,-14.51786003533001,-0.025923924198451687,-0.4767880928640898,0.018679034911511794,-172044193.0,-1.0
3491,2016-11-10,IBM,107.78873181121288,110.1816091680902,107.74087186343957,109.53894805908205,8070727.0,0.0,0.0,3.698699951171889,0.0,3.698699951171889,82.41345831307163,101.5145810101289,110.1816091680902,92.58498879552126,-7.415011204478748,0.39165383081142124,-0.30309970812898757,0.05939000634564584,-163973466.0,1.0
3492,2016-11-11,IBM,109.3680397933521,110.30466971716764,108.9304802510316,110.25682067871094,4651144.0,0.0,0.0,0.717872619628892,0.0,0.717872619628892,84.0376202566613,101.5145810101289,110.30466971716764,99.45564783187696,-0.5443521681230392,0.7716187899398363,-0.08815600851522272,0.05883953633033934,-159322322.0,1.0
3493,2016-11-14,IBM,110.24312434485438,110.6601583607984,107.7340238784205,108.16474151611328,5435539.0,0.0,0.0,-2.0920791625976562,2.0920791625976562,0.0,64.12407347164672,101.80590806216456,110.6601583607984,71.81673478250156,-28.183265217498445,0.8936292516145414,0.10820104351073016,0.04486724628008365,-164757861.0,-1.0
3494,2016-11-15,IBM,108.30833368206342,108.80741497577388,107.71353248743186,108.479248046875,3636942.0,0.0,0.0,0.31450653076171875,0.0,0.31450653076171875,65.54046633502512,102.76123516755789,110.6601583607984,72.38977692820569,-27.610223071794305,1.004126524592948,0.2873861397271738,0.05369844017920289,-161120919.0,1.0
3495,2016-11-16,IBM,108.33565865674711,109.0808704624474,108.0416790210982,108.90311431884766,2356429.0,0.0,0.0,0.42386627197265625,0.0,0.42386627197265625,67.5337098870294,102.76123516755789,110.6601583607984,77.75590420407767,-22.244095795922338,1.1130681188548266,0.4525225355527045,0.05489981586374215,-158764490.0,1.0
3496,2016-11-17,IBM,108.8552396555855,109.34064807931104,108.60227818452162,109.25177001953124,2365215.0,0.0,0.0,0.34865570068357954,0.0,0.34865570068357954,69.22332758916427,102.76123516755789,110.6601583607984,82.16986914783025,-17.830130852169745,1.2135496731731763,0.6047279630767989,0.0578604854848106,-156399275.0,1.0
3497,2016-11-18,IBM,109.25178676069896,109.8807750856671,108.84842543679542,109.65515899658205,3118754.0,0.0,0.0,0.40338897705080967,0.0,0.40338897705080967,71.22264532278261,102.76123516755789,110.6601583607984,87.27675482303226,-12.72324517696773,1.3106240894189654,0.7459071883452323,0.039333607399348436,-153280521.0,1.0
3498,2016-11-21,IBM,109.86026559316797,111.4395673770792,109.64149130524322,111.2823257446289,4850407.0,0.0,0.0,1.6271667480468608,0.0,1.6271667480468608,77.9035893055252,102.76123516755789,111.4395673770792,98.18811231635293,-1.8118876836470759,1.5015461323113612,0.8970349771384583,0.04897851866165959,-148430114.0,1.0
3499,2016-11-22,IBM,111.4395519201704,111.4395519201704,110.72168558851126,111.21393585205078,2898257.0,0.0,0.0,-0.068389892578125,0.068389892578125,0.0,77.03624835184004,102.84930822136528,111.4395673770792,97.3734025838052,-2.626597416194797,1.6285616886474799,1.0433403194402626,0.05077168506504104,-151328371.0,-1.0
3500,2016-11-23,IBM,110.71488022246616,111.01569080401852,110.318338831179,110.74222564697266,2356324.0,0.0,0.0,-0.471710205078125,0.471710205078125,0.0,70.76595294344247,102.89674553640567,111.4395673770792,91.83710320650249,-8.162896793497506,1.6718868894898122,1.1690496334501725,0.01098492918921945,-153684695.0,-1.0
3501,2016-11-25,IBM,110.63966663033992,111.56946555439656,110.63966663033992,111.5352783203125,1679144.0,0.0,0.0,0.7930526733398438,0.0,0.7930526733398438,74.75241304815975,103.23543818037226,111.56946555439656,99.58978735550336,-0.4102126444966296,1.7500417542396463,1.2852480576080674,0.011595270330957641,-152005551.0,1.0
3502,2016-11-28,IBM,111.5762987047035,112.57446110746396,111.23445912633942,112.47875213623048,4654072.0,0.0,0.0,0.943473815917983,0.0,0.943473815917983,78.73325726785872,103.23543818037226,112.57446110746396,98.97517147156975,-1.024828528430252,1.8665935708634294,1.4015171602591399,0.03988370479741343,-147351479.0,1.0
3503,2016-11-29,IBM,112.12323108557956,112.4035379902558,111.4600665019298,111.80189514160156,3293017.0,0.0,0.0,-0.6768569946289205,0.6768569946289205,0.0,69.6435261885224,103.23543818037226,112.57446110746396,91.72755038836826,-8.272449611631755,1.8826430849331786,1.4977423451939478,0.030629333762442812,-150644496.0,-1.0
3504,2016-11-30,IBM,111.67884534719803,111.98649768272756,110.89944633614849,110.90628814697266,4600099.0,0.0,0.0,-0.8956069946289062,0.8956069946289062,0.0,59.2074419531515,107.71353248743186,112.57446110746396,65.68201076607684,-34.31798923392314,1.802318435872877,1.5586575633297337,0.018394091304497318,-155244595.0,-1.0
3505,2016-12-01,IBM,110.72170899088172,110.89263425872798,108.22628082898422,109.26547241210938,4848942.0,0.0,0.0,-1.6408157348632812,1.6408157348632812,0.0,44.96407335201994,107.71353248743186,112.57446110746396,31.926819873097916,-68.07318012690207,1.5879554933907087,1.564517149341929,0.00012542032569062833,-160093537.0,-1.0
3506,2016-12-02,IBM,108.70484690636576,109.58679675167856,108.30147466567202,109.4021987915039,2866981.0,0.0,0.0,0.13672637939453125,0.0,0.13672637939453125,46.20827926466153,107.71353248743186,112.57446110746396,34.73958241462293,-65.26041758537707,1.4128179078262662,1.5341773010387967,-0.0023068700770022543,-157226556.0,1.0
3507,2016-12-05,IBM,109.96964230841829,110.17474385572034,109.1082070801669,109.27912139892578,3605667.0,0.0,0.0,-0.123077392578125,0.123077392578125,0.0,45.14814762946042,107.71353248743186,112.57446110746396,32.20760957159623,-67.79239042840376,1.2496832222031742,1.4772784852716723,-0.018001100644679968,-160832223.0,-1.0
3508,2016-12-06,IBM,109.47742737501376,109.92865965426934,108.65701000908632,109.62783813476562,2990514.0,0.0,0.0,0.34871673583984375,0.0,0.34871673583984375,48.97519438062549,108.0416790210982,112.57446110746396,34.993059084804884,-65.00694091519512,1.1354476016001769,1.4089123085373734,-0.01426168137233419,-157841709.0,1.0
3509,2016-12-07,IBM,109.79877300439152,112.93001015769389,109.65519313283318,112.6633758544922,4639115.0,0.0,0.0,3.0355377197265767,0.0,3.0355377197265767,69.99921681180707,108.22628082898422,112.93001015769389,94.33142758503863,-5.66857241496137,1.2751583425691706,1.382161515343733,0.017347946515395618,-153202594.0,1.0
3510,2016-12-08,IBM,112.71804178097268,113.49059901565276,112.27365141695132,113.05303955078124,3416654.0,0.0,0.0,0.3896636962890341,0.0,0.3896636962890341,71.72482417528349,108.22628082898422,113.49059901565276,91.68820254862995,-8.311797451370053,1.401170889270844,1.3859633901291553,0.01360790283868707,-149785940.0,1.0
3511,2016-12-09,IBM,112.92997045310167,113.98283458110924,112.53344004436612,113.84610748291016,3291657.0,0.0,0.0,0.7930679321289205,0.0,0.7930679321289205,75.08961576418719,108.22628082898422,113.98283458110924,97.62484458433805,-2.375155415661944,1.5471955869503091,1.4182098294933863,0.012156565757624804,-146494283.0,1.0
3512,2016-12-12,IBM,113.98282921282372,114.03068915092888,112.85475977794616,113.14875030517578,3548346.0,0.0,0.0,-0.697357177734375,0.697357177734375,0.0,67.0001237098447,108.22628082898422,114.03068915092888,84.80570633842625,-15.194293661573758,1.5883409104189212,1.4522360456784935,0.01204680083345977,-150042629.0,-1.0
3513,2016-12-13,IBM,113.2718251914567,116.19114008858412,113.2718251914567,115.05622863769533,6205186.0,0.0,0.0,1.9074783325195455,0.0,1.9074783325195455,75.37343813132077,108.22628082898422,116.19114008858412,85.75101688682189,-14.248983113178113,1.7546400375492652,1.512716844052648,0.03741844182201093,-143837443.0,1.0
3514,2016-12-14,IBM,115.1109146319824,116.15010614552888,114.48193718661278,115.20663452148438,4313913.0,0.0,0.0,0.1504058837890483,0.0,0.1504058837890483,75.92912493789312,108.22628082898422,116.19114008858412,87.63938526706372,-12.36061473293628,1.8769336687650195,1.5855602089951224,0.054373645930592795,-139523530.0,1.0
3515,2016-12-15,IBM,114.86480888344175,116.12277483907748,114.70756723098036,114.87165069580078,3544476.0,0.0,0.0,-0.33498382568359375,0.33498382568359375,0.0,71.76751719667391,108.22628082898422,116.19114008858412,83.43361320298307,-16.56638679701693,1.9246358533522852,1.653375337866555,0.049993985173190314,-143068006.0,-1.0
3516,2016-12-16,IBM,115.52111141888064,115.61682038208498,113.53160676738052,113.98966979980467,7448148.0,0.0,0.0,-0.881980895996108,0.881980895996108,0.0,61.523363913646314,108.22628082898422,116.19114008858412,72.36021105927198,-27.63978894072803,1.8697187372844866,1.6966440177501418,0.043105657700915456,-150516154.0,-1.0
3517,2016-12-19,IBM,114.05801798401812,114.35200846849834,113.49057335578183,113.9554672241211,3091871.0,0.0,0.0,-0.03420257568357954,0.03420257568357954,0.0,61.132909127945794,108.22628082898422,116.19114008858412,71.93079260291499,-28.069207397085005,1.8026567601137629,1.717846566222866,0.03947564015661342,-153608025.0,-1.0
3518,2016-12-20,IBM,114.50929017256588,115.02888596366054,113.79826550180276,114.5844955444336,2274632.0,0.0,0.0,0.6290283203125,0.0,0.6290283203125,65.74608662573547,108.22628082898422,116.19114008858412,79.82833730283349,-20.17166269716651,1.7797511253740055,1.730227478053094,0.01705185625204919,-151333393.0,1.0
3519,2016-12-21,IBM,113.66152463803434,114.81693969923586,112.97784540826127,114.39989471435548,3740182.0,0.0,0.0,-0.1846008300781108,0.1846008300781108,0.0,63.20577920768074,108.30147466567202,116.19114008858412,77.2963075338183,-22.703692466181696,1.7267970590004467,1.7295413942425646,0.011913480335654869,-155073575.0,-1.0
3520,2016-12-22,IBM,114.42041073228113,115.01521188819216,113.8871422355306,114.2153091430664,2931520.0,0.0,0.0,-0.1845855712890767,0.1845855712890767,0.0,60.50838787192634,108.65701000908632,116.19114008858412,73.77492922647525,-26.225070773524745,1.6509054564795917,1.7138142066899702,0.003242988876116515,-158005095.0,-1.0
3521,2016-12-23,IBM,114.17427621781306,114.50927398187169,113.79824941164172,113.97600555419922,1779455.0,0.0,0.0,-0.2393035888671875,0.2393035888671875,0.0,56.877388413843,108.65701000908632,116.19114008858412,70.59866884415997,-29.401331155840026,1.5535427413586973,1.6817599136237156,0.0073112186108306165,-159784550.0,-1.0
3522,2016-12-27,IBM,114.16058879558372,114.84426792296624,114.0717107272636,114.26998138427734,1461785.0,0.0,0.0,0.293975830078125,0.0,0.293975830078125,60.2578232796267,109.65519313283318,116.19114008858412,70.6062684211909,-29.39373157880909,1.4830082844313637,1.6420095877852452,-0.0068335913902916046,-158322765.0,1.0
3523,2016-12-28,IBM,114.37254907314625,114.68021236434424,113.49061007032668,113.6205062866211,1838345.0,0.0,0.0,-0.64947509765625,0.64947509765625,0.0,50.22185937467306,112.27365141695132,116.19114008858412,34.38056833252832,-65.61943166747167,1.3590358869182069,1.5854148476118377,-0.013767681361853246,-160161110.0,-1.0
3524,2016-12-29,IBM,113.50428739430131,114.1674521263133,113.49061468213472,113.90081787109376,1740021.0,0.0,0.0,0.28031158447267046,0.0,0.28031158447267046,54.034323426181224,112.53344004436612,116.19114008858412,37.383541848631424,-62.61645815136857,1.268779965269914,1.5220878711434531,-0.008451457072536916,-158421089.0,1.0
3525,2016-12-30,IBM,113.79138641755738,113.9691425270243,113.14873642916297,113.48373413085938,3088629.0,0.0,0.0,-0.4170837402343892,0.4170837402343892,0.0,47.75495906097225,112.85475977794616,116.19114008858412,18.851998104285336,-81.14800189571466,1.1503359680023237,1.4477374905152274,-0.004438434375973244,-161509718.0,-1.0
3526,2017-01-03,IBM,114.17425726253607,114.76905824264912,113.49740912379842,114.3041534423828,3069278.0,0.0,0.0,0.8204193115234233,0.0,0.8204193115234233,58.658999843597506,112.97784540826127,116.19114008858412,41.275642792533034,-58.72435720746697,1.1098752774098841,1.380165047894159,0.0030598463308120216,-158440440.0,1.0
3527,2017-01-04,IBM,114.70072898151368,116.13645115930352,114.42042199373454,115.71940612792967,3536944.0,0.0,0.0,1.415252685546875,0.0,1.415252685546875,70.79243483391508,112.97784540826127,116.15010614552888,86.42293136439389,-13.577068635606107,1.178424804967591,1.3398169993088456,0.009904573721808418,-154903496.0,1.0
3528,2017-01-05,IBM,115.7125517790699,115.80826075180424,114.35203525535638,115.3365249633789,2805686.0,0.0,0.0,-0.38288116455076704,0.38288116455076704,0.0,64.85092419333495,112.97784540826127,116.13645115930352,74.67470589956784,-25.32529410043216,1.1881591304692307,1.3094854255409227,0.00818733488664547,-157709182.0,-1.0
3529,2017-01-06,IBM,115.32968988887588,116.17061065136312,114.52978725607552,115.90397644042967,3080993.0,0.0,0.0,0.567451477050767,0.0,0.567451477050767,69.26247743936072,112.97784540826127,116.17061065136312,91.64880000151827,-8.351199998481729,1.227512248271239,1.2930907900869861,0.014784947044603536,-154628189.0,1.0
3530,2017-01-09,IBM,115.86293747494868,116.08855351562242,114.5981301972116,114.61864471435548,3336635.0,0.0,0.0,-1.2853317260741903,1.2853317260741903,0.0,52.15434765994298,112.97784540826127,116.17061065136312,51.39116662708763,-48.60883337291237,1.141822134517355,1.26283705897306,0.0056383723664596985,-157964824.0,-1.0
3531,2017-01-10,IBM,114.84426360422852,114.91946896013124,113.03935688652074,113.16242218017578,4308160.0,0.0,0.0,-1.4562225341797017,1.4562225341797017,0.0,39.42432432387125,112.97784540826127,116.17061065136312,5.781094376208714,-94.21890562379129,0.9455078872882154,1.1993712246360912,-0.009692477330305649,-162272984.0,-1.0
3532,2017-01-11,IBM,113.52475516764058,114.69385352866388,113.21710287304488,114.68701171875,3765077.0,0.0,0.0,1.5245895385742188,0.0,1.5245895385742188,53.21825881062399,112.97784540826127,116.17061065136312,53.532476720030665,-46.467523279969335,0.9025450882651995,1.140005997361913,0.009386557646896332,-158507907.0,1.0
3533,2017-01-12,IBM,114.70072617648243,114.86480964238704,113.18979865726467,114.82379150390624,3062165.0,0.0,0.0,0.1367797851562358,0.0,0.1367797851562358,54.295627939429046,113.03935688652074,116.17061065136312,56.98786337348554,-43.012136626514454,0.869510569461724,1.0859069117818752,0.008103309967949723,-155445742.0,1.0
3534,2017-01-13,IBM,114.83744832625732,115.18611882306932,114.09223647639092,114.40673065185548,3007668.0,0.0,0.0,-0.41706085205075283,0.41706085205075283,0.0,50.226108813591864,113.03935688652074,116.17061065136312,43.668570739541316,-56.33142926045868,0.8004500600422659,1.0288155414339533,0.008133293533783448,-158453410.0,-1.0
3535,2017-01-17,IBM,113.96233580682927,114.98101274751136,113.57263628048246,114.78275299072266,3468222.0,0.0,0.0,0.3760223388671733,0.0,0.3760223388671733,53.826372851428715,113.03935688652074,116.17061065136312,55.67725374981472,-44.32274625018529,0.7672169693236413,0.9764958270118909,0.004187070495046408,-154985188.0,1.0
3536,2017-01-18,IBM,114.48195760781503,115.26134592601151,113.9623617583567,114.03756713867188,4192159.0,0.0,0.0,-0.7451858520507812,0.7451858520507812,0.0,46.187095589365875,113.03935688652074,116.17061065136312,31.87893179910909,-68.12106820089092,0.6729914089751077,0.9157949434045342,-0.014533767891951488,-159177347.0,-1.0
3537,2017-01-19,IBM,114.14692334302302,114.48193202920764,113.35386248850602,114.04437255859376,7283716.0,0.0,0.0,0.006805419921889211,0.0,0.006805419921889211,46.26745427195348,113.03935688652074,116.17061065136312,32.096270297773756,-67.90372970222624,0.5920414289923883,0.851044240522105,-0.011203323536888465,-151893631.0,1.0
3538,2017-01-20,IBM,114.7280672587864,116.66288153833554,113.49061586691728,116.60134887695312,13273740.0,0.0,0.0,2.556976318359361,0.0,2.556976318359361,67.38322913204405,113.03935688652074,116.66288153833554,98.30185614021978,-1.6981438597802063,0.7258474879748462,0.8260048900126534,0.006016812001975458,-138619891.0,1.0
3539,2017-01-23,IBM,116.2800048442209,117.07990748803962,116.23214490293736,116.92949676513672,5730197.0,0.0,0.0,0.32814788818359375,0.0,0.32814788818359375,69.17687650907156,113.03935688652074,117.07990748803962,96.27746963875757,-3.722530361242439,0.8485865681384297,0.8305212256378087,0.02016122295408551,-132889694.0,1.0
3540,2017-01-24,IBM,117.15512687990822,120.32739241492354,117.01838885071362,120.25901794433594,7272210.0,0.0,0.0,3.3295211791992188,0.0,3.3295211791992188,81.24894831187274,113.03935688652074,120.32739241492354,99.0618257784127,-0.9381742215873089,1.200681992041595,0.9045533789185661,0.06271159301328,-125617484.0,1.0
3541,2017-01-25,IBM,120.5051282666693,122.54932381222116,120.4162501994714,121.89299011230467,6194935.0,0.0,0.0,1.6339721679687358,0.0,1.6339721679687358,84.65263621304479,113.03935688652074,122.54932381222116,93.09846495740418,-6.901535042595823,1.5932026026066382,1.0422832236561805,0.06283168674083228,-119422549.0,1.0
3542,2017-01-26,IBM,121.7357548190196,122.29636867014968,121.35972801058875,122.14595794677734,3204839.0,0.0,0.0,0.25296783447267046,0.0,0.25296783447267046,85.13465895868846,113.03935688652074,122.54932381222116,95.7584934985028,-4.241506501497201,1.9027566107553326,1.214377901076011,0.06376872203024253,-116217710.0,1.0
3543,2017-01-27,IBM,122.01603559254568,122.5151166851468,121.21613311767578,121.21613311767578,3642486.0,0.0,0.0,-0.9298248291015625,0.9298248291015625,0.0,75.12738559930341,113.03935688652074,122.54932381222116,85.98112164888325,-14.018878351116745,2.0494267833565516,1.3813876775321192,0.05951924704973521,-119860196.0,-1.0
3544,2017-01-30,IBM,120.99738778767347,121.05892044074004,119.35655341249723,120.19064331054688,4283161.0,0.0,0.0,-1.0254898071289062,1.0254898071289062,0.0,65.35175595633817,113.03935688652074,122.54932381222116,75.19780541717746,-24.802194582822537,2.0591785660696473,1.516945855239625,0.04711413674022369,-124143357.0,-1.0
3545,2017-01-31,IBM,119.67788295733642,120.04022613306492,118.69338238513336,119.3155288696289,4329394.0,0.0,0.0,-0.8751144409179688,0.8751144409179688,0.0,57.929625342571754,113.18979865726467,122.54932381222116,65.4491559234739,-34.55084407652611,1.9735427302751134,1.608265230246723,0.0462826581045781,-128472751.0,-1.0
3546,2017-02-01,IBM,119.64368786228576,120.12226540720135,118.20112432911414,119.15827941894533,2924302.0,0.0,0.0,-0.15724945068357954,0.15724945068357954,0.0,56.59691345356422,113.18979865726467,122.54932381222116,63.76905519100985,-36.230944808990145,1.871414495563613,1.660895083310101,0.04484137836546154,-131397053.0,-1.0
3547,2017-02-02,IBM,119.11725571146197,119.6231786966757,118.65236176654685,119.3565444946289,2741043.0,0.0,0.0,0.19826507568357954,0.0,0.19826507568357954,58.002520009319774,113.35386248850602,122.54932381222116,65.27874779530569,-34.721252204694316,1.785888853373379,1.6858938373227568,0.023629191636395985,-128656010.0,1.0
3548,2017-02-03,IBM,119.64371651220746,120.55984278295216,119.5685111396555,120.20433044433594,3461528.0,0.0,0.0,0.8477859497070312,0.0,0.8477859497070312,63.788507446938006,113.35386248850602,122.54932381222116,74.49836081809757,-25.50163918190243,1.7661592225357339,1.7019469143653523,0.028006908177985457,-125194482.0,1.0
3549,2017-02-06,IBM,119.85563543219055,120.31369847398422,119.219816257403,120.23165130615234,2772737.0,0.0,0.0,0.02732086181640625,0.0,0.02732086181640625,63.97306746648106,113.35386248850602,122.54932381222116,74.79547328319973,-25.204526716800267,1.7327538058985823,1.7081082926719986,-0.00022756412493118994,-122421745.0,1.0
3550,2017-02-07,IBM,120.32738661628856,122.11862088527737,120.25901214899596,122.00923919677734,4051681.0,0.0,0.0,1.777587890625,0.0,1.777587890625,73.94313266976555,113.35386248850602,122.54932381222116,94.12661750802064,-5.8733824919793465,1.8286368718207768,1.7322140085017543,0.0009536978653617023,-118370064.0,1.0
3551,2017-02-08,IBM,122.31242767383728,122.31242767383728,121.19610430813856,121.39594268798828,3047103.0,1.338432,0.0,-0.6132965087890625,0.6132965087890625,0.0,66.6053150180953,113.49061586691728,122.54932381222116,87.26770825158566,-12.732291748414335,1.8339958273627417,1.752570372273952,-0.006140319920499238,-121417167.0,-1.0
3552,2017-02-09,IBM,121.39595555194656,122.51916394727836,121.21679388146153,122.11260223388672,3232872.0,0.0,0.0,0.7166595458984375,0.0,0.7166595458984375,70.54625560184084,116.23214490293736,122.54932381222116,93.08676254692374,-6.913237453076264,1.8744636243705486,1.7769490226932716,0.007395625426696695,-118184295.0,1.0
3553,2017-02-10,IBM,122.22286365357238,123.25649124625376,121.80252110598629,123.12555694580078,3065512.0,0.0,0.0,1.0129547119140625,0.0,1.0129547119140625,75.3000799376957,117.01838885071362,123.25649124625376,97.90105560712522,-2.098944392874794,1.9656132585963775,1.814681869873893,0.024418819588732266,-115118783.0,1.0
3554,2017-02-13,IBM,123.51147704291922,123.96626623356605,123.23583856510756,123.59416198730467,3235696.0,0.0,0.0,0.46860504150389204,0.0,0.46860504150389204,77.25925040851264,118.20112432911414,123.96626623356605,93.54561860872793,-6.454381391272072,2.0520082373423207,1.8621471433675787,0.03585981773043856,-111883087.0,1.0
3555,2017-02-14,IBM,123.0497519595391,124.1247329711914,122.89816293053792,124.1247329711914,2904219.0,0.0,0.0,0.530570983886733,0.0,0.530570983886733,79.39448054960779,118.20112432911414,124.1247329711914,100.0,-0.0,2.1386366525975546,1.917445045213574,0.041679466810566,-108978868.0,1.0
3556,2017-02-15,IBM,124.17292546795134,125.3581527132502,123.9041830400863,125.1927719116211,3048358.0,0.0,0.0,1.0680389404296875,0.0,1.0680389404296875,83.08371605914851,118.20112432911414,125.3581527132502,97.68925323817791,-2.310746761822093,2.2673356780016434,1.9874231717711879,0.04889742277395448,-105930510.0,1.0
3557,2017-02-16,IBM,125.03431915056731,125.95768911464586,124.6346423615991,125.02053833007812,3401069.0,0.0,0.0,-0.17223358154296875,0.17223358154296875,0.0,80.40507258318749,118.20112432911414,125.95768911464586,87.9179661295965,-12.082033870403512,2.3285902335313153,2.0556565841232137,0.040066841751366544,-109331579.0,-1.0
3558,2017-02-17,IBM,124.89648428306256,125.11698838149482,124.03513361834511,124.49681854248048,3715915.0,0.0,0.0,-0.523719787597642,0.523719787597642,0.0,72.23415796691629,118.20112432911414,125.95768911464586,81.16601082362736,-18.83398917637264,2.308266836903968,2.1061786346793645,0.0354745791976816,-113047494.0,-1.0
3559,2017-02-21,IBM,124.4485946367964,124.57951792936512,123.42874794044948,124.2143096923828,4686394.0,0.0,0.0,-0.28250885009768467,0.28250885009768467,0.0,67.93706280350857,118.20112432911414,125.95768911464586,77.5238205253571,-22.47617947464291,2.2435025941037594,2.1336434265642437,0.018072979637624886,-117733888.0,-1.0
3560,2017-02-22,IBM,124.09714490909026,124.9585065936219,124.09714490909026,124.82758331298828,3159443.0,0.0,0.0,0.613273620605483,0.0,0.613273620605483,72.0950549305089,118.65236176654685,125.95768911464586,84.53038792366158,-15.469612076338418,2.216116509290316,2.1501380431094583,0.028268165714730564,-114574445.0,1.0
3561,2017-02-23,IBM,125.4133042494864,125.75784674735284,124.6690959735381,125.17213439941406,2387495.0,0.0,0.0,0.34455108642578125,0.0,0.34455108642578125,74.25903119400596,119.219816257403,125.95768911464586,88.34120601745451,-11.65879398254549,2.1968908427919303,2.159488603045953,0.025055007505837112,-112186950.0,1.0
3562,2017-02-24,IBM,124.17984237452376,125.06186979961164,123.9593382678167,124.96539306640624,3451905.0,0.0,0.0,-0.2067413330078267,0.2067413330078267,0.0,70.47522083850541,119.219816257403,125.95768911464586,85.27285881963539,-14.727141180364614,2.1403000194801365,2.1556508863327895,0.014942763844027374,-115638855.0,-1.0
3563,2017-02-27,IBM,124.85518555842118,124.8965280291842,123.53903441882552,123.62171936035156,3861100.0,0.0,0.0,-1.3436737060546733,1.3436737060546733,0.0,50.99083829615571,120.25901214899596,125.95768911464586,59.00855991004755,-40.99144008995245,1.9643839503684575,2.117397499139923,0.00022296662401988243,-119499955.0,-1.0
3564,2017-02-28,IBM,123.6079174898823,124.46926830963228,123.58724075888992,123.91111755371094,3423976.0,0.0,0.0,0.289398193359375,0.0,0.289398193359375,54.14162339188444,121.19610430813856,125.95768911464586,57.01910930709402,-42.98089069290598,1.8272577241772154,2.0593695441473816,-0.0017209738330720148,-116075979.0,1.0
3565,2017-03-01,IBM,124.36590625631815,125.7923147354728,124.05582128198404,125.37886810302734,3143858.0,0.0,0.0,1.4677505493164062,0.0,1.4677505493164062,66.67810237493109,121.21679388146153,125.95768911464586,87.79089215962831,-12.20910784037168,1.8160847107343585,2.010712577464777,0.0014864771229574636,-112932121.0,1.0
3566,2017-03-02,IBM,125.33061062811475,125.33061062811475,124.33144075314726,124.4003448486328,3052437.0,0.0,0.0,-0.9785232543945455,0.9785232543945455,0.0,55.09255361167684,121.80252110598629,125.95768911464586,62.52030573089994,-37.47969426910006,1.708575968105393,1.9502852555929002,-0.004960732770226128,-115984558.0,-1.0
3567,2017-03-03,IBM,124.40036467387046,124.94474560887043,123.869775558425,124.0696029663086,1905812.0,0.0,0.0,-0.33074188232420454,0.33074188232420454,0.0,51.5961872172121,122.89816293053792,125.95768911464586,38.288282736571105,-61.71171726342889,1.5784905527194582,1.8759263150182122,-0.003431538100117093,-117890370.0,-1.0
3568,2017-03-06,IBM,123.8421971501125,124.71733975191802,123.73883549609572,124.35901641845705,3351802.0,0.0,0.0,0.2894134521484517,0.0,0.2894134521484517,54.51098224603614,122.89816293053792,125.95768911464586,47.74770340280853,-52.25229659719146,1.4816703966457965,1.797075131343729,0.0011649762932517405,-114538568.0,1.0
3569,2017-03-07,IBM,124.52438182146324,124.92404756731368,124.17294344278184,124.29698181152344,3117603.0,0.0,0.0,-0.06203460693360796,0.06203460693360796,0.0,53.71104616305517,123.42874794044948,125.95768911464586,34.33191249890792,-65.66808750109207,1.3839803866714817,1.7144561824092797,-0.004250675110279323,-117656171.0,-1.0
3570,2017-03-08,IBM,124.55193609930976,124.68975527884982,123.55276629459712,123.6561279296875,3721040.0,0.0,0.0,-0.6408538818359375,0.6408538818359375,0.0,45.71456745016278,123.42874794044948,125.95768911464586,8.99111420850948,-91.00888579149053,1.240548526326691,1.619674651192762,-0.012111373485804044,-121377211.0,-1.0
3571,2017-03-09,IBM,123.44940007756408,123.51830416564732,121.1960879207554,122.0918960571289,5694529.0,0.0,0.0,-1.5642318725585938,1.5642318725585938,0.0,32.20922792553104,121.1960879207554,125.7923147354728,19.490076806154807,-80.5099231938452,0.9892538023045603,1.4935904814151217,-0.022994342183602523,-127071740.0,-1.0
3572,2017-03-10,IBM,122.80167200301828,123.68369942481918,122.2572911496587,122.53982543945312,3242914.0,0.0,0.0,0.44792938232421875,0.0,0.44792938232421875,38.237996271855344,121.1960879207554,125.7923147354728,29.23566596833283,-70.76433403166718,0.8168291823323983,1.358238221598577,-0.008751649196406697,-123828826.0,1.0
3573,2017-03-13,IBM,122.55361453973816,122.69831865052512,121.56822540802426,121.59578704833984,3642381.0,0.0,0.0,-0.9440383911132812,0.9440383911132812,0.0,31.43887194450633,121.1960879207554,125.7923147354728,8.696244630586548,-91.30375536941345,0.5971221675949465,1.2060150107978511,-0.018685413795638484,-127471207.0,-1.0
3574,2017-03-14,IBM,121.40286500775632,121.8438733235763,120.73444562539416,121.08588409423828,3292285.0,0.0,0.0,-0.5099029541015625,0.5099029541015625,0.0,28.30249432053934,120.73444562539416,125.7923147354728,6.948350405980717,-93.05164959401928,0.3775062119310775,1.0403132510244963,-0.034240092239957054,-130763492.0,-1.0
3575,2017-03-15,IBM,121.07893495626482,121.47171571987224,120.41741177508544,121.1478500366211,3991013.0,0.0,0.0,0.0619659423828125,0.0,0.0619659423828125,29.29160706186927,120.41741177508544,125.7923147354728,13.58979440036275,-86.41020559963725,0.20608351600921537,0.8734673040214401,-0.026145384210705003,-126772479.0,1.0
3576,2017-03-16,IBM,122.973939908625,123.34604399753772,121.84383582539124,122.1332550048828,4510143.0,0.0,0.0,0.9854049682617045,0.0,0.9854049682617045,43.57477766928717,120.41741177508544,125.7923147354728,31.923241078824983,-68.07675892117501,0.14803725865530737,0.7283812949482136,-0.015606948963571843,-122262336.0,1.0
3577,2017-03-17,IBM,121.47861679521743,121.82314821862684,121.03759765625,121.03759765625,6193366.0,0.0,0.0,-1.0956573486327983,1.0956573486327983,0.0,34.60633264819988,120.41741177508544,125.7923147354728,11.538550290773317,-88.46144970922668,0.013469521992448108,0.5853989403570605,-0.026708306786785485,-128455702.0,-1.0
3578,2017-03-20,IBM,121.03761734288818,121.40283654859589,120.68618995468756,121.07207489013672,2590001.0,0.0,0.0,0.03447723388671875,0.0,0.03447723388671875,35.0913864011396,120.41741177508544,125.7923147354728,12.179998780928646,-87.82000121907136,-0.08936421909425007,0.4504463084667984,-0.02594517480944769,-125865701.0,1.0
3579,2017-03-21,IBM,121.28568717395189,121.43728718904164,119.79037475001176,119.81794738769533,4108374.0,0.0,0.0,-1.254127502441392,1.254127502441392,0.0,26.760289786066025,119.79037475001176,125.33061062811475,0.4976798513676848,-99.50232014863232,-0.2689579284698027,0.30656546107947813,-0.031039145461312034,-129974075.0,-1.0
3580,2017-03-22,IBM,119.92820225092068,120.63106809793882,119.07373637831384,120.43812561035156,3609223.0,0.0,0.0,0.6201782226562358,0.0,0.6201782226562358,35.49799849128655,119.07373637831384,124.94474560887043,23.239432582332594,-76.76056741766742,-0.357127296361611,0.17382690959126026,-0.013545292522965768,-126364852.0,1.0
3581,2017-03-23,IBM,120.19693288016438,121.05139866838071,119.59742874648244,120.4656753540039,3912040.0,0.0,0.0,0.02754974365234375,0.0,0.02754974365234375,35.89003403878711,119.07373637831384,124.92404756731368,23.792563006003633,-76.20743699399637,-0.4199383338617224,0.055073860900663706,-0.01692633458560011,-122452812.0,1.0
3582,2017-03-24,IBM,120.6724208013649,120.93427841276754,119.48030822387132,119.78350830078124,3369898.0,0.0,0.0,-0.6821670532226705,0.6821670532226705,0.0,30.57985917016785,119.07373637831384,124.92404756731368,12.132208006335782,-87.86779199366421,-0.5187815232273039,-0.059697215924929846,-0.01490412448942946,-125822710.0,-1.0
3583,2017-03-27,IBM,118.9979452489814,120.01090713226026,118.5844986016098,119.7421646118164,3408914.0,0.0,0.0,-0.04134368896482954,0.04134368896482954,0.0,30.266699084742484,118.5844986016098,124.68975527884982,18.96179098451849,-81.03820901548151,-0.5936088003601725,-0.16647953281197841,-0.01109724302277948,-129231624.0,-1.0
3584,2017-03-28,IBM,119.85929432320712,120.58972178825164,119.2115517795214,120.2520751953125,3685999.0,0.0,0.0,0.5099105834960938,0.0,0.5099105834960938,39.13661909459818,118.5844986016098,123.68369942481918,32.70270482607015,-67.29729517392985,-0.604792759540274,-0.25414217815763757,-0.007394063048067445,-125545625.0,1.0
3585,2017-03-29,IBM,120.10734154190855,120.23826481297672,119.52851418698202,119.8592758178711,3227538.0,0.0,0.0,-0.39279937744140625,0.39279937744140625,0.0,35.16132401262112,118.5844986016098,123.68369942481918,24.999549154037176,-75.00045084596283,-0.6379973188129782,-0.33091320628870574,-0.01861883716208823,-128773163.0,-1.0
3586,2017-03-30,IBM,119.80411529541016,120.3071535396954,119.6869728681094,119.80411529541016,3314042.0,0.0,0.0,-0.0551605224609375,0.0551605224609375,0.0,34.59199003885874,118.5844986016098,123.34604399753772,25.613883569048358,-74.38611643095165,-0.6611419317863323,-0.3969589513882311,-0.010190902535449853,-132087205.0,-1.0
3587,2017-03-31,IBM,119.88685090405372,120.55525915074,119.68701252181314,119.99710845947266,3047730.0,0.0,0.0,0.1929931640625,0.0,0.1929931640625,38.60522644976236,118.5844986016098,123.34604399753772,29.667045893774862,-70.33295410622515,-0.656345328500791,-0.44883622681074314,-0.008878731380787097,-129039475.0,1.0
3588,2017-04-03,IBM,119.77662014331018,120.50016282869628,119.4734310450379,120.24520111083984,4483679.0,0.0,0.0,0.2480926513671875,0.0,0.2480926513671875,43.72660421866465,118.5844986016098,123.34604399753772,34.87738478037576,-65.12261521962424,-0.6253167203646086,-0.48413232552151625,0.0035658574734389603,-124555796.0,1.0
3589,2017-04-04,IBM,119.56987192313407,120.56215694262218,119.39071026669262,120.25895690917967,3251909.0,0.0,0.0,0.01375579833982954,0.0,0.01375579833982954,44.02532593113802,118.5844986016098,123.34604399753772,35.16627834740115,-64.83372165259884,-0.5927831121810527,-0.5058624828534236,-0.0014876410626942782,-121303887.0,1.0
3590,2017-04-05,IBM,120.38296890571176,121.50617696686348,119.08059922737966,119.12883758544922,6525889.0,0.0,0.0,-1.1301193237304545,1.1301193237304545,0.0,29.287523631492533,118.5844986016098,121.82314821862684,16.80759107065082,-83.19240892934918,-0.6506904237629811,-0.5348280710353351,-0.01109725043773857,-127829776.0,-1.0
3591,2017-04-06,IBM,119.53542353801048,119.53542353801048,118.69474946905711,118.83255767822266,3593428.0,0.0,0.0,-0.2962799072265625,0.2962799072265625,0.0,26.59445710717992,118.5844986016098,121.50617696686348,8.490293783289967,-91.50970621671003,-0.7122789889832291,-0.5703182546249139,-0.007938911090921708,-131423204.0,-1.0
3592,2017-04-07,IBM,118.57755829530072,119.16328149195232,118.02629263911612,118.61891174316406,3753362.0,0.0,0.0,-0.21364593505859375,0.21364593505859375,0.0,24.70438320422133,118.02629263911612,121.50617696686348,17.02985065689131,-82.97014934310869,-0.7694579794712126,-0.6101461995941737,-0.00938059598549712,-135176566.0,-1.0
3593,2017-04-10,IBM,118.88770712209478,118.90837285697468,117.83340269882538,117.97122192382812,3964235.0,0.0,0.0,-0.6476898193359375,0.6476898193359375,0.0,19.785604143377654,117.83340269882538,121.50617696686348,3.7524556355695515,-96.24754436443045,-0.8571551458749695,-0.659547988850333,-0.01896726744864763,-139140801.0,-1.0
3594,2017-04-11,IBM,117.5921803051026,117.99185701638662,116.4414105292338,117.54395294189452,5116927.0,0.0,0.0,-0.42726898193360796,0.42726898193360796,0.0,17.181665420675515,116.4414105292338,121.50617696686348,21.76886982327865,-78.23113017672135,-0.9501797375321672,-0.7176743385866998,-0.019317010387204125,-144257728.0,-1.0
3595,2017-04-12,IBM,117.8609371448134,117.97119469902336,117.15807135759177,117.59909057617188,3427637.0,0.0,0.0,0.05513763427735796,0.0,0.05513763427735796,18.773413434050397,116.4414105292338,121.50617696686348,22.857520898433904,-77.1424791015661,-1.0078355494860887,-0.7757065807665777,-0.0184052502186689,-140830091.0,1.0
3596,2017-04-13,IBM,117.08915412950984,118.08143901134348,116.8204116821289,116.8204116821289,3352953.0,0.0,0.0,-0.7786788940429688,0.7786788940429688,0.0,14.296052232577978,116.4414105292338,121.50617696686348,7.483092410327882,-92.51690758967212,-1.103639011373815,-0.8412930668880253,-0.026473111045143494,-144183044.0,-1.0
3597,2017-04-17,IBM,116.97203210920748,118.0401061771873,116.88245127776683,117.9022979736328,3891329.0,0.0,0.0,1.081886291503892,0.0,1.081886291503892,38.00082983368498,116.4414105292338,121.50617696686348,28.844122673555944,-71.15587732644406,-1.0798173014351278,-0.8889979137974459,-0.019484379547483166,-140291715.0,1.0
3598,2017-04-18,IBM,117.68865707967656,118.30882687620309,117.02713383144152,117.1787338256836,6637393.0,0.0,0.0,-0.7235641479492045,0.7235641479492045,0.0,31.31657948761554,116.4414105292338,121.50617696686348,14.557893350652854,-85.44210664934715,-1.106568175234841,-0.9325119660849249,-0.025613252955638766,-146929108.0,-1.0
3599,2017-04-19,IBM,111.4662452661933,112.07264534037232,109.97782871731786,111.41800689697266,20171378.0,0.0,0.0,-5.7607269287109375,5.7607269287109375,0.0,11.971741214626789,109.97782871731786,121.50617696686348,12.492493707514063,-87.50750629248594,-1.5744615416105887,-1.0609018811900577,-0.06472681883549569,-167100486.0,-1.0
3600,2017-04-20,IBM,111.16305180381732,111.90727112053192,110.59800515455656,111.8383560180664,6785193.0,0.0,0.0,0.42034912109375,0.0,0.42034912109375,16.323597492410585,109.97782871731786,121.50617696686348,16.13871528232048,-83.86128471767952,-1.8895699581241416,-1.2266354965768747,-0.058857621150386286,-160315293.0,1.0
3601,2017-04-21,IBM,111.66608214007428,111.7074245995914,110.51531219482422,110.51531219482422,5865759.0,0.0,0.0,-1.3230438232421875,1.3230438232421875,0.0,13.838936500317999,109.97782871731786,121.50617696686348,4.6622765540374855,-95.33772344596252,-2.2204581682652105,-1.425400030914542,-0.0683162526889971,-166181052.0,-1.0
3602,2017-04-24,IBM,111.14238307987436,111.3353255647145,110.54287889551873,110.77027893066406,5565348.0,0.0,0.0,0.25496673583984375,0.0,0.25496673583984375,16.659680209335903,109.97782871731786,121.50617696686348,6.873926742952391,-93.12607325704761,-2.4340574745678367,-1.6271315196452014,-0.061039827135244695,-160615704.0,1.0
3603,2017-04-25,IBM,111.4800059592016,111.65916758545156,110.51529374026252,110.52217864990234,5083978.0,0.0,0.0,-0.24810028076171875,0.24810028076171875,0.0,16.069025388811866,109.97782871731786,121.50617696686348,4.7218380361292125,-95.27816196387079,-2.5934602870928245,-1.8203972731347264,-0.05973743536992704,-165699682.0,-1.0
3604,2017-04-26,IBM,110.61866892275545,111.01143876808888,110.17764971274129,110.29479217529295,4526879.0,0.0,0.0,-0.2273864746093892,0.2273864746093892,0.0,15.488318932594652,109.97782871731786,119.53542353801048,3.316351696441997,-96.683648303558,-2.7069325195289196,-1.9977043224135653,-0.06211186128304069,-170226561.0,-1.0
3605,2017-04-27,IBM,110.45325700559935,110.58418025052752,109.99845710436712,110.4739227294922,4312240.0,0.0,0.0,0.17913055419924717,0.0,0.17913055419924717,18.176138052676805,109.97782871731786,119.16328149195232,5.40086617770545,-94.59913382229455,-2.7506974150395536,-2.1483029409387635,-0.05432688398587093,-165914321.0,1.0
3606,2017-04-28,IBM,110.5979893145206,110.66000849855271,110.046723565054,110.45328521728516,4345189.0,0.0,0.0,-0.02063751220704546,0.02063751220704546,0.0,18.09961571426699,109.97782871731786,118.90837285697468,5.32393650971378,-94.67606349028623,-2.755285469019782,-2.2696994465549674,-0.06317953834974033,-170259510.0,-1.0
3607,2017-05-01,IBM,110.287898178549,110.54285981061588,109.3576324670006,109.45410919189452,5162324.0,0.0,0.0,-0.9991760253906392,0.9991760253906392,0.0,14.653302765233079,109.3576324670006,118.30882687620309,1.077808396103352,-98.92219160389665,-2.8071871832061674,-2.3771969938852076,-0.06592172812927233,-175421834.0,-1.0
3608,2017-05-02,IBM,109.86757045966996,109.90202800864544,109.31630466736276,109.63328552246094,3355777.0,0.0,0.0,0.17917633056642046,0.0,0.17917633056642046,17.888321697912474,109.31630466736276,118.30882687620309,3.524938251323569,-96.47506174867642,-2.801566913726319,-2.46207097785343,-0.016018248972646143,-172066057.0,1.0
3609,2017-05-03,IBM,109.38518720087666,109.87444470613104,109.23358721318584,109.30938720703124,4176992.0,0.0,0.0,-0.3238983154297017,0.3238983154297017,0.0,16.57766367685838,109.23358721318584,118.30882687620309,0.8352395822039622,-99.16476041779603,-2.7910749224732285,-2.52787176677739,-0.022612714466462958,-176243049.0,-1.0
3610,2017-05-04,IBM,109.48858123748909,109.6608580011341,109.12337297564048,109.59883880615234,4477508.0,0.0,0.0,0.28945159912110796,0.0,0.28945159912110796,22.43751602309382,109.12337297564048,118.30882687620309,5.176291075640183,-94.82370892435982,-2.727957423727105,-2.567888898167333,-0.008292727681538326,-171765541.0,1.0
3611,2017-05-05,IBM,105.78818279503494,107.34551425569111,105.4298595207784,106.84247589111328,13097280.0,0.0,0.0,-2.7563629150390625,2.7563629150390625,0.0,12.663584032947739,105.4298595207784,118.30882687620309,10.968397786487797,-89.0316022135122,-2.867299360396629,-2.6277709906131923,-0.03545899746275227,-184862821.0,-1.0
3612,2017-05-08,IBM,106.32062635328953,106.78682141208226,105.9031408930452,106.48065948486328,7836632.0,1.434034,0.0,-0.36181640625,0.36181640625,0.0,11.879788117717354,105.4298595207784,112.07264534037232,15.818663925387913,-84.18133607461209,-2.972657464435173,-2.6967482853775886,-0.03656749454642272,-192699453.0,-1.0
3613,2017-05-09,IBM,106.1814601128514,106.52936836260083,105.45781273028452,105.84051513671876,7168238.0,0.0,0.0,-0.640144348144517,0.640144348144517,0.0,10.547131428545612,105.4298595207784,111.90727112053192,6.339810426065824,-93.66018957393418,-3.0723921952069873,-2.7718770673434685,-0.040385198165067915,-199867691.0,-1.0
3614,2017-05-10,IBM,105.52042696083356,106.02141612183684,105.1586033066143,105.24209594726562,5229895.0,0.0,0.0,-0.5984191894531392,0.5984191894531392,0.0,9.408681676402338,105.1586033066143,111.7074245995914,1.274926233532524,-98.72507376646747,-3.1632560683868007,-2.850152867552135,-0.0473580248891613,-205097586.0,-1.0
3615,2017-05-11,IBM,105.10298475347672,105.17256198262236,104.226256137727,104.82465362548828,5886783.0,0.0,0.0,-0.41744232177734375,0.41744232177734375,0.0,8.656598846276694,104.226256137727,111.65916758545156,8.050647340141039,-91.94935265985896,-3.231697452605218,-2.926461784562752,-0.050959385958725956,-210984369.0,-1.0
3616,2017-05-12,IBM,104.58108928865748,105.24907493640828,104.37234655016036,104.62979888916016,3886204.0,0.0,0.0,-0.194854736328125,0.194854736328125,0.0,8.299292787185422,104.226256137727,111.65916758545156,5.429134387934723,-94.57086561206528,-3.264035126299902,-2.993976452910182,-0.044076100370762705,-214870573.0,-1.0
3617,2017-05-15,IBM,104.80375097063724,105.64569633239682,104.68546415525049,105.42302703857422,4440793.0,0.0,0.0,0.7932281494140625,0.0,0.7932281494140625,23.190878460979818,104.226256137727,111.01143876808888,17.6380057257705,-82.3619942742295,-3.1888964698248117,-3.0329604562931083,-0.03840310416515014,-210429780.0,1.0
3618,2017-05-16,IBM,105.52740424970548,107.1486589124402,105.52740424970548,106.93295288085938,5767330.0,0.0,0.0,1.5099258422851562,0.0,1.5099258422851562,43.38432181683645,104.226256137727,110.66000849855271,42.07026617333142,-57.92973382666858,-2.9732365268221486,-3.0210156703989166,-0.021740441392017917,-204662450.0,1.0
3619,2017-05-17,IBM,106.66852488405924,107.25300669627394,104.99160881654568,105.01943969726562,5430309.0,0.0,0.0,-1.91351318359375,1.91351318359375,0.0,31.33723571947249,104.226256137727,110.66000849855271,12.32847512702248,-87.67152487297753,-2.923034072997666,-3.001419350918667,-0.04178328127167763,-210092759.0,-1.0
3620,2017-05-18,IBM,104.9707466090595,105.29778727319022,104.44888974925571,104.9150848388672,3424813.0,0.0,0.0,-0.10435485839842329,0.10435485839842329,0.0,30.79907012799002,104.226256137727,110.54285981061588,10.905048611751235,-89.09495138824877,-2.858715340637076,-2.972878548862349,-0.0180395581080538,-213517572.0,-1.0
3621,2017-05-19,IBM,105.07511971418444,106.0840615026144,104.9916270575188,105.75006866455078,5902578.0,0.0,0.0,0.8349838256835795,0.0,0.8349838256835795,40.2694058305296,104.226256137727,109.90202800864544,26.8476704398832,-73.1523295601168,-2.709136822458021,-2.9201302035814836,-0.006861253713556836,-207614994.0,1.0
3622,2017-05-22,IBM,105.8335504230763,106.34845506992738,105.48564217806069,106.20928955078124,3453997.0,0.0,0.0,0.45922088623045454,0.0,0.45922088623045454,45.04221571170433,104.226256137727,109.87444470613104,35.109192779917386,-64.8908072200826,-2.5244393164650774,-2.8409920261582027,0.00348424621314547,-204160997.0,1.0
3623,2017-05-23,IBM,106.1605936875324,106.93293957123343,105.70830296268365,105.78484344482422,2682467.0,0.0,0.0,-0.42444610595701704,0.42444610595701704,0.0,41.505262663385814,104.226256137727,109.6608580011341,28.67896023058611,-71.32103976941389,-2.384823702655595,-2.7497583614576815,0.005157133109839895,-206843464.0,-1.0
3624,2017-05-24,IBM,105.91008510538217,106.29278748565848,105.22818409402556,106.11882781982422,3904090.0,0.0,0.0,0.333984375,0.0,0.333984375,45.39812133216324,104.226256137727,107.34551425569111,60.67377595966522,-39.326224040334786,-2.221618143942692,-2.644130317954684,0.012346086054905392,-202939374.0,1.0
3625,2017-05-25,IBM,106.63375503814564,106.96774789431798,106.4250122794632,106.59896087646484,2701504.0,0.0,0.0,0.480133056640625,0.0,0.480133056640625,50.826457140596276,104.226256137727,107.25300669627394,78.3911555591456,-21.608844440854387,-2.030131742781009,-2.5213306029199494,0.018820278813598046,-200237870.0,1.0
3626,2017-05-26,IBM,106.35541194473116,106.45978330138654,105.8057131747405,106.10491180419922,2555692.0,0.0,0.0,-0.494049072265625,0.494049072265625,0.0,45.46047219213082,104.226256137727,107.25300669627394,62.06840075298792,-37.93159924701208,-1.8963827021338346,-2.3963410227627264,0.0064680818297457865,-202793562.0,-1.0
3627,2017-05-30,IBM,105.72918417835048,106.23017340810908,105.4786951163211,105.57610321044922,3834636.0,0.0,0.0,-0.52880859375,0.52880859375,0.0,40.216715486047235,104.226256137727,107.25300669627394,44.59723543820006,-55.402764561799934,-1.8121665301637506,-2.2795061242429315,-0.012688788945367513,-206628198.0,-1.0
3628,2017-05-31,IBM,105.78485780669509,106.32064125441984,105.52045327300324,106.20235443115234,3706396.0,0.0,0.0,0.626251220703125,0.0,0.626251220703125,48.35665120414675,104.226256137727,107.25300669627394,65.28778157305473,-34.71221842694528,-1.6755763660836323,-2.158720172611072,0.011263769234502119,-202921802.0,1.0
3629,2017-06-01,IBM,106.32062712770508,106.36933672660824,105.5065238108791,106.23017120361328,3052333.0,0.0,0.0,0.0278167724609375,0.0,0.0278167724609375,48.714534611727544,104.37234655016036,107.25300669627394,64.49301754528001,-35.50698245471998,-1.5472473911113553,-2.0364256163111287,0.012534769111284927,-199869469.0,1.0
3630,2017-06-02,IBM,106.50849559419784,106.59895152206916,105.624815031801,105.79877471923828,3750642.0,0.0,0.0,-0.431396484375,0.431396484375,0.0,43.34007728078202,104.44888974925571,107.25300669627394,48.13939630506405,-51.86060369493596,-1.4634856927657012,-1.9218376316020431,0.0004605770502335016,-203620111.0,-1.0
3631,2017-06-05,IBM,105.63872209124746,106.41107905386691,105.54131400280043,106.04925537109376,4157955.0,0.0,0.0,0.25048065185548296,0.0,0.25048065185548296,47.23975197176295,104.44888974925571,107.25300669627394,57.07199992282088,-42.92800007717912,-1.361201168355251,-1.809710338952685,-0.0015067813782047024,-199462156.0,1.0
3632,2017-06-06,IBM,105.7639862434964,106.3832623295596,105.7639862434964,106.0214385986328,3971871.0,0.0,0.0,-0.02781677246096592,0.02781677246096592,0.0,46.82677379799133,104.44888974925571,107.25300669627394,56.08000233546829,-43.91999766453171,-1.2677704582202267,-1.7013223628061935,0.002236569494305618,-203434027.0,-1.0
3633,2017-06-07,IBM,106.49459971989248,107.29478777545526,104.92901777378768,105.05426788330078,5089522.0,0.0,0.0,-0.967170715332017,0.967170715332017,0.0,34.6679418269627,104.44888974925571,107.29478777545526,21.271954527952587,-78.72804547204741,-1.2572754522637837,-1.6125129806977117,-0.010031772479912049,-208523549.0,-1.0
3634,2017-06-08,IBM,105.06817095787312,106.33455403166651,105.012509184955,105.83356475830078,3879614.0,0.0,0.0,0.779296875,0.0,0.779296875,47.37246456738152,104.92901777378768,107.29478777545526,38.23478122875454,-61.76521877124546,-1.1725588113889245,-1.5245221468359544,-0.0071801461465563765,-204643935.0,1.0
3635,2017-06-09,IBM,105.76399399392952,107.33653912610217,105.68049022375756,107.22520446777344,4562129.0,0.0,0.0,1.3916397094726562,0.0,1.3916397094726562,62.42730474646399,104.92901777378768,107.33653912610217,95.37554845685182,-4.624451543148189,-0.981808887310919,-1.4159794949309474,0.010558348756196656,-200081806.0,1.0
3636,2017-06-12,IBM,107.28780846546928,109.38221010384297,107.16952166116404,107.9766616821289,6769189.0,0.0,0.0,0.7514572143554688,0.0,0.7514572143554688,68.11098429473051,104.92901777378768,109.38221010384297,68.4372845918243,-31.562715408175702,-0.7612269309785944,-1.285028982140477,0.0227377067222736,-193312617.0,1.0
3637,2017-06-13,IBM,108.15757040875386,108.18540129064732,107.25997449204368,107.32955169677734,3685581.0,0.0,0.0,-0.6471099853515625,0.6471099853515625,0.0,59.211140037824734,104.92901777378768,109.38221010384297,53.90591164877586,-46.094088351224144,-0.6313526685128892,-1.1542937194149594,0.010613674919567995,-196998198.0,-1.0
3638,2017-06-14,IBM,107.13472635892296,107.80966412701504,106.41803116153504,107.0233917236328,3189359.0,0.0,0.0,-0.30615997314454546,0.30615997314454546,0.0,55.26872016990887,104.92901777378768,109.38221010384297,47.03084427119541,-52.96915572880459,-0.5468274445696579,-1.032800464445899,0.007466998415159631,-200187557.0,-1.0
3639,2017-06-15,IBM,106.66159006589918,107.63573778516928,106.66159006589918,107.30870819091795,4868398.0,0.0,0.0,0.28531646728515625,0.0,0.28531646728515625,58.257309382712144,104.92901777378768,109.38221010384297,53.43785403269866,-46.56214596730134,-0.45161203873874456,-0.9165627793044681,0.014271748190719968,-195319159.0,1.0
3640,2017-06-16,IBM,107.31561887907476,108.14363745697688,106.4388907128967,108.11580657958984,7052132.0,0.0,0.0,0.8070983886718892,0.0,0.8070983886718892,65.73055873275274,104.92901777378768,109.38221010384297,71.56189469504906,-28.438105304950945,-0.3074825810713122,-0.7947467396578369,0.01948671116326728,-188267027.0,1.0
3641,2017-06-19,IBM,108.2062768093047,108.44981367722887,107.531339073374,107.74008178710938,4842457.0,0.0,0.0,-0.37572479248046875,0.37572479248046875,0.0,59.96407038268244,104.92901777378768,109.38221010384297,63.12469359002056,-36.87530640997944,-0.22102891442351336,-0.6800031746109723,0.01621033643000147,-193109484.0,-1.0
3642,2017-06-20,IBM,107.4895868697107,108.12278942050442,107.32955374292284,107.8166275024414,4687858.0,0.0,0.0,0.07654571533203125,0.0,0.07654571533203125,60.773031743481724,104.92901777378768,109.38221010384297,64.8435889275386,-35.156411072461395,-0.1446695012750041,-0.5729364399437786,0.02629459682884261,-188421626.0,1.0
3643,2017-06-21,IBM,108.40110093740456,108.40110093740456,106.73114817027408,107.00946807861328,4141846.0,0.0,0.0,-0.807159423828125,0.807159423828125,0.0,48.78050942761896,104.92901777378768,109.38221010384297,46.71817767187644,-53.28182232812355,-0.14758388089393293,-0.48786592813380947,0.011110873218699524,-192563472.0,-1.0
3644,2017-06-22,IBM,107.53828553590112,107.8444474228438,106.93988830751144,107.43391418457033,2485819.0,0.0,0.0,0.42444610595704546,0.0,0.42444610595704546,54.25737245186106,104.92901777378768,109.38221010384297,56.24945488827675,-43.75054511172325,-0.1143264105373305,-0.41315802461451373,0.0019464613551716248,-190077653.0,1.0
3645,2017-06-23,IBM,107.39218798669704,107.62876161327934,107.01644883036624,107.2321548461914,3433181.0,0.0,0.0,-0.20175933837892046,0.20175933837892046,0.0,51.25155455530955,104.92901777378768,109.38221010384297,51.71878737101693,-48.28121262898307,-0.10306188485182588,-0.35113879666197617,-0.006895071808473263,-193510834.0,-1.0
3646,2017-06-26,IBM,107.64962044470693,108.37326773888682,107.59395868536946,108.01144409179688,2252561.0,0.0,0.0,0.7792892456054688,0.0,0.7792892456054688,60.90421073850697,104.92901777378768,109.38221010384297,69.21835145554847,-30.781648544451517,-0.030896383484673606,-0.2870903140265157,0.00635325857827107,-191258273.0,1.0
3647,2017-06-27,IBM,107.85143467027284,108.08800830511836,107.50352638659967,107.67747497558594,2496279.0,0.0,0.0,-0.3339691162109375,0.3339691162109375,0.0,55.47269704114681,105.012509184955,109.38221010384297,60.9873728225121,-39.0126271774879,-0.0006457762026172986,-0.229801406461736,0.006111591507417247,-193754552.0,-1.0
3648,2017-06-28,IBM,107.9557946159982,108.23411455005184,107.69834229122138,108.07408142089844,2323166.0,0.0,0.0,0.3966064453125,0.0,0.3966064453125,60.32145658788539,105.68049022375756,109.38221010384297,64.66159716779146,-35.33840283220854,0.054700322304853444,-0.1729010607084181,0.007132442863991617,-191431386.0,1.0
3649,2017-06-29,IBM,108.09493420649828,108.36630193547856,106.89117650189814,107.2460479736328,3412261.0,0.0,0.0,-0.8280334472656392,0.8280334472656392,0.0,47.78598176093007,106.41803116153504,109.38221010384297,27.934103446975428,-72.06589655302457,0.03138533448974101,-0.13204378166878628,-0.008044694235498029,-194843647.0,-1.0
3650,2017-06-30,IBM,107.3504252804473,107.50350622924424,106.5571896558992,107.03730010986328,3735789.0,0.0,0.0,-0.20874786376951704,0.20874786376951704,0.0,45.06201594731121,106.41803116153504,108.44981367722887,30.479096239134947,-69.52090376086505,-0.003891312725812668,-0.10641328788019155,-0.0065229361774086225,-198579436.0,-1.0
3651,2017-07-03,IBM,106.8633717460977,108.56811900686314,106.82162541736442,108.2550048828125,2952335.0,0.0,0.0,1.2177047729492188,0.0,1.2177047729492188,60.29574093198178,106.41803116153504,108.56811900686314,85.4371473830242,-14.56285261697581,0.06565347618929707,-0.07199993506629382,0.004065953374039255,-195627101.0,1.0
3652,2017-07-05,IBM,108.3871897307829,108.47069348053516,106.89814873290668,106.9259796142578,3728362.0,0.0,0.0,-1.3290252685547017,1.3290252685547017,0.0,44.69004020754192,106.4388907128967,108.56811900686314,22.876311701350147,-77.12368829864985,0.013372836666121657,-0.05492538071981072,-0.0007801969849448032,-199355463.0,-1.0
3653,2017-07-06,IBM,106.71030488059256,107.03733449080327,105.9240322764798,106.01448822021484,2884345.0,0.0,0.0,-0.9114913940429545,0.9114913940429545,0.0,37.09283428408642,105.9240322764798,108.56811900686314,3.4210656819840026,-96.578934318016,-0.1004517395411142,-0.06403065248407143,-0.01321208461154011,-202239808.0,-1.0
3654,2017-07-07,IBM,106.19536400972346,106.8007245205918,105.86137123781693,106.41802215576172,2573265.0,0.0,0.0,0.403533935546875,0.0,0.403533935546875,42.11918925082812,105.86137123781693,108.56811900686314,20.565304396314023,-79.43469560368598,-0.15629504809813,-0.08248353160688315,-0.007592244057740283,-199666543.0,1.0
3655,2017-07-10,IBM,106.39716138765156,107.07906241531762,106.20233410913256,106.75202178955078,3353685.0,0.0,0.0,0.3339996337890625,0.0,0.3339996337890625,46.22279033500142,105.86137123781693,108.56811900686314,32.90482260368488,-67.09517739631512,-0.17162194244197337,-0.10031121377390122,-0.011660082066634825,-196312858.0,1.0
3656,2017-07-11,IBM,106.6407430027208,106.91211087297656,105.7988084984459,106.59203338623048,3606085.0,0.0,0.0,-0.1599884033202983,0.1599884033202983,0.0,44.47984326476798,105.7988084984459,108.56811900686314,28.643407280389923,-71.35659271961008,-0.19443699505667666,-0.11913637003045631,-0.010080488882206473,-199918943.0,-1.0
3657,2017-07-12,IBM,106.79381425498134,107.3226345003712,106.49460441288096,106.94688415527344,3240403.0,0.0,0.0,0.35485076904295454,0.0,0.35485076904295454,49.36608245888931,105.7988084984459,108.56811900686314,41.45709386282243,-58.54290613717757,-0.18178904621227332,-0.13166690526681973,-0.010429857471886295,-196678540.0,1.0
3658,2017-07-13,IBM,106.94686897060954,107.28782510074316,106.5920085026717,106.8981704711914,2590001.0,0.0,0.0,-0.04871368408203125,0.04871368408203125,0.0,48.68735818615417,105.7988084984459,108.56811900686314,39.69803925576529,-60.30196074423472,-0.17369400643231359,-0.14007232549991852,-0.003243732603805838,-199268541.0,-1.0
3659,2017-07-14,IBM,107.16255708625518,107.58700580645436,106.73810836605598,107.32260131835938,3406194.0,0.0,0.0,0.42443084716796875,0.0,0.42443084716796875,54.91849131345713,105.7988084984459,108.56811900686314,55.02426742259316,-44.97573257740684,-0.13151458852371434,-0.1383607781046777,0.0026654372653576175,-195862347.0,1.0
3660,2017-07-17,IBM,106.87031693306312,107.07209637397403,105.93096361419208,106.46673583984376,4981680.0,0.0,0.0,-0.8558654785156108,0.8558654785156108,0.0,42.81990058533768,105.7988084984459,108.56811900686314,24.11890394261396,-75.88109605738603,-0.16524346350797714,-0.14373731518533758,-0.016519042652157867,-200844027.0,-1.0
3661,2017-07-18,IBM,106.01446516945032,107.35738858873252,105.76397611268722,107.15560913085938,7914873.0,0.0,0.0,0.6888732910156108,0.0,0.6888732910156108,52.531735383244246,105.76397611268722,108.56811900686314,49.62774975064627,-50.37225024935373,-0.134833248745025,-0.14195650189727507,0.0021475558833314867,-192929154.0,1.0
3662,2017-07-19,IBM,104.3862646234744,104.54629776550256,102.08312006231051,102.6536865234375,14951106.0,0.0,0.0,-4.501922607421875,4.501922607421875,0.0,23.032699963226904,102.08312006231051,108.56811900686314,8.798250639751608,-91.2017493602484,-0.46859875003569584,-0.20728495152495927,-0.03170134340314168,-207880260.0,-1.0
3663,2017-07-20,IBM,102.65366945191188,103.55822859490262,102.3057612349386,102.74412536621094,7543961.0,0.0,0.0,0.0904388427734375,0.0,0.0904388427734375,24.02166450553389,102.08312006231051,108.56811900686314,10.19283595189581,-89.8071640481042,-0.7175412863807935,-0.30933621849612614,-0.03452325757542629,-200336299.0,1.0
3664,2017-07-21,IBM,102.69542897232724,102.89025626619018,101.94395068089882,102.34056854248048,6808937.0,0.0,0.0,-0.40355682373045454,0.40355682373045454,0.0,22.5310881080796,101.94395068089882,108.56811900686314,5.987436340152516,-94.01256365984749,-0.9365971935426955,-0.43478841350544006,-0.04132430630463346,-207145236.0,-1.0
3665,2017-07-24,IBM,102.2848761010393,102.31270697973837,101.449894211578,101.58210754394533,4055970.0,0.0,0.0,-0.7584609985351562,0.7584609985351562,0.0,19.858814475217827,101.449894211578,108.47069348053516,1.8831663932042146,-98.11683360679578,-1.1580527310194668,-0.5794412770082454,-0.047000940718824324,-211201206.0,-1.0
3666,2017-07-25,IBM,101.98568743809768,102.62584213337028,101.6099483276373,101.72128295898438,4402509.0,0.0,0.0,0.1391754150390483,0.0,0.1391754150390483,21.821996259160713,101.449894211578,107.58700580645436,4.422092432422915,-95.57790756757709,-1.307258287318433,-0.7250046790702831,-0.048861649757856895,-206798697.0,1.0
3667,2017-07-26,IBM,101.77695982658936,101.90916208576624,100.52449223727562,101.14376831054688,4113290.0,0.0,0.0,-0.5775146484375,0.5775146484375,0.0,19.53122076745828,100.52449223727562,107.58700580645436,8.768493925078067,-91.23150607492192,-1.4553292417035948,-0.8710695915969455,-0.05383068891899623,-210911987.0,-1.0
3668,2017-07-27,IBM,100.89324597455264,101.17157698026064,99.94694054540196,100.94195556640624,6726617.0,0.0,0.0,-0.2018127441406392,0.2018127441406392,0.0,18.738086383342107,99.94694054540196,107.58700580645436,13.02364557115337,-86.97635442884663,-1.5708533224017316,-1.0110263377579027,-0.059452954676580516,-217638604.0,-1.0
3669,2017-07-28,IBM,100.76104698326871,100.92109120368964,100.08610926542404,100.39922332763672,3195321.0,0.0,0.0,-0.542732238769517,0.542732238769517,0.0,16.641148250932844,99.94694054540196,107.58700580645436,5.919881136885211,-94.08011886311479,-1.6867570591194578,-1.1461724820302137,-0.05698974862284034,-220833925.0,-1.0
3670,2017-07-31,IBM,100.4618675626118,100.84457000448374,100.3157498601246,100.66365814208984,4556062.0,0.0,0.0,0.264434814453125,0.0,0.264434814453125,21.575104009923905,99.94694054540196,107.58700580645436,9.38104024243845,-90.61895975756154,-1.7372480122710527,-1.2643875880783817,-0.06058433190222923,-216277863.0,1.0
3671,2017-08-01,IBM,100.89325880060946,101.35945385459203,100.69843151412567,101.10201263427734,3367597.0,0.0,0.0,0.4383544921875,0.0,0.4383544921875,29.550894654621302,99.94694054540196,107.58700580645436,15.118615475233227,-84.88138452476677,-1.7220403036851621,-1.355918131199738,-0.015115617779648649,-212910266.0,1.0
3672,2017-08-02,IBM,100.97677709130843,101.0950639138052,100.35053771155364,100.51058197021484,3703781.0,0.0,0.0,-0.5914306640625,0.5914306640625,0.0,25.511774723165672,99.94694054540196,107.58700580645436,7.377442542097418,-92.62255745790259,-1.737680695474026,-1.4322706440545956,-0.021738891523335968,-216614047.0,-1.0
3673,2017-08-03,IBM,100.49664108718228,101.12983247554548,100.49664108718228,100.85150146484376,3175028.0,0.0,0.0,0.34091949462892046,0.0,0.34091949462892046,31.71918847512876,99.94694054540196,107.35738858873252,12.20656179157636,-87.79343820842364,-1.702936077555023,-1.4864037307546814,-0.014550115353508364,-213439019.0,1.0
3674,2017-08-04,IBM,100.89328112148432,101.16464894901851,100.47579557318618,101.0046157836914,2666672.0,0.0,0.0,0.15311431884764204,0.0,0.15311431884764204,34.54583954460145,99.94694054540196,107.35738858873252,14.272756952143551,-85.72724304785645,-1.6440935842055069,-1.5179417014448466,-0.005684975181324048,-210772347.0,1.0
3675,2017-08-07,IBM,100.8932821767714,100.95590723081156,99.32770024857628,99.82868957519533,4830742.0,0.0,0.0,-1.1759262084960795,1.1759262084960795,0.0,25.274097294530463,99.32770024857628,104.54629776550256,9.600075978155301,-90.3999240218447,-1.6730618857153416,-1.548965738298946,-0.01860567748198938,-215603089.0,-1.0
3676,2017-08-08,IBM,99.84977483729472,100.38418229471787,99.84977483729472,99.9271240234375,3450440.0,1.434034,0.0,0.09843444824217329,0.0,0.09843444824217329,27.16224980140794,99.32770024857628,103.55822859490262,14.169005045947594,-85.83099495405241,-1.6688392954633855,-1.572940449731834,-0.012028860575708955,-212152649.0,1.0
3677,2017-08-09,IBM,99.67397159028846,99.87085735592922,99.28020005900692,99.6880340576172,3060387.0,0.0,0.0,-0.2390899658202983,0.2390899658202983,0.0,25.365948628769672,99.28020005900692,102.89025626619018,11.297164786486734,-88.70283521351327,-1.6655855904543415,-1.5914694778763356,-0.012422203451013192,-215213036.0,-1.0
3678,2017-08-10,IBM,99.59662301395196,100.14509291222248,99.3083255974025,99.7372589111328,4733568.0,0.0,0.0,0.04922485351559658,0.0,0.04922485351559658,26.520335995892907,99.28020005900692,102.62584213337028,13.661319470728351,-86.33868052927166,-1.64012859006192,-1.6012013003134526,-0.006593322085208797,-210479468.0,1.0
3679,1.0,1.0,1.0,1.0,1.0,1.0,1.0,1.0,1.0,1.0,1.0,1.0,1.0,1.0,1.0,1.0,1.0,1.0,1.0,1.0,1.0,1.0
3680,2017-08-14,IBM,99.84978022958629,100.3841877158696,99.80758159992828,100.07479095458984,2352036.0,0.0,0.0,0.33753204345704546,0.0,0.33753204345704546,35.61204578914159,99.28020005900692,101.90916208576624,30.22451018672211,-69.77548981327789,-1.5260461937117213,-1.5862169065639542,-0.010160249563016421,-208127432.0,1.0
3681,2017-08-15,IBM,100.23649318332107,100.7919998637582,98.85125612747947,99.8989715576172,4896849.0,0.0,0.0,-0.17581939697264204,0.17581939697264204,0.0,33.14701413475002,98.85125612747947,101.35945385459203,41.77164418946586,-58.22835581053414,-1.4635703045023547,-1.5616875861516344,-0.00608503503421054,-213024281.0,-1.0
3682,2017-08-16,IBM,99.7020829190064,100.4896370971337,99.57552073031924,100.20133972167967,3439039.0,0.0,0.0,0.3023681640624716,0.0,0.3023681640624716,41.22062355546322,98.85125612747947,101.35945385459203,53.82684066755845,-46.17315933244155,-1.3738225570826046,-1.5241145803378287,-0.006446723486717043,-209585242.0,1.0
3683,2017-08-17,IBM,100.21542815471332,100.47560066676336,98.93565368652344,98.93565368652344,4625517.0,0.0,0.0,-1.2656860351562358,1.2656860351562358,0.0,26.034785533446723,98.85125612747947,101.35945385459203,3.364868651767843,-96.63513134823216,-1.3888176802040135,-1.4970552003110658,-0.02048383711095736,-214210759.0,-1.0
3684,2017-08-18,IBM,99.05517235252616,99.25205808436482,98.14808163884396,98.2324676513672,4343724.0,0.0,0.0,-0.7031860351562358,0.7031860351562358,0.0,21.06092314916137,98.14808163884396,101.35945385459203,2.6277244384635243,-97.37227556153648,-1.4408336264203996,-1.4858108855329326,-0.01598961110899666,-218554483.0,-1.0
3685,2017-08-21,IBM,98.1551463145212,98.73876683154607,97.8316870836998,98.6754913330078,3337472.0,0.0,0.0,0.4430236816405966,0.0,0.4430236816405966,30.687189634468808,97.8316870836998,101.16464894901851,25.316948810253077,-74.68305118974693,-1.42982618373631,-1.4746139451736082,-0.012525454951912152,-215217011.0,1.0
3686,2017-08-22,IBM,98.8934377923867,99.25205870754796,98.71061452431458,99.1536102294922,2661442.0,0.0,0.0,0.4781188964844034,0.0,0.4781188964844034,39.82493913848854,97.8316870836998,101.16464894901851,39.66211433583236,-60.33788566416764,-1.3667672647202664,-1.45304460908294,-0.005360962658929713,-212555569.0,1.0
3687,2017-08-23,IBM,98.9356239757228,100.58807021215404,98.9215615108923,99.94818878173828,4234522.0,0.0,0.0,0.7945785522460795,0.0,0.7945785522460795,51.96748837647644,97.8316870836998,101.16464894901851,63.5021276439384,-36.4978723560616,-1.2384012497596046,-1.4101159372182732,0.0021148552998977443,-208321047.0,1.0
3688,2017-08-24,IBM,100.20135667311013,101.03108716479797,100.0255589911932,100.5107421875,3757441.0,0.0,0.0,0.5625534057617188,0.0,0.5625534057617188,58.764787727119405,97.8316870836998,101.03108716479797,83.7361704035663,-16.263829596433702,-1.078840695701075,-1.3438608889148338,0.007755208883937659,-204563606.0,1.0
3689,2017-08-25,IBM,100.76384916618645,101.38966801568723,100.72868739911416,101.07323455810548,3005053.0,0.0,0.0,0.562492370605483,0.0,0.562492370605483,64.55227733166437,97.8316870836998,101.38966801568723,91.10637567680844,-8.893624323191565,-0.8966631984764319,-1.2544213508271536,0.009976974160942342,-201558553.0,1.0
3690,2017-08-28,IBM,101.33343097684148,101.64986450947126,100.1239916006998,100.20836639404295,5319956.0,0.0,0.0,-0.8648681640625284,0.8648681640625284,0.0,51.68307768306435,97.8316870836998,101.64986450947126,62.24643449781405,-37.75356550218596,-0.8127054892543981,-1.1660781785126024,0.003097077293206185,-206878509.0,-1.0
3691,2017-08-29,IBM,99.92008919745945,100.8553050726125,99.77945329044464,100.65138244628906,3147937.0,0.0,0.0,0.44301605224610796,0.0,0.44301605224610796,56.7761608401468,97.8316870836998,101.64986450947126,73.84924921396355,-26.150750786036458,-0.7023247443656118,-1.0733274916832043,0.004491384305433721,-203730572.0,1.0
3692,2017-08-30,IBM,100.73575024738184,100.7498127132342,100.1380561680262,100.2435302734375,2861856.0,0.0,0.0,-0.4078521728515625,0.4078521728515625,0.0,51.05894526799028,97.8316870836998,101.64986450947126,63.16739430332756,-36.832605696672445,-0.6403756190606629,-0.986737117158696,0.013219466776436928,-206592428.0,-1.0
3693,2017-08-31,IBM,100.56697187737764,101.01699315216392,100.29273700657602,100.5739974975586,3824594.0,0.0,0.0,0.33046722412109375,0.0,0.33046722412109375,55.27000067644621,97.8316870836998,101.64986450947126,71.82249822517645,-28.17750177482356,-0.5581801939595579,-0.9010257325188685,0.023836618403007215,-202767834.0,1.0
3694,2017-09-01,IBM,100.53886322789924,101.60767807666342,100.53886322789924,101.3123550415039,3505878.0,0.0,0.0,0.7383575439453125,0.0,0.7383575439453125,63.390728408477734,97.8316870836998,101.64986450947126,91.16045614618974,-8.839543853810254,-0.42852072413299425,-0.8065247308416937,0.026722579972743965,-199261956.0,1.0
3695,2017-09-05,IBM,100.90452151107316,101.5092412744656,100.34197792656846,100.58106231689452,3239985.0,0.0,0.0,-0.7312927246093892,0.7312927246093892,0.0,52.49852790981878,97.8316870836998,101.64986450947126,72.00752942064258,-27.992470579357416,-0.3803889839342247,-0.7212975814602001,0.014396370279392334,-202501941.0,-1.0
3696,2017-09-06,IBM,101.171734527286,101.58660543164936,100.90453638599176,101.12954711914062,3423872.0,0.0,0.0,0.548484802246108,0.0,0.548484802246108,58.647628012517146,97.8316870836998,101.64986450947126,86.37262410021442,-13.627375899785577,-0.29459024047754667,-0.6359561132636694,0.011819707308374783,-199078069.0,1.0
3697,2017-09-07,IBM,101.32638597954708,101.7060949230562,100.13803491746384,100.48258209228516,4380857.0,0.0,0.0,-0.6469650268554688,0.6469650268554688,0.0,49.862593518873275,97.8316870836998,101.7060949230562,68.4206495159712,-31.579350484028783,-0.27562159472103076,-0.5638892095551417,-0.00028017000573243855,-203458926.0,-1.0
3698,2017-09-08,IBM,100.65842645793676,100.65842645793676,99.5966370685771,100.16620635986328,3521045.0,0.0,0.0,-0.316375732421875,0.316375732421875,0.0,45.97661596658461,97.8316870836998,101.7060949230562,60.25486662630954,-39.745133373690464,-0.28285708345573823,-0.5076827843352609,-0.008973970232651118,-206979971.0,-1.0
3699,2017-09-11,IBM,100.93264563484642,102.05067350362334,100.5599621965618,101.86082458496094,4825616.0,0.0,0.0,1.6946182250976562,0.0,1.6946182250976562,63.53864917586527,98.71061452431458,102.05067350362334,94.31600100960804,-5.683998990391959,-0.15011925087875966,-0.43617007764396065,0.016490221828585838,-202154355.0,1.0
3700,2017-09-12,IBM,102.0365941778064,102.92258557994889,101.61469778556204,102.49365234375,5479053.0,0.0,0.0,0.6328277587890625,0.0,0.6328277587890625,68.01840808192227,98.9215615108923,102.92258557994889,89.27941375018953,-10.720586249810456,0.006070373646224425,-0.34772198738592364,0.018303473362067724,-196675302.0,1.0
3701,2017-09-13,IBM,102.2053705237358,102.86635136541234,102.19834490174938,102.65540313720705,4289646.0,0.0,0.0,0.16175079345704546,0.0,0.16175079345704546,69.13674439802301,99.5966370685771,102.92258557994889,91.96672943587927,-8.033270564120722,0.14127518124332994,-0.24992255366007293,0.02406013492532244,-192385656.0,1.0
3702,2017-09-14,IBM,102.5639959270126,102.92964253119652,102.31788590911364,102.33897399902344,3929717.0,0.0,0.0,-0.31642913818360796,0.31642913818360796,0.0,64.07890119135419,99.5966370685771,102.92964253119652,82.27820089713043,-17.72179910286958,0.22035268977636235,-0.15586750497278587,0.017549033998650376,-196315373.0,-1.0
3703,2017-09-15,IBM,101.83271026611328,102.07882030225304,101.3123652565103,101.83271026611328,7737471.0,0.0,0.0,-0.5062637329101562,0.5062637329101562,0.0,56.454538401124665,99.5966370685771,102.92964253119652,67.0887948614055,-32.9112051385945,0.23941115007832536,-0.07681177396256361,0.005136147752129672,-204052844.0,-1.0
3704,2017-09-18,IBM,101.8256684605458,102.2967891953656,101.4459593790946,101.6428451538086,3158397.0,0.0,0.0,-0.1898651123046875,0.1898651123046875,0.0,53.690148107580086,99.5966370685771,102.92964253119652,61.39228117626225,-38.60771882373774,0.23646872511592676,-0.01415567414686552,0.0105564885919458,-207211241.0,-1.0
3705,2017-09-19,IBM,101.81159862853106,101.94519767616676,101.41079026258564,101.53032684326172,3623762.0,0.0,0.0,-0.112518310546875,0.112518310546875,0.0,51.9506753357007,99.5966370685771,102.92964253119652,58.01639980406533,-41.98360019593466,0.22249278648220638,0.03317401797894888,0.003963032917065679,-210835003.0,-1.0
3706,2017-09-20,IBM,101.91007259542988,102.5780792236328,101.55145154071649,102.5780792236328,5698085.0,0.0,0.0,1.0477523803710795,0.0,1.0477523803710795,64.35779470750117,99.5966370685771,102.92964253119652,89.45206326522408,-10.547936734775924,0.2925888331493951,0.08505698101303814,0.02085433204157816,-205136918.0,1.0
3707,2017-09-21,IBM,102.41632480122244,102.58508563836232,102.02959010101608,102.14208984375,2673158.0,0.0,0.0,-0.4359893798827983,0.4359893798827983,0.0,57.25888400727382,99.5966370685771,102.92964253119652,76.37109520883956,-23.628904791160448,0.3093932629618479,0.1299242374028001,0.019726048891060444,-207810076.0,-1.0
3708,2017-09-22,IBM,102.37411832586656,102.37411832586656,101.67095017262058,102.0506591796875,2920746.0,0.0,0.0,-0.0914306640625,0.0914306640625,0.0,55.77035321089661,99.5966370685771,102.92964253119652,73.62790546349049,-26.372094536509504,0.31173966339724757,0.1662873226016896,0.0018636663849920243,-210730822.0,-1.0
3709,2017-09-25,IBM,102.04367420837728,102.68355591150714,101.8960126532062,102.571044921875,5452903.0,0.0,0.0,0.5203857421875,0.0,0.5203857421875,62.22028401424882,99.5966370685771,102.92964253119652,89.24101345337438,-10.758986546625614,0.35153767549809345,0.2033373931809704,0.0007550963045539483,-205277919.0,1.0
3710,2017-09-26,IBM,102.91558107193916,103.6609367552294,102.62024680295896,103.05620574951172,4695076.0,0.0,0.0,0.48516082763671875,0.0,0.48516082763671875,67.34326345360104,99.5966370685771,103.6609367552294,85.12090514132858,-14.879094858671415,0.4174146150979965,0.24615283756437564,0.0039043498934874243,-200582843.0,1.0
3711,2017-09-27,IBM,103.14057812597768,103.29527647386838,101.98035173983472,102.42334747314452,3663824.0,0.0,0.0,-0.6328582763672017,0.6328582763672017,0.0,55.92852570626977,99.5966370685771,103.6609367552294,69.54975327854662,-30.45024672145338,0.4137863193467268,0.27967953392084594,0.0008244510456190124,-204246667.0,-1.0
3712,1.0,1.0,1.0,1.0,1.0,1.0,1.0,1.0,1.0,1.0,1.0,1.0,1.0,1.0,1.0,1.0,1.0,1.0,1.0,1.0,1.0,1.0
3713,2017-09-29,IBM,102.27568300516828,102.44444381406306,101.9029996121398,102.01551055908205,2776816.0,0.0,0.0,-0.4078369140624716,0.4078369140624716,0.0,48.8276275453722,101.3123652565103,103.6609367552294,29.9392759792595,-70.06072402074051,0.363143081592483,0.3166200178485605,0.0036664204421819058,-207023483.0,-1.0
3714,2017-10-02,IBM,102.2053952284916,103.27421031791818,102.10695793561972,103.12654876708984,3109967.0,0.0,0.0,1.1110382080077983,0.0,1.1110382080077983,63.42451778866186,101.3123652565103,103.6609367552294,77.24625422598331,-22.753745774016682,0.41387844019338615,0.33607170231752564,0.015721626960704116,-203913516.0,1.0
3715,2017-10-03,IBM,103.1476050148056,103.50622595714734,102.90150624708733,103.2108917236328,2408624.0,0.0,0.0,0.08434295654295454,0.0,0.08434295654295454,64.31610689402231,101.3123652565103,103.6609367552294,80.83749922699585,-19.162500773004155,0.4556400146596786,0.3599853647859563,0.006169081199311588,-201504892.0,1.0
3716,2017-10-04,IBM,103.36558551256736,103.3796479780154,102.7397665194991,102.99993896484376,2347642.0,0.0,0.0,-0.21095275878903408,0.21095275878903408,0.0,60.08890238683067,101.3123652565103,103.6609367552294,71.85532606752052,-28.14467393247948,0.46633857783204746,0.38125600739517457,0.008398585954194182,-203852534.0,-1.0
3717,2017-10-05,IBM,103.14058386791228,103.7453036042073,102.99994797808796,103.16870880126952,2810079.0,0.0,0.0,0.16876983642575283,0.0,0.16876983642575283,62.37188944157663,101.40375696899656,103.7453036042073,75.3754721658198,-24.624527834180196,0.4828693641026973,0.40157867873667924,0.010955829492618863,-201042455.0,1.0
3718,2017-10-06,IBM,103.11244991146528,103.2601114101884,102.8874392412593,102.99993896484376,2743867.0,0.0,0.0,-0.16876983642575283,0.16876983642575283,0.0,58.51010055444442,101.40375696899656,103.7453036042073,68.16784990932078,-31.832150090679225,0.476854929196989,0.41663392882874123,0.004181433886097485,-203786322.0,-1.0
3719,2017-10-09,IBM,103.01402764940616,103.92111862838236,102.90855352018194,103.6398468017578,2806000.0,0.0,0.0,0.6399078369140341,0.0,0.6399078369140341,67.35330004338446,101.40375696899656,103.92111862838236,88.82672159656283,-11.173278403437173,0.5177552999027739,0.4368582030435478,0.005663327579366495,-200980322.0,1.0
3720,2017-10-10,IBM,103.86483480601572,104.73676381014602,103.82264740816365,104.42034149169922,4218100.0,0.0,0.0,0.7804946899414205,0.0,0.7804946899414205,74.8864361988503,101.40375696899656,104.73676381014602,90.50640057079293,-9.493599429207066,0.6061610892556075,0.47071878028595976,0.01949744924201302,-196762222.0,1.0
3721,2017-10-11,IBM,104.35004462951912,104.39925765612256,103.5624903043556,103.80157470703124,3872501.0,0.0,0.0,-0.618766784667983,0.618766784667983,0.0,61.834564836040286,101.40375696899656,104.73676381014602,71.94157864997777,-28.05842135002223,0.6191567523447787,0.5004063746977236,0.013456182285470408,-200634723.0,-1.0
3722,2017-10-12,IBM,103.75937572743496,103.99142328378528,103.203880184336,103.38670349121094,3414458.0,0.0,0.0,-0.4148712158202983,0.4148712158202983,0.0,54.487696038554176,101.40375696899656,104.73676381014602,59.49422298606856,-40.505777013931436,0.5891874825361612,0.5181625962654112,0.013441024062069262,-204049181.0,-1.0
3723,2017-10-13,IBM,103.70312646108611,103.9632989549305,103.32341737713143,103.43592834472656,2621904.0,0.0,0.0,0.049224853515625,0.0,0.049224853515625,55.21616539512472,101.40375696899656,104.73676381014602,60.971113249475536,-39.02888675052446,0.562919667068698,0.5271140104260685,0.0029999993341718323,-201427277.0,1.0
3724,2017-10-16,IBM,103.52030583082372,103.83672820513073,103.02106014384516,103.2460708618164,3192497.0,0.0,0.0,-0.18985748291015625,0.18985748291015625,0.0,51.54455607868438,101.40375696899656,104.73676381014602,55.2748308246642,-44.72516917533581,0.5207791045521475,0.5258470292512843,0.00034084714894055956,-204619774.0,-1.0
3725,2017-10-17,IBM,103.10540859049398,103.44996703660368,102.78898629709582,103.04212188720705,6665530.0,0.0,0.0,-0.2039489746093608,0.2039489746093608,0.0,47.619742969841745,101.40375696899656,104.73676381014602,49.15576223796352,-50.844237762036485,0.4655587558361276,0.513789374568253,0.0004095431782507042,-211285304.0,-1.0
3726,2017-10-18,IBM,110.4816734891254,113.37168492076508,110.3621368871752,112.17630767822266,31892749.0,0.0,0.0,9.13418579101561,0.0,9.13418579101561,89.38572572851943,101.9029996121398,113.37168492076508,89.57703337065661,-10.422966629343385,1.1456424345489182,0.6401599865643861,0.08730940787777208,-179392555.0,1.0
3727,2017-10-19,IBM,112.36617165719814,113.181851110319,111.8669258669062,113.13966369628906,10370253.0,0.0,0.0,0.9633560180664062,0.0,0.9633560180664062,90.32456344740821,102.10695793561972,113.37168492076508,97.94028541675287,-2.059714583247135,1.7422646864397393,0.8605809265394568,0.09844398776688812,-169022302.0,1.0
3728,2017-10-20,IBM,113.25918060104476,114.25064638490956,112.34506400762616,113.96234893798828,8230765.0,0.0,0.0,0.8226852416992188,0.0,0.8226852416992188,91.1002279315701,102.7397665194991,114.25064638490956,97.49543518573593,-2.504564814264063,2.2554762171856026,1.1395599846686861,0.09959974329154853,-160791537.0,1.0
3729,2017-10-23,IBM,113.94828179317092,114.271741010578,112.18332417727022,112.19036102294922,6045252.0,0.0,0.0,-1.7719879150390625,1.7719879150390625,0.0,75.96491660696533,102.7397665194991,114.271741010578,81.95122622549219,-18.04877377450781,2.490506429337387,1.4097492736024264,0.07441097606319991,-166836789.0,-1.0
3730,2017-10-24,IBM,112.26064029519246,112.29580206715087,109.11045752812127,109.60970306396484,8571656.0,0.0,0.0,-2.580657958984375,2.580657958984375,0.0,59.38548013268024,102.78898629709582,114.271741010578,59.39965571902932,-40.60034428097069,2.440400616724361,1.6158795422268133,0.05595414494747719,-175408445.0,-1.0
3731,2017-10-25,IBM,109.70112617239,109.9542617770864,107.62678342442156,107.9361801147461,7239471.0,0.0,0.0,-1.67352294921875,1.67352294921875,0.0,51.04882919249042,102.78898629709582,114.271741010578,44.82542687781035,-55.17457312218965,2.2398326864861673,1.7406701710786843,0.04400446546708903,-182647916.0,-1.0
3732,2017-10-26,IBM,108.50573053896716,109.07529963900296,107.96429759132133,108.00648498535156,4498323.0,0.0,0.0,0.07030487060546875,0.0,0.07030487060546875,51.37967894619974,102.78898629709582,114.271741010578,45.437691725050556,-54.562308274949444,2.0627757771286497,1.8050912922886773,0.04418732169534412,-178149593.0,1.0
3733,2017-10-27,IBM,108.66749808216386,108.73078480357636,107.52133391990566,108.0627670288086,5120379.0,0.0,0.0,0.05628204345703125,0.0,0.05628204345703125,51.681337045923954,102.78898629709582,114.271741010578,45.927835813828736,-54.072164186171264,1.9050382957467633,1.8250806929802947,0.046652585679883174,-173029214.0,1.0
3734,2017-10-30,IBM,108.11899716348262,108.70261751183962,107.38066725583748,108.5408935546875,4404078.0,0.0,0.0,0.47812652587890625,0.0,0.47812652587890625,54.45142074581627,102.78898629709582,114.271741010578,50.09170187044254,-49.90829812955746,1.7978861081729747,1.819641776018831,0.05336430934040326,-168625136.0,1.0
3735,2017-10-31,IBM,108.51980496025918,108.94171261615632,107.53537620924124,108.3299560546875,4527402.0,0.0,0.0,-0.2109375,0.2109375,0.0,52.907399534614214,102.78898629709582,114.271741010578,48.25470800213033,-51.74529199786968,1.6766193104080855,1.791037282896682,-0.03428844916672069,-173152538.0,-1.0
3736,2017-11-01,IBM,108.3580773910908,108.92060969058068,108.16821726878226,108.30885314941406,3389249.0,0.0,0.0,-0.0211029052734375,0.0211029052734375,0.0,52.734784910416,102.78898629709582,114.271741010578,48.07092888466246,-51.92907111533754,1.560819515608543,1.7449937294390543,-0.04269776300416428,-176541787.0,-1.0
3737,2017-11-02,IBM,108.4143241050095,108.6323091525051,107.52130705155612,107.83070373535156,3553890.0,0.0,0.0,-0.4781494140625,0.4781494140625,0.0,48.590216693961395,102.78898629709582,114.271741010578,43.90686350145704,-56.09313649854296,1.4141630904630915,1.6788276016438617,-0.053804131450231885,-180095677.0,-1.0
3738,2017-11-03,IBM,107.87990000175442,107.9150617711907,106.52278813333037,106.58607482910156,4635663.0,0.0,0.0,-1.24462890625,1.24462890625,0.0,39.31084356042661,102.78898629709582,114.271741010578,33.06774921829073,-66.93225078170929,1.1838588777797554,1.5798338568710404,-0.04995336624954139,-184731340.0,-1.0
3739,2017-11-06,IBM,106.71970174033494,106.75486351896352,105.67198623376224,106.06575775146484,4705326.0,0.0,0.0,-0.5203170776367188,0.5203170776367188,0.0,35.99504158284614,105.67198623376224,114.271741010578,4.5788691412943505,-95.42113085870565,0.9484230596234369,1.45355169742152,-0.032332405010091714,-189436666.0,-1.0
3740,2017-11-07,IBM,106.43846279928988,106.5369000871902,105.8267060866964,106.42440032958984,3871351.0,0.0,0.0,0.358642578125,0.0,0.358642578125,40.01880997675109,105.67198623376224,114.271741010578,8.749250593238438,-91.25074940676157,0.7817662218913028,1.3191946023154766,-0.014006237607714911,-185565315.0,1.0
3741,2017-11-08,IBM,106.60015913247597,106.73375817145616,105.6719802580825,106.57907104492188,4847582.0,0.0,0.0,0.15467071533203125,0.0,0.15467071533203125,41.83830374411526,105.6719802580825,114.271741010578,10.547860724801609,-89.45213927519839,0.6546240132456944,1.1862804845015202,-0.013216002174529451,-180717733.0,1.0
3742,2017-11-09,IBM,106.47964339912068,107.80771133863708,106.42992714072238,106.74241638183594,4996219.0,1.434034,0.0,0.1633453369140625,0.0,0.1633453369140625,43.9115711620346,105.6719802580825,114.271741010578,12.447277948317538,-87.55272205168247,0.5605814662458783,1.0611406808503918,-0.012218367928896967,-175721514.0,1.0
3743,2017-11-10,IBM,106.99097267526622,107.16142029999594,105.91858201005346,105.93278503417967,4505436.0,0.0,0.0,-0.8096313476562642,0.8096313476562642,0.0,36.47543662340404,105.6719802580825,112.29580206715087,3.937376089135102,-96.0626239108649,0.4159270388262115,0.9320979524455557,-0.024028810111036636,-180226950.0,-1.0
3744,2017-11-13,IBM,105.73395409962556,105.81917226270944,105.0521634540854,105.39305877685548,5342445.0,0.0,0.0,-0.5397262573241903,0.5397262573241903,0.0,32.27179637825661,105.0521634540854,109.9542617770864,6.954069467978134,-93.04593053202187,0.2547988026416306,0.7966381224847707,-0.027110666197901923,-185569395.0,-1.0
3745,2017-11-14,IBM,105.073447934511,105.7978475623664,104.74676701888686,105.74103546142578,3930868.0,0.0,0.0,0.3479766845702983,0.0,0.3479766845702983,37.61985237854463,104.74676701888686,109.07529963900296,22.970103954357047,-77.02989604564296,0.15341386533859236,0.6679932710555351,-0.02370828988878615,-181638527.0,1.0
3746,2017-11-15,IBM,105.10897307006788,105.61320886106571,103.8377284886362,104.46980285644533,4992872.0,0.0,0.0,-1.2712326049804545,1.2712326049804545,0.0,28.225110955331957,103.8377284886362,108.94171261615632,12.38394070234367,-87.61605929765634,-0.02917595277861551,0.528559426288705,-0.031168310717463954,-186631399.0,-1.0
3747,2017-11-16,IBM,104.91721193226796,106.28078166594082,104.7538601434824,105.90437316894533,5697039.0,0.0,0.0,1.4345703125,0.0,1.4345703125,45.837282683998815,103.8377284886362,108.94171261615632,40.490813228944106,-59.50918677105589,-0.05745950668493549,0.41135563969397687,-0.006395785389876396,-180934360.0,1.0
3748,2017-11-17,IBM,106.0606092454213,106.63587137948228,105.69841513764494,105.79783630371094,5142659.0,0.0,0.0,-0.10653686523438921,0.10653686523438921,0.0,44.893334346587835,103.8377284886362,108.94171261615632,38.40348571042863,-61.59651428957136,-0.08746284436031715,0.3115919428831181,-0.0025259938120811842,-186077019.0,-1.0
3749,2017-11-20,IBM,106.98386585207936,107.91422627912976,106.4583312872276,106.89154052734376,5937619.0,0.0,0.0,1.0937042236328267,0.0,1.0937042236328267,55.69978506776902,103.8377284886362,108.92060969058068,60.08033470346141,-39.91966529653859,-0.022725944706664336,0.2447283653651616,0.004389408785083315,-180139400.0,1.0
3750,2017-11-21,IBM,107.4526113023599,108.26933628933264,107.38159617379463,107.91423797607422,3928985.0,0.0,0.0,1.0226974487304545,0.0,1.0226974487304545,63.43598980644318,103.8377284886362,108.6323091525051,85.02327467671702,-14.976725323282977,0.10983553605694851,0.217749799503519,0.012527477656373964,-176210415.0,1.0
3751,2017-11-22,IBM,107.94972107665932,108.22669700357744,107.47389151004715,107.78636932373048,3361426.0,0.0,0.0,-0.1278686523437358,0.1278686523437358,0.0,61.87709482541325,103.8377284886362,108.26933628933264,89.10176650726494,-10.898233492735066,0.20224221070124315,0.21464828174306383,0.009780113447686478,-179571841.0,-1.0
3752,2017-11-24,IBM,107.91424291807624,108.0917977504447,107.47392643037492,107.83612060546876,1247878.0,0.0,0.0,0.04975128173828125,0.0,0.04975128173828125,62.293091783231674,103.8377284886362,108.26933628933264,90.22441282381088,-9.775587176189124,0.27630461119423444,0.22697954763329795,0.017967389139018408,-178323963.0,1.0
3753,2017-11-27,IBM,107.9923742439847,108.29775633911248,107.6798849674737,107.93556213378906,3529204.0,0.0,0.0,0.09944152832029829,0.0,0.09944152832029829,63.218732146959496,103.8377284886362,108.29775633911248,91.879104403244,-8.120895596755997,0.33911459547849176,0.24940655720233673,0.024124011452373972,-174794759.0,1.0
3754,2017-11-28,IBM,108.19834353464276,108.6102540359306,107.73671676547058,108.28356170654295,4156490.0,0.0,0.0,0.34799957275389204,0.0,0.34799957275389204,66.5358436356862,103.8377284886362,108.6102540359306,93.15472853628104,-6.845271463718962,0.41222079300943903,0.2819694043637572,0.02404483967858151,-170638269.0,1.0
3755,2017-11-29,IBM,108.52502916817444,109.09319567933817,108.07050956150611,109.05057525634766,5333240.0,0.0,0.0,0.7670135498047017,0.0,0.7670135498047017,72.77906394655099,103.8377284886362,109.09319567933817,99.18902694196409,-0.8109730580359094,0.5259863216234066,0.33077278781568714,0.04384781319245801,-165305029.0,1.0
3756,2017-11-30,IBM,109.12157143653006,109.6613204040808,108.71675687706308,109.3488311767578,6799837.0,0.0,0.0,0.29825592041014204,0.0,0.29825592041014204,74.8816502314629,103.8377284886362,109.6613204040808,94.63408096136932,-5.365919038630684,0.6329172072468623,0.3912016717019222,0.03252422827070278,-158505192.0,1.0
3757,2017-12-01,IBM,109.65421970939374,110.09454752579522,108.59603191728272,109.90989685058594,5824023.0,0.0,0.0,0.5610656738281392,0.0,0.5610656738281392,78.48825779660137,103.8377284886362,110.09454752579522,97.04880908153729,-2.95119091846272,0.7542396106219229,0.46380925948592244,0.03886715164070664,-152681169.0,1.0
3758,2017-12-04,IBM,110.76215012636368,111.3587227076754,110.13007563882606,111.11724853515624,4878858.0,0.0,0.0,1.2073516845702983,0.0,1.2073516845702983,84.14188673276611,103.8377284886362,111.3587227076754,96.7893317627093,-3.2106682372907085,0.9370104073558849,0.558449489059915,0.03953267009685857,-147802311.0,1.0
3759,2017-12-05,IBM,111.11012631327476,111.31607586024263,109.85307348374948,110.3289031982422,5301128.0,0.0,0.0,-0.7883453369140341,0.7883453369140341,0.0,70.23483953902861,103.8377284886362,111.3587227076754,86.30740192797603,-13.692598072023978,1.00664077213888,0.648087745675708,0.022375779762289882,-153103439.0,-1.0
3760,2017-12-06,IBM,109.44117736816406,110.946789020061,109.43408152176283,109.44117736816406,3567592.0,0.0,0.0,-0.8877258300781392,0.8877258300781392,0.0,57.818354483647354,104.7538601434824,111.3587227076754,70.96767236449489,-29.032327635505105,0.9789070512972131,0.7142516068000091,0.015352665228600904,-156671031.0,-1.0
3761,2017-12-07,IBM,109.07896503226384,109.6897291413403,108.84459810603126,109.06475067138672,3944571.0,0.0,0.0,-0.37642669677734375,0.37642669677734375,0.0,53.21543713797218,105.69841513764494,111.3587227076754,59.47266101873089,-40.52733898126911,0.9159943762362133,0.75460016068725,0.011393492820583218,-160615602.0,-1.0
3762,2017-12-08,IBM,110.06612781069798,110.10164104293844,109.05054911852336,109.94539642333984,3682234.0,0.0,0.0,0.880645751953125,0.0,0.880645751953125,61.49101384195814,106.4583312872276,111.3587227076754,71.15891031809858,-28.841089681901416,0.9265160796777252,0.7889833444853451,0.018620686730287606,-156933368.0,1.0
3763,2017-12-11,IBM,110.40703815674814,110.71243159227048,109.77496374684551,110.3715362548828,4291424.0,0.0,0.0,0.42613983154295454,0.0,0.42613983154295454,64.95241969768679,107.38159617379463,111.3587227076754,75.17839967165109,-24.82160032834891,0.9581950523583771,0.8228256860599517,0.019282470168449306,-152641944.0,1.0
3764,2017-12-12,IBM,111.7137969325508,112.10439716301173,110.19397108443566,111.31607818603516,6612603.0,0.0,0.0,0.944541931152358,0.0,0.944541931152358,71.50332900169948,107.47389151004715,112.10439716301173,82.97553148494988,-17.024468515050113,1.0474432328427383,0.8677491954165091,0.02077479118621728,-146029341.0,1.0
3765,2017-12-13,IBM,111.21669349003822,111.30901885992436,109.2920637535486,109.30626678466795,5922034.0,0.0,0.0,-2.0098114013672017,2.0098114013672017,0.0,49.0115447810691,107.47392643037492,112.10439716301173,39.57136239687702,-60.42863760312298,0.9451035105166596,0.8832200584365392,-0.0003892532881402122,-151951375.0,-1.0
3766,2017-12-14,IBM,109.79624584130262,110.15843996002118,109.15706441356748,109.37013244628906,4850720.0,0.0,0.0,0.06386566162110796,0.0,0.06386566162110796,49.59291032264044,107.6798849674737,112.10439716301173,38.201894448837166,-61.79810555116284,0.8592471026638151,0.8784254672819944,-0.004910971802936426,-147100655.0,1.0
3767,2017-12-15,IBM,109.09316663970148,109.228101049336,107.97104828054808,108.30484771728516,11798775.0,0.0,0.0,-1.0652847290039062,1.0652847290039062,0.0,40.66846209446525,107.73671676547058,112.10439716301173,13.007612739577251,-86.99238726042276,0.697208718098878,0.8421821174453711,-0.025310209305455134,-158899430.0,-1.0
3768,2017-12-18,IBM,109.07894537430286,109.49795155861776,108.80906526494664,108.89429473876952,5327069.0,0.0,0.0,0.5894470214843608,0.0,0.5894470214843608,46.78269072623133,107.97104828054808,112.10439716301173,22.336523832731682,-77.66347616726831,0.6093315841211222,0.7956120107805214,-0.013003015691137043,-153572361.0,1.0
3769,2017-12-19,IBM,109.40565369218608,109.4908831873942,108.7238744066052,108.82329559326172,4305754.0,0.0,0.0,-0.07099914550779829,0.07099914550779829,0.0,46.12211661447334,107.97104828054808,112.10439716301173,20.61880903229413,-79.38119096770588,0.5278742785525026,0.7420644643349177,-0.0056457888133254475,-157878115.0,-1.0
3770,2017-12-20,IBM,109.12157533417268,109.29202297923554,108.50370403772186,108.62443542480467,3959842.0,0.0,0.0,-0.19886016845704546,0.19886016845704546,0.0,44.109278291740836,107.97104828054808,112.10439716301173,15.807694023330345,-84.19230597666966,0.44217530173661146,0.6820866318152565,-0.004037191153617781,-161837957.0,-1.0
3771,2017-12-21,IBM,108.78069199253876,108.98665289238386,107.58755834604474,107.59466552734376,4344979.0,0.0,0.0,-1.029769897460909,1.029769897460909,0.0,34.98627778493645,107.58755834604474,112.10439716301173,0.15734857025055818,-99.84265142974944,0.2878463075479374,0.6032385669617928,-0.021380894266320172,-166182936.0,-1.0
3772,2017-12-22,IBM,107.82191084543707,108.659946024629,107.59465110259744,108.30484771728516,3128168.0,0.0,0.0,0.710182189941392,0.0,0.710182189941392,44.174252388601836,107.58755834604474,112.10439716301173,15.880340218163145,-84.11965978183686,0.2203056884205239,0.526651991253539,-0.018724832576625605,-163054768.0,1.0
3773,2017-12-26,IBM,108.311936395479,109.27070289538798,108.3048405508182,108.5392074584961,2593034.0,0.0,0.0,0.2343597412109375,0.0,0.2343597412109375,47.02492581970467,107.58755834604474,112.10439716301173,21.06891901647209,-78.9310809835279,0.18357400676865154,0.4580363943565615,-0.024945818904060446,-160461734.0,1.0
3774,2017-12-27,IBM,108.6244578537564,108.78779835202772,108.38299502973312,108.7522964477539,2248168.0,0.0,0.0,0.2130889892578125,0.0,0.2130889892578125,49.7186066202334,107.58755834604474,112.10439716301173,25.786576606053735,-74.21342339394627,0.16970216408454064,0.4003695483021573,-0.005068056509562879,-158213566.0,1.0
3775,2017-12-28,IBM,108.8020022756854,109.45538694458176,108.8020022756854,109.39857482910156,2811230.0,0.0,0.0,0.6462783813476562,0.0,0.6462783813476562,57.314241589805924,107.58755834604474,112.10439716301173,40.094777707230655,-59.905222292769345,0.20845495406535974,0.36198662945479787,0.0002600562162295983,-155402336.0,1.0
3776,2017-12-29,IBM,109.49085156673908,109.88145169005354,108.95819854736328,108.95819854736328,3480147.0,0.0,0.0,-0.44037628173828125,0.44037628173828125,0.0,51.22966333117268,107.58755834604474,112.10439716301173,30.345120932141434,-69.65487906785856,0.2013115396488132,0.329851611493601,0.006032516954214362,-158882483.0,-1.0
3777,2018-01-02,IBM,109.72523853319476,109.94539109084585,109.04344798445636,109.54768371582033,4395815.0,0.0,0.0,0.5894851684570455,0.0,0.5894851684570455,58.100010927378364,107.58755834604474,112.10439716301173,43.39595564961492,-56.60404435038509,0.2404451567247463,0.3119703205398301,0.006000213129790266,-154486668.0,1.0
3778,2018-01-03,IBM,111.74216653292326,113.49634741297912,111.02486292224306,112.55889129638672,9875914.0,0.0,0.0,3.011207580566392,0.0,3.011207580566392,77.10767095121201,107.58755834604474,113.49634741297912,84.13454760403597,-15.865452395964033,0.5085755736046309,0.3512913711527903,0.03432716940577851,-144610754.0,1.0
3779,2018-01-04,IBM,113.3827696249589,115.27899302383396,113.1839158829454,114.83867645263672,7903785.0,0.0,0.0,2.27978515625,0.0,2.27978515625,83.60491898231419,107.58755834604474,115.27899302383396,94.27523486003517,-5.7247651399648305,0.8947167323583329,0.4599764433938989,0.0572085001273388,-136706969.0,1.0
3780,2018-01-05,IBM,115.36420208075369,115.69089436157827,114.4125312913573,115.3997039794922,5434807.0,0.0,0.0,0.561027526855483,0.0,0.561027526855483,84.82764881526913,107.58755834604474,115.69089436157827,96.40653699256849,-3.5934630074315055,1.2318071097936212,0.6143425766738435,0.07254112844623228,-131272162.0,1.0
3781,2018-01-08,IBM,115.52045977645668,116.4082000440316,114.83866908460055,116.09571075439452,5478425.0,0.0,0.0,0.6960067749023153,0.0,0.6960067749023153,86.29115636627604,107.58755834604474,116.4082000440316,96.45729528149404,-3.5427047185059664,1.5373934774654003,0.7989527568321549,0.07193457357925781,-125793737.0,1.0
3782,2018-01-09,IBM,116.401069056477,116.84849268960006,115.80450799071812,116.3513641357422,4541523.0,0.0,0.0,0.25565338134768467,0.0,0.25565338134768467,86.8295842544863,107.58755834604474,116.84849268960006,94.63198274152744,-5.368017258472567,1.7796868446380785,0.9950995743933397,0.07197543505404136,-121252214.0,1.0
3783,2018-01-10,IBM,115.6979829665095,116.70646579894694,115.40680393786296,116.59993743896484,4366109.0,0.0,0.0,0.24857330322264204,0.0,0.24857330322264204,87.38542477520343,107.58755834604474,116.84849268960006,97.31608883710324,-2.6839111628967562,1.969065708125754,1.1898928011398227,0.07216069221104715,-116886105.0,1.0
3784,2018-01-11,IBM,117.0402568221326,117.13967800416016,115.97496186053988,116.61414337158205,3969047.0,0.0,0.0,0.01420593261720171,0.0,0.01420593261720171,87.42043376337382,107.58755834604474,117.13967800416016,94.49824069015274,-5.501759309847255,2.0961332031111937,1.371140881534097,0.06595669599674747,-112917058.0,1.0
3785,2018-01-12,IBM,116.48629894924038,116.9976418653374,115.78320952411684,115.86132049560548,5263367.0,0.0,0.0,-0.7528228759765625,0.7528228759765625,0.0,74.73758154136141,107.59465110259744,117.13967800416016,86.60708323047908,-13.392916769520923,2.1117457039123337,1.5192618460097447,0.0633556909005013,-118180425.0,-1.0
3786,2018-01-16,IBM,117.25327173856566,117.3882061050978,116.0104337274727,116.36553192138672,8152733.0,0.0,0.0,0.5042114257812358,0.0,0.5042114257812358,77.28438935352243,108.3048405508182,117.3882061050978,88.74124158496247,-11.258758415037539,2.1401342361816944,1.6434363240441348,0.06223635200952948,-110027692.0,1.0
3787,2018-01-17,IBM,119.32001281537303,120.11542780330876,118.78737087438378,119.77454376220705,12248660.0,0.0,0.0,3.4090118408203267,0.0,3.4090118408203267,87.28467554174588,108.38299502973312,120.11542780330876,97.09451528356956,-2.9054847164304443,2.409930934108516,1.7967352460570112,0.06410557515905424,-97779032.0,1.0
3788,2018-01-18,IBM,120.73326638499208,121.5357883367475,119.41941284319036,120.1082992553711,14915228.0,0.0,0.0,0.3337554931640483,0.0,0.3337554931640483,87.88707538008583,108.8020022756854,121.5357883367475,88.78975133922312,-11.210248660776879,2.620470882832265,1.9614823734120619,0.045887178131208683,-82863804.0,1.0
3789,2018-01-19,IBM,116.79876532679216,117.46634139048471,114.55454041216086,115.314453125,22146435.0,0.0,0.0,-4.793846130371094,4.793846130371094,0.0,49.23190381698382,108.95819854736328,121.5357883367475,50.536348251725826,-49.46365174827417,2.3731458421408433,2.0438150671578184,-0.0007387441349706592,-105010239.0,-1.0
3790,2018-01-22,IBM,114.70370160711064,116.45788276232726,114.41961845559996,115.4778060913086,8870917.0,0.0,0.0,0.16335296630859375,0.0,0.16335296630859375,50.09491853638062,109.04344798445636,121.5357883367475,51.50642654138179,-48.49357345861821,2.165359270909903,2.068123907908235,-0.005322372885878002,-96139322.0,1.0
3791,2018-01-23,IBM,115.63406587133665,118.07714502236428,115.41391330199008,118.07003784179688,7809645.0,0.0,0.0,2.5922317504882812,0.0,2.5922317504882812,61.94109757868356,111.02486292224306,121.5357883367475,67.0271611844177,-32.97283881558231,2.1846747832789077,2.09143408298237,0.01477141002016591,-88329677.0,1.0
3792,2018-01-24,IBM,118.42512611128252,119.82420905966848,117.05444921232336,117.44506072998048,5904670.0,0.0,0.0,-0.624977111816392,0.624977111816392,0.0,58.10420798242912,113.1839158829454,121.5357883367475,51.020233733277884,-48.979766266722116,2.125055716719075,2.098158409729711,0.007248059557990905,-94234347.0,-1.0
3793,2018-01-25,IBM,117.8285796458544,118.44645097058672,117.3172366872604,117.5160903930664,3454415.0,0.0,0.0,0.07102966308592329,0.0,0.07102966308592329,58.44179114408841,114.4125312913573,121.5357883367475,43.56938240376386,-56.43061759623613,2.0597946466210004,2.0904856571079686,0.0077344565196553194,-90779932.0,1.0
3794,2018-01-26,IBM,117.97772824399937,118.89388588165464,117.74336128225336,118.84416961669922,3962143.0,0.0,0.0,1.3280792236328125,0.0,1.3280792236328125,64.59627292302727,114.41961845559996,121.5357883367475,62.17601933339123,-37.82398066660877,2.0911343771003885,2.0906154011064526,0.02574499503660399,-86817789.0,1.0
3795,2018-01-29,IBM,118.92228957460206,119.58987720943476,117.89960358105633,118.46066284179688,3678782.0,0.0,0.0,-0.38350677490234375,0.38350677490234375,0.0,61.558737589975486,114.41961845559996,121.5357883367475,56.78678915328626,-43.21321084671374,2.0612645727589864,2.0847452354369596,0.018004738051002667,-90496571.0,-1.0
3796,2018-01-30,IBM,118.04165116843396,118.43935862987765,115.87555900526011,116.20223999023438,5127806.0,0.0,0.0,-2.2584228515625,2.2584228515625,0.0,46.65247695807455,114.41961845559996,121.5357883367475,25.05029481318331,-74.94970518681669,1.8342130219650414,2.0346387927425758,-0.02982523380815294,-95624377.0,-1.0
3797,2018-01-31,IBM,116.29455036035732,117.1751946745194,115.59146087927805,116.25904846191406,4260149.0,0.0,0.0,0.0568084716796875,0.0,0.0568084716796875,47.02478931530656,114.41961845559996,121.5357883367475,25.848596043037126,-74.15140395696288,1.6399526477508886,1.9557015637442383,-0.03204816667391863,-91364228.0,1.0
3798,2018-02-01,IBM,115.89682507785278,116.56441255754105,114.98067900652512,115.33577728271484,4638173.0,0.0,0.0,-0.9232711791992188,0.9232711791992188,0.0,41.582652450991056,114.41961845559996,121.5357883367475,12.87432484631952,-87.12567515368048,1.3954141676441338,1.8436440845242175,0.00018492181280804765,-96002401.0,-1.0
3799,2018-02-02,IBM,114.83865933448072,115.05171607379216,112.82880066752767,112.94243621826172,5493487.0,0.0,0.0,-2.393341064453125,2.393341064453125,0.0,30.89003147920917,112.82880066752767,121.5357883367475,1.3051075188237575,-98.69489248117624,0.997000240280542,1.6743153156754824,-0.021955473167217576,-101495888.0,-1.0
3800,2018-02-05,IBM,112.1328058358435,112.56602649102146,106.52936604254656,108.32615661621094,9148944.0,0.0,0.0,-4.616279602050781,4.616279602050781,0.0,19.646667024196006,106.52936604254656,121.5357883367475,11.973477344821424,-88.02652265517857,0.3052405256266155,1.400500357665709,-0.08252628188907551,-110644832.0,-1.0
3801,2018-02-06,IBM,106.73530793924778,110.42832095212476,105.89727283161112,110.32179260253906,10321614.0,0.0,0.0,1.995635986328125,0.0,1.995635986328125,31.993738607826728,105.89727283161112,121.5357883367475,28.29245377845957,-71.70754622154043,-0.08101895020003269,1.1041964960925605,-0.06065191744264686,-100323218.0,1.0
3802,2018-02-07,IBM,109.49086293026372,110.32179084492294,108.85878868734406,109.26360321044922,6432063.0,0.0,0.0,-1.0581893920898438,1.0581893920898438,0.0,29.244373735849223,105.89727283161112,119.82420905966848,24.171363490961166,-75.82863650903884,-0.4671345713682342,0.7899302826004015,-0.07022431698514109,-106755281.0,-1.0
3803,2018-02-08,IBM,109.3568540094092,109.84453434003429,105.78525149038168,105.84980010986328,7090939.0,1.434034,0.0,-3.4138031005859375,3.4138031005859375,0.0,22.156802395114624,105.78525149038168,119.82420905966848,0.45978213954298547,-99.54021786045702,-1.0366495125425672,0.4246143235718078,-0.10933956246020216,-113846220.0,-1.0
3804,2018-02-09,IBM,106.57413957138176,107.9654889278588,103.5619550387282,107.22679138183594,8188402.0,0.0,0.0,1.3769912719726562,0.0,1.3769912719726562,30.04723196858461,103.5619550387282,119.82420905966848,22.535844898183665,-77.46415510181633,-1.3611915500284226,0.0674531488517616,-0.09483208341459026,-105657818.0,1.0
3805,2018-02-12,IBM,108.22367326984624,109.29945674399896,107.79336445891266,108.58226776123048,6151944.0,0.0,0.0,1.3554763793945455,0.0,1.3554763793945455,37.26940755506112,103.5619550387282,119.82420905966848,30.87095255084455,-69.12904744915545,-1.4918210528359737,-0.24440169148578555,-0.0655750889969442,-99505874.0,1.0
3806,2018-02-13,IBM,108.22367369974276,108.42449668891616,107.32002748255644,108.11609649658205,5115986.0,0.0,0.0,-0.4661712646484375,0.4661712646484375,0.0,35.80258047025197,103.5619550387282,119.58987720943476,28.41379817888824,-71.58620182111176,-1.614352746485224,-0.5183919024856734,-0.07004144686423797,-104621860.0,-1.0
3807,2018-02-14,IBM,107.7144785725091,111.1641607347769,107.57821563488628,110.99203491210938,5731034.0,0.0,0.0,2.8759384155273295,0.0,2.8759384155273295,49.85209240299218,103.5619550387282,119.58987720943476,46.35709978028695,-53.642900219713056,-1.4625365901685399,-0.7072208400222467,-0.0376617080401509,-98890826.0,1.0
3808,2018-02-15,IBM,111.52274384679576,112.49811577767944,110.23179458531864,111.88850402832033,5882286.0,0.0,0.0,0.8964691162109517,0.0,0.8964691162109517,53.51135995747535,103.5619550387282,119.58987720943476,51.95027091415597,-48.04972908584403,-1.2554120186538,-0.8168590757485574,-0.009331587180434697,-93008540.0,1.0
3809,2018-02-16,IBM,111.67333969837554,113.16508891176916,111.65899683646346,112.01041412353516,4479913.0,0.0,0.0,0.12191009521482954,0.0,0.12191009521482954,54.03761485468983,103.5619550387282,118.43935862987765,56.78718758314076,-43.21281241685924,-1.0691032211974516,-0.8673079048383364,0.03401078393630441,-88528627.0,1.0
3810,2018-02-20,IBM,111.7307443066454,111.85266439249136,110.35374902668649,111.27891540527344,4696122.0,0.0,0.0,-0.7314987182617188,0.7314987182617188,0.0,50.11027990020337,103.5619550387282,117.1751946745194,56.68717052667035,-43.31282947332965,-0.9693044517559883,-0.8877072142218668,0.008675736499157871,-93224749.0,-1.0
3811,2018-02-21,IBM,111.47256042693058,112.44793255315288,110.3752567689626,110.41829681396484,3900116.0,0.0,0.0,-0.8606185913085938,0.8606185913085938,0.0,45.61030766700438,103.5619550387282,116.56441255754105,52.73112229220067,-47.26887770779933,-0.9487216630186879,-0.8999101039812311,0.01056796197075438,-97124865.0,-1.0
3812,2018-02-22,IBM,110.80558462403005,111.19286492763491,109.57918364132306,109.85888671875,4209732.0,0.0,0.0,-0.5594100952148438,0.5594100952148438,0.0,42.73220804680852,103.5619550387282,115.05171607379216,54.80472275102234,-45.19527724897767,-0.966409210343997,-0.9132099252537843,0.037875240243492314,-101334597.0,-1.0
3813,2018-02-23,IBM,110.662144878178,111.7737800346874,110.4971847364827,111.53711700439452,3405881.0,0.0,0.0,1.678230285644517,0.0,1.678230285644517,52.99869574937915,103.5619550387282,113.16508891176916,83.04749336104877,-16.952506638951235,-0.8353778447458211,-0.8976435091521917,0.04019821508236188,-97928716.0,1.0
3814,2018-02-26,IBM,111.74504864702789,113.94682093011784,111.52989428185144,113.7316665649414,3776374.0,0.0,0.0,2.194549560546889,0.0,2.194549560546889,63.005408524515744,103.5619550387282,113.94682093011784,97.92819312809016,-2.0718068719098386,-0.5481341848774548,-0.8277416442972444,0.047423938640094754,-94152342.0,1.0
3815,2018-02-27,IBM,113.64563212220608,114.59231848172584,112.26145974676804,112.27580261230467,4432216.0,0.0,0.0,-1.455863952636733,1.455863952636733,0.0,54.17634688882017,103.5619550387282,114.59231848172584,78.99873488854303,-21.001265111456966,-0.4329764853632554,-0.7487886125104467,0.038474438594387594,-98584558.0,-1.0
3816,2018-02-28,IBM,112.9571413710848,113.41614745984522,111.73792898374444,111.75943756103516,3978461.0,0.0,0.0,-0.516365051269517,0.516365051269517,0.0,51.237937450553474,103.5619550387282,114.59231848172584,74.31742901917643,-25.682570980823577,-0.3790105256130687,-0.6748329951309712,0.006914033511805195,-102563019.0,-1.0
3817,2018-03-01,IBM,111.54427368943011,112.57702871682876,109.5791751429162,110.31070709228516,4225108.0,0.0,0.0,-1.44873046875,1.44873046875,0.0,43.58514779802841,103.5619550387282,114.59231848172584,61.18340604489545,-38.81659395510455,-0.44797853726905146,-0.6294621035585872,-0.014101510693500852,-106788127.0,-1.0
3818,2018-03-02,IBM,109.57913939842012,110.9920085289616,108.92649914792936,110.7983627319336,3411111.0,0.0,0.0,0.4876556396484375,0.0,0.4876556396484375,46.67832960383722,107.32002748255644,114.59231848172584,47.82997888525678,-52.17002111474323,-0.45800683113277785,-0.5951710490734254,-0.01082088126435099,-103377016.0,1.0
3819,2018-03-05,IBM,110.53303598839356,112.94996336959228,110.26767580505448,112.56268310546876,3839448.0,0.0,0.0,1.7643203735351705,0.0,1.7643203735351705,56.609840876902076,107.32002748255644,114.59231848172584,72.09083937250462,-27.90916062749537,-0.3199007998763932,-0.540116999234019,0.011536486454059025,-99537568.0,1.0
3820,2018-03-06,IBM,112.799350303921,113.23682484600909,111.27890362952849,111.68052673339844,3855242.0,0.0,0.0,-0.8821563720703267,0.8821563720703267,0.0,51.117046063857934,107.57821563488628,114.59231848172584,58.486611731970726,-41.513388268029274,-0.27842392415831796,-0.4877783842188788,0.011431347483653154,-103392810.0,-1.0
3821,2018-03-07,IBM,111.16414772934222,113.91097196810716,110.9705019089392,113.5452117919922,4819654.0,0.0,0.0,1.8646850585937642,0.0,1.8646850585937642,60.471520162361095,108.92649914792936,114.59231848172584,81.51888318274337,-18.48111681725663,-0.09400506900237815,-0.40902372117557867,0.03355509220368824,-98573156.0,1.0
3822,2018-03-08,IBM,114.03289388423576,114.44169410275548,111.21434383786288,112.03194427490234,6752558.0,0.0,0.0,-1.513267517089858,1.513267517089858,0.0,51.28214032247227,108.92649914792936,114.59231848172584,54.81016855671827,-45.18983144328173,-0.06916257622354749,-0.34105149218517244,0.004436435904007885,-105325714.0,-1.0
3823,2018-03-09,IBM,112.93564029052762,114.44889872480336,112.8137201883826,114.25526428222656,5253221.0,0.0,0.0,2.2233200073242188,0.0,2.2233200073242188,61.26167567397794,108.92649914792936,114.59231848172584,94.0510951789663,-5.948904821033693,0.1284479537598031,-0.24715160299617733,0.004603798863583641,-100072493.0,1.0
3824,2018-03-12,IBM,114.49192509208436,115.48164010586468,113.93968467288498,114.93657684326172,5296421.0,0.0,0.0,0.6813125610351562,0.0,0.6813125610351562,63.87796998250023,108.92649914792936,115.48164010586468,91.68494978062768,-8.315050219372322,0.3361569441853334,-0.13048989355987517,0.023698554533115868,-94776072.0,1.0
3825,2018-03-13,IBM,114.8146495922211,116.26337057998366,113.89664896757692,114.26242065429688,4378138.0,0.0,0.0,-0.6741561889648438,0.6741561889648438,0.0,59.304992551758716,108.92649914792936,116.26337057998366,72.72747731485701,-27.272522685142984,0.44128221854222716,-0.016135471139454665,0.022396167588931926,-99154210.0,-1.0
3826,2018-03-14,IBM,114.87199312107307,115.23776471884952,113.12922664457984,113.40176391601562,3798863.0,0.0,0.0,-0.86065673828125,0.86065673828125,0.0,53.64760836844064,108.92649914792936,116.26337057998366,60.996908689637564,-39.003091310362436,0.4499600900581697,0.07708364110007025,0.02802136714747472,-102953073.0,-1.0
3827,2018-03-15,IBM,113.82491190303364,115.64656992295846,113.68863753799128,114.47037506103516,4048648.0,0.0,0.0,1.0686111450195312,0.0,1.0686111450195312,59.22076358256234,108.92649914792936,116.26337057998366,75.5618517299482,-24.438148270051798,0.5368765754348033,0.16904222796701687,0.033141395220664505,-98904425.0,1.0
3828,2018-03-16,IBM,114.79313673271972,116.17014347900964,114.49192509208436,114.93657684326172,9688784.0,0.0,0.0,0.4662017822265625,0.0,0.4662017822265625,61.548048292777324,108.92649914792936,116.26337057998366,81.91608304698829,-18.0839169530117,0.6360451711019977,0.2624428165940131,0.021089526940013315,-89215641.0,1.0
3829,2018-03-19,IBM,114.54212493368571,114.67122218409136,112.20410024024726,112.8495635986328,5734172.0,0.0,0.0,-2.0870132446289205,2.0870132446289205,0.0,47.53523701492721,108.92649914792936,116.26337057998366,53.47053559591943,-46.52946440408057,0.5400075992343432,0.3179557731220791,0.010467687603453513,-94949813.0,-1.0
3830,2018-03-20,IBM,112.9714665905201,113.26552393789,111.37213985690528,112.0247802734375,4536188.0,0.0,0.0,-0.8247833251952983,0.8247833251952983,0.0,43.06437086734658,108.92649914792936,116.26337057998366,42.22891397513055,-57.77108602486945,0.3928158734052687,0.33292779317871707,-0.013390538399276952,-99486001.0,-1.0
3831,2018-03-21,IBM,112.29014443449016,113.45916236919626,111.82397269183008,112.37621307373048,3642381.0,0.0,0.0,0.35143280029298296,0.0,0.35143280029298296,45.58076555538623,108.92649914792936,116.26337057998366,47.01886843388795,-52.98113156611204,0.3010527118998283,0.3265527769229393,0.003072952103583715,-95843620.0,1.0
3832,2018-03-22,IBM,111.16416700071971,111.34345854241062,109.01259981950888,109.0771484375,4964630.0,0.0,0.0,-3.299064636230483,3.299064636230483,0.0,30.82425523117483,109.01259981950888,116.26337057998366,0.8902311233308806,-99.10976887666912,-0.03744555042510456,0.25375311145333057,-0.04532058874710476,-100808250.0,-1.0
3833,2018-03-23,IBM,109.1918850774451,109.4285595141858,106.53111770838784,106.78213500976562,4645181.0,0.0,0.0,-2.295013427734375,2.295013427734375,0.0,24.466355832688507,106.53111770838784,116.26337057998366,2.5792311881907155,-97.42076881180928,-0.4853020060211719,0.10594208795843002,-0.07094731770736706,-105453431.0,-1.0
3834,2018-03-26,IBM,108.44603027673996,110.20314026277,107.77904688456266,109.9951629638672,4292679.0,0.0,0.0,3.2130279541015767,0.0,3.2130279541015767,43.343881106781005,106.53111770838784,116.26337057998366,35.59345714895461,-64.40654285104539,-0.5743462639983505,-0.030115582432926134,-0.037346116649675576,-101160752.0,1.0
3835,2018-03-27,IBM,110.41110757589146,111.07092512976044,108.41014634095744,108.9480438232422,4062350.0,0.0,0.0,-1.047119140625,1.047119140625,0.0,39.62037002600734,106.53111770838784,116.26337057998366,24.83418943940833,-75.16581056059167,-0.721095898828068,-0.16831164571195456,-0.03927381672891628,-105223102.0,-1.0
3836,2018-03-28,IBM,109.0628121606101,110.3465731013844,108.93371491682898,109.3855438232422,3833381.0,0.0,0.0,0.4375,0.0,0.4375,42.02153199221235,106.53111770838784,116.26337057998366,29.329551466805608,-70.67044853319439,-0.792952781970115,-0.2932398729635867,-0.044420499496762744,-101389721.0,1.0
3837,2018-03-29,IBM,109.77995257269112,110.3680556799357,108.35275200601028,110.03814697265624,3577320.0,0.0,0.0,0.6526031494140341,0.0,0.6526031494140341,45.735721478473636,106.53111770838784,116.26337057998366,36.035122705287264,-63.96487729471273,-0.7881549003535611,-0.39222287844158166,-0.042618546724994655,-97812401.0,1.0
3838,2018-04-02,IBM,109.97361935049288,110.0023050788905,106.4522229767146,107.62841796875,5387318.0,0.0,0.0,-2.409729003906236,2.409729003906236,0.0,35.92925622307543,106.4522229767146,116.26337057998366,11.988352836965767,-88.01164716303424,-0.967643148397471,-0.5073069324327596,-0.04626642286763838,-103199719.0,-1.0
3839,2018-04-03,IBM,108.15196824800104,108.29540834624986,106.35899563694,107.47064208984376,4325942.0,0.0,0.0,-0.1577758789062358,0.1577758789062358,0.0,35.35653021214232,106.35899563694,116.17014347900964,11.330442378384037,-88.66955762161595,-1.109826681810162,-0.6278108823082401,-0.04065295350258835,-107525661.0,-1.0
3840,2018-04-04,IBM,106.0649522337996,110.7840525944734,105.7493862995706,110.53303527832033,5026344.0,0.0,0.0,3.0623931884765625,0.0,3.0623931884765625,52.362918071409396,105.7493862995706,116.17014347900964,45.90500379558057,-54.09499620441943,-0.9642829658099004,-0.6951052990085722,-0.016401850044553856,-102499317.0,1.0
3841,2018-04-05,IBM,110.76252122426638,111.10677285418647,109.9736179163438,110.46847534179688,3331928.0,0.0,0.0,-0.06455993652345171,0.06455993652345171,0.0,52.029958921131794,105.7493862995706,116.17014347900964,45.28547168853912,-54.714528311460874,-0.8444140896257011,-0.724967057131998,0.012755438918483408,-105831245.0,-1.0
3842,2018-04-06,IBM,110.05968255402917,110.41109987979554,107.24829816062444,107.98700714111328,3841853.0,0.0,0.0,-2.4814682006835938,2.4814682006835938,0.0,40.58475431029699,105.7493862995706,114.67122218409136,25.08027350542184,-74.91972649457816,-0.9388286546114131,-0.7677393766278812,0.011283461706749653,-109673098.0,-1.0
3843,2018-04-09,IBM,108.86917911596116,110.92033515758187,108.82615051190707,109.50747680664062,4616207.0,0.0,0.0,1.5204696655273438,0.0,1.5204696655273438,48.581390829080114,105.7493862995706,113.45916236919626,48.74448327852007,-51.255516721479935,-0.8808102503887909,-0.7903535513800632,-0.00443370548382005,-105056891.0,1.0
3844,2018-04-10,IBM,111.1856608478804,112.31165004186624,110.98484931118524,111.44385528564452,3981494.0,0.0,0.0,1.936378479003892,0.0,1.936378479003892,57.07153740042094,105.7493862995706,113.45916236919626,73.86036811767481,-26.139631882325183,-0.6708475735372588,-0.7664523558115024,0.02290827237294435,-101075397.0,1.0
3845,2018-04-11,IBM,110.71236645407704,111.7236016854772,110.36093754326204,111.42237854003906,3458599.0,0.0,0.0,-0.02147674560545454,0.02147674560545454,0.0,56.95119357140623,105.7493862995706,112.31165004186624,86.44870830022306,-13.551291699776948,-0.5004151588609886,-0.7132449164213998,0.018620693791934873,-104533996.0,-1.0
3846,2018-04-12,IBM,112.41924985960782,114.01857676656545,112.36187839381478,113.36593627929688,5898812.0,0.0,0.0,1.9435577392578125,0.0,1.9435577392578125,64.71934633667657,105.7493862995706,114.01857676656545,92.10756494395092,-7.892435056049088,-0.20614110937199825,-0.6118241550115195,0.030242142367842506,-98635184.0,1.0
3847,2018-04-13,IBM,113.7962681769428,114.1907257010845,111.81683773861772,112.39058685302734,4243727.0,0.0,0.0,-0.9753494262695312,0.9753494262695312,0.0,58.59668315297525,105.7493862995706,114.1907257010845,78.67472491706333,-21.32527508293667,-0.051040983698456444,-0.4996675207489069,0.04424638932869973,-102878911.0,-1.0
3848,2018-04-16,IBM,113.30855743943329,114.1333237172263,113.07906014437592,113.23683166503906,4379393.0,0.0,0.0,0.8462448120117188,0.0,0.8462448120117188,62.17869071852221,105.7493862995706,114.1907257010845,88.69973127873088,-11.300268721269111,0.13856458106320702,-0.3720211003864841,0.05365362542800156,-98499518.0,1.0
3849,2018-04-17,IBM,113.90380260628642,116.18445510812889,113.68147106706324,115.40271759033205,10677045.0,0.0,0.0,2.165885925292983,0.0,2.165885925292983,69.87532995032866,105.7493862995706,116.18445510812889,92.5085542593097,-7.491445740690299,0.45831409073103657,-0.20595406216297996,0.044056352019556266,-87822473.0,1.0
3850,2018-04-18,IBM,109.1129915684219,109.46442036253998,106.33030417831336,106.71041870117188,21319258.0,0.0,0.0,-8.69229888916017,8.69229888916017,0.0,35.97466131266788,105.7493862995706,116.18445510812889,9.20964125136468,-90.79035874863533,0.010204375344258665,-0.16272237466153225,-0.03401926775034525,-109141731.0,-1.0
3851,2018-04-19,IBM,106.9972867663259,107.01162963060644,105.15411996149722,105.92868041992188,8458061.0,0.0,0.0,-0.78173828125,0.78173828125,0.0,34.250318383884164,105.15411996149722,116.18445510812889,7.022093600312647,-92.97790639968736,-0.40335591271198723,-0.21084908227162324,-0.01906087385588584,-117599792.0,-1.0
3852,2018-04-20,IBM,106.07212215196864,106.12231645431817,103.64085208671632,103.9205551147461,8645818.0,0.0,0.0,-2.0081253051757812,2.0081253051757812,0.0,29.98966781361031,103.64085208671632,116.18445510812889,2.229845982468551,-97.77015401753145,-0.8829660668701962,-0.34527247919133786,-0.051018632287176735,-126245610.0,-1.0
3853,2018-04-23,IBM,104.01378564651375,104.68076888531525,103.51175106685844,104.60905456542967,5560118.0,0.0,0.0,0.6884994506835795,0.0,0.6884994506835795,33.273423544983046,103.51175106685844,116.18445510812889,8.658795273666238,-91.34120472633376,-1.1937436836989548,-0.5149667200928614,-0.06132954304834837,-120685492.0,1.0
3854,2018-04-24,IBM,105.07522409900903,105.6417958314904,103.65518901995262,104.3938980102539,5142659.0,0.0,0.0,-0.21515655517576704,0.21515655517576704,0.0,32.72004603800369,103.51175106685844,116.18445510812889,6.96100011901669,-93.03899988098331,-1.4407899897902183,-0.7001313740323328,-0.0630796131071597,-125828151.0,-1.0
3855,2018-04-25,IBM,104.55884278587878,104.9963287289882,103.3539621535819,104.66641998291016,7663414.0,0.0,0.0,0.27252197265625,0.0,0.27252197265625,34.316567290596666,103.3539621535819,116.18445510812889,10.229208137035235,-89.77079186296476,-1.5961858843245835,-0.879342276090783,-0.07673836235034426,-118164737.0,1.0
3856,2018-04-26,IBM,105.13978814219055,105.68485138256683,104.85290793280504,105.22584533691406,4462027.0,0.0,0.0,0.5594253540039062,0.0,0.5594253540039062,37.81187191156568,103.3539621535819,116.18445510812889,14.58933175805053,-85.41066824194947,-1.6551181280497786,-1.034497446482582,-0.06374859066696204,-113702710.0,1.0
3857,2018-04-27,IBM,105.31189774611948,105.60594361966548,104.46561156101347,105.05370330810548,3352953.0,0.0,0.0,-0.17214202880857954,0.17214202880857954,0.0,37.11070553942694,103.3539621535819,116.18445510812889,13.247668351832187,-86.75233164816781,-1.6961604964796066,-1.166830056481987,-0.0722656068401819,-117055663.0,-1.0
3858,2018-04-30,IBM,105.32625634721737,105.6991937495665,103.96359252929688,103.96359252929688,4618613.0,0.0,0.0,-1.090110778808608,1.090110778808608,0.0,32.68239203050099,103.3539621535819,116.18445510812889,4.751418186928859,-95.24858181307114,-1.795947137901038,-1.2926534727657972,-0.09912353278926156,-121674276.0,-1.0
3859,2018-05-01,IBM,103.74126934147856,104.00662954900996,102.89499440821116,103.9922866821289,4637336.0,0.0,0.0,0.02869415283203125,0.0,0.02869415283203125,32.92548219522439,102.89499440821116,116.18445510812889,8.25686082148193,-91.74313917851808,-1.8513719286702468,-1.4043971639466872,-0.02547203967641365,-117036940.0,1.0
3860,2018-05-02,IBM,103.6050037133974,103.86319820424666,101.89092242047124,102.16345977783205,5433865.0,0.0,0.0,-1.8288269042968608,1.8288269042968608,0.0,26.01649231843301,101.89092242047124,116.18445510812889,1.9067179773978322,-98.09328202260217,-2.019586980143643,-1.5274351271860787,-0.03554486497107079,-122470805.0,-1.0
3861,2018-05-03,IBM,101.93394573664392,102.00566005743129,100.33460763830568,101.83353424072266,5249456.0,0.0,0.0,-0.3299255371093892,0.3299255371093892,0.0,24.927674031361263,100.33460763830568,116.18445510812889,9.457041181442309,-90.5429588185577,-2.1546830094133753,-1.6528847036315382,-0.020082849554825866,-127720261.0,-1.0
3862,2018-05-04,IBM,101.1952591602639,103.52611818792045,100.6071672589508,103.21056365966795,4604701.0,0.0,0.0,1.3770294189452983,0.0,1.3770294189452983,37.52040832187358,100.33460763830568,116.18445510812889,18.145007558197975,-81.85499244180203,-2.126124184003274,-1.7475325997058855,-0.01336873668891636,-123115560.0,1.0
3863,2018-05-07,IBM,103.27508141542909,103.50459014331072,102.2997093857999,102.7156753540039,3825222.0,0.0,0.0,-0.4948883056640483,0.4948883056640483,0.0,35.080267219596394,100.33460763830568,109.46442036253998,26.080137540805016,-73.91986245919499,-2.1189979698574035,-1.821825673736189,-0.016075869262829556,-126940782.0,-1.0
3864,2018-05-08,IBM,102.55792999267578,102.92369030448924,101.88376939541564,102.55792999267578,5616079.0,0.0,0.0,-0.157745361328125,0.157745361328125,0.0,34.26078044578135,100.33460763830568,107.01162963060644,33.29811339447139,-66.7018866055286,-2.101850304181184,-1.877830599825188,-0.020144856302323544,-132556861.0,-1.0
3865,2018-05-09,IBM,102.898759257889,103.71093413281056,102.44917133922614,103.41361236572266,4389016.0,1.500956,0.0,0.855682373046875,0.0,0.855682373046875,42.64654283459754,100.33460763830568,106.12231645431817,53.19902616556119,-46.800973834438814,-1.9962032508393008,-1.9015051300280106,-0.01722231800931573,-128167845.0,1.0
3866,2018-05-10,IBM,103.80516930565902,104.66083859296438,103.70364313952786,104.59557342529295,3898024.0,0.0,0.0,1.1819610595702983,0.0,1.1819610595702983,52.33688144260167,100.33460763830568,105.6991937495665,79.42767062761959,-20.57232937238041,-1.7963950960235167,-1.880483123227112,-0.00436091130903693,-124269821.0,1.0
3867,2018-05-11,IBM,104.5012894900646,105.03790126718918,104.11696694086264,104.5230484008789,3214567.0,0.0,0.0,-0.07252502441404829,0.07252502441404829,0.0,51.71821649161908,100.33460763830568,105.6991937495665,78.07574854248779,-21.92425145751221,-1.6251639784313738,-1.8294192942679643,0.005381267210676333,-127484388.0,-1.0
3868,2018-05-14,IBM,104.76237263645774,105.23371935631492,104.52307086163228,104.63909912109376,3364041.0,0.0,0.0,0.11605072021485796,0.0,0.11605072021485796,52.749462517322655,100.33460763830568,105.6991937495665,80.23902298357199,-19.76097701642801,-1.4632305498912501,-1.7561815453926215,0.006219811676436704,-124120347.0,1.0
3869,2018-05-15,IBM,104.05892337119636,104.41424163491058,103.63832839714507,104.23294830322266,4277512.0,0.0,0.0,-0.40615081787110796,0.40615081787110796,0.0,48.56100558953119,100.33460763830568,105.6991937495665,72.66806020195953,-27.331939798040473,-1.3520841335160156,-1.6753620630173003,0.020256640974091855,-128397859.0,-1.0
3870,2018-05-16,IBM,104.2039923893694,105.1684446572103,103.8921802143076,104.87837982177734,3314460.0,0.0,0.0,0.6454315185546875,0.0,0.6454315185546875,55.09845109414845,100.33460763830568,105.6991937495665,84.69939878369765,-15.300601216302356,-1.1981078270864316,-1.5799112158311266,0.029900224948070875,-125083399.0,1.0
3871,2018-05-17,IBM,104.7840805053711,105.28444278202308,104.25472564213942,104.7840805053711,3292494.0,0.0,0.0,-0.09429931640625,0.09429931640625,0.0,53.9427253748341,100.33460763830568,105.6991937495665,82.9415871939404,-17.0584128060596,-1.071339921909484,-1.4781969570467983,0.015245695691496586,-128375893.0,-1.0
3872,2018-05-18,IBM,104.76236122376176,105.10317756133304,104.41428805718728,104.47955322265624,2805581.0,0.0,0.0,-0.30452728271485796,0.30452728271485796,0.0,50.03223800738739,100.33460763830568,105.28444278202308,83.73906330216971,-16.26093669783028,-0.9841041108118134,-1.3793783877998014,0.0171724312046162,-131181474.0,-1.0
3873,2018-05-21,IBM,105.11044234100748,105.90084649375537,104.91464682979044,105.50202178955078,3027856.0,0.0,0.0,1.0224685668945455,0.0,1.0224685668945455,60.98849819046142,100.33460763830568,105.90084649375537,92.83493370367835,-7.1650662963216565,-0.8229776596204914,-1.2680982421639395,0.02870662265789936,-128153618.0,1.0
3874,2018-05-22,IBM,105.5237643883846,106.01686998515324,105.14668704199988,105.21195220947266,2389064.0,0.0,0.0,-0.290069580078125,0.290069580078125,0.0,56.90420485845828,100.33460763830568,106.01686998515324,85.8345545040324,-14.165445495967594,-0.7104997779284474,-1.1565785493168412,0.017389778798077016,-130542682.0,-1.0
3875,2018-05-23,IBM,104.67533030131447,104.92913411759297,104.04444917488264,104.90738677978516,3618846.0,0.0,0.0,-0.3045654296875,0.3045654296875,0.0,52.633881960954554,100.6071672589508,106.01686998515324,79.49086555173938,-20.509134448260628,-0.6385750356327975,-1.0529778465800326,0.002981133371910083,-134161528.0,-1.0
3876,2018-05-24,IBM,104.70431965202064,104.76958480398744,103.66011194221444,104.47227478027344,3555040.0,0.0,0.0,-0.43511199951171875,0.43511199951171875,0.0,46.83962054685226,101.88376939541564,106.01686998515324,62.62865683175007,-37.37134316824992,-0.6096563225629836,-0.9643135417766228,-0.0004857648277797333,-137716568.0,-1.0
3877,2018-05-25,IBM,104.34902298153078,104.83487173457456,104.02995398291458,104.16048431396484,5140358.0,0.0,0.0,-0.31179046630859375,0.31179046630859375,0.0,42.93190848368182,101.88376939541564,106.01686998515324,55.084914318374935,-44.915085681625065,-0.6049237347344558,-0.8924355803681894,-0.004573957642496906,-142856926.0,-1.0
3878,2018-05-29,IBM,103.35555524922486,103.61661588275024,101.67320950940628,102.4056167602539,4746330.0,0.0,0.0,-1.7548675537109375,1.7548675537109375,0.0,27.84532505138354,101.67320950940628,106.01686998515324,16.8615216345076,-83.1384783654924,-0.7343115834869423,-0.8608107809919399,-0.017531227627303414,-147603256.0,-1.0
3879,2018-05-30,IBM,102.89872762338544,103.76891058831592,102.84071928368697,103.42083740234376,5353951.0,0.0,0.0,1.015220642089858,0.0,1.015220642089858,41.55486987575577,101.67320950940628,106.01686998515324,40.233989343675766,-59.766010656324234,-0.7463293444398573,-0.8379144936815233,-0.013897453621141143,-142249305.0,1.0
3880,2018-05-31,IBM,103.55861203304404,103.55861203304404,102.28234755431131,102.47088623046876,7144494.0,0.0,0.0,-0.949951171875,0.949951171875,0.0,34.48140414081833,101.67320950940628,106.01686998515324,18.36415911225922,-81.63584088774078,-0.8230193720660424,-0.834935469358427,-0.02207581785082091,-149393799.0,-1.0
3881,2018-06-01,IBM,103.28304780920308,103.58035787069517,102.6956729407539,102.93497467041016,4034945.0,0.0,0.0,0.46408843994139204,0.0,0.46408843994139204,40.217685282396815,101.67320950940628,106.01686998515324,29.04842972992496,-70.95157027007505,-0.8367037133497348,-0.8352891181566885,-0.014783548594952678,-145358854.0,1.0
3882,2018-06-04,IBM,103.18879097591623,103.81967216962198,103.10176689373765,103.72540283203124,3174924.0,0.0,0.0,0.7904281616210795,0.0,0.7904281616210795,48.993732520393344,101.67320950940628,106.01686998515324,47.245712091989716,-52.75428790801028,-0.7748358799429695,-0.8231984705139447,-0.016839667405269654,-142183930.0,1.0
3883,2018-06-05,IBM,103.73264046824892,104.47954985870192,103.72539521336896,104.20398712158205,2966456.0,0.0,0.0,0.47858428955080967,0.0,0.47858428955080967,53.73825170136857,101.67320950940628,106.01686998515324,58.26370698875959,-41.73629301124041,-0.679356228051077,-0.7944300220213713,-0.009580328724285936,-139217474.0,1.0
3884,2018-06-06,IBM,104.66808022132098,104.94363136270395,104.08796219966698,104.93638610839844,3368225.0,0.0,0.0,0.732398986816392,0.0,0.732398986816392,60.26477048425642,101.67320950940628,106.01686998515324,75.12503836826721,-24.874961631732788,-0.5383832912609421,-0.7432206758692855,0.0002764278999165537,-135849249.0,1.0
3885,2018-06-07,IBM,105.14666947626051,106.37942747529311,105.09591797571824,105.40773010253906,4515059.0,0.0,0.0,0.471343994140625,0.0,0.471343994140625,64.03272173525971,101.67320950940628,106.37942747529311,79.35290333347439,-20.647096666525616,-0.384198896337125,-0.6714163199628534,0.008954101212336862,-131334190.0,1.0
3886,2018-06-08,IBM,105.14668150833498,106.1836441563197,104.68983693395856,105.97335815429688,5450183.0,0.0,0.0,0.5656280517578125,0.0,0.5656280517578125,68.20717444356602,101.67320950940628,106.37942747529311,91.37164228389668,-8.62835771610333,-0.21389949565728728,-0.5799129551017402,0.017404621841691892,-125884007.0,1.0
3887,2018-06-11,IBM,106.3214312305627,106.89429247488148,105.97335807189042,106.29242706298828,3409960.0,0.0,0.0,0.31906890869140625,0.0,0.31906890869140625,70.44020584304855,101.67320950940628,106.89429247488148,88.47240283532976,-11.527597164670238,-0.05258364775716018,-0.4744470936328242,0.03795504998357613,-122474047.0,1.0
3888,2018-06-12,IBM,106.66949211085264,106.9740474092172,106.32141899224594,106.50270080566406,2761963.0,0.0,0.0,0.21027374267578125,0.0,0.21027374267578125,71.93891914695492,101.67320950940628,106.9740474092172,91.1080736203996,-8.891926379600402,0.09117663018723476,-0.3613223488688124,0.029799250138835776,-119712084.0,1.0
3889,2018-06-13,IBM,106.44470222333108,106.93780778215434,106.01686182695836,106.1256332397461,3104737.0,0.0,0.0,-0.37706756591796875,0.37706756591796875,0.0,65.10864900981588,101.67320950940628,106.9740474092172,83.99471582593813,-16.005284174061877,0.17269081271787456,-0.25451971655147504,0.03566619889533684,-122816821.0,-1.0
3890,2018-06-14,IBM,106.3431668859547,106.58246860298732,105.21193503149694,105.2917022705078,3479310.0,0.0,0.0,-0.8339309692382955,0.8339309692382955,0.0,52.41024845955345,101.67320950940628,106.9740474092172,68.26265638552323,-31.737343614476764,0.16806280646825655,-0.17000321194752868,0.02289530460996092,-126296131.0,-1.0
3891,2018-06-15,IBM,105.07418593044731,105.48752431180984,104.20400291018176,105.42950439453124,9535336.0,0.0,0.0,0.1378021240234375,0.0,0.1378021240234375,54.11649066773954,101.67320950940628,106.9740474092172,70.86228547488574,-29.137714525114255,0.17351439201851804,-0.10129969115431933,0.016428970300164103,-116760795.0,1.0
3892,2018-06-18,IBM,104.55204186543853,104.79858881795312,103.7978873529114,104.76958465576172,4483574.0,0.0,0.0,-0.659919738769517,0.659919738769517,0.0,45.1681474032165,102.28234755431131,106.9740474092172,53.013559655774145,-46.986440344225855,0.12316503524559153,-0.05640674587433716,0.005427791678640492,-121244369.0,-1.0
3893,2018-06-19,IBM,103.78340591472262,104.5810668291946,103.66013241394576,104.3490219116211,3647402.0,0.0,0.0,-0.420562744140625,0.420562744140625,0.0,40.271504330865426,102.28234755431131,106.9740474092172,44.049585890468975,-55.950414109531025,0.04876477858041994,-0.03537244098338573,-0.0055973358580369,-124891771.0,-1.0
3894,2018-06-20,IBM,104.58105692134475,104.79859973432838,103.2685432151956,103.4280776977539,3483075.0,0.0,0.0,-0.9209442138671875,0.9209442138671875,0.0,31.612382796783905,102.6956729407539,106.9740474092172,17.11876233365505,-82.88123766634496,-0.08354738006781304,-0.0450074288002712,-0.018780903476997235,-128374846.0,-1.0
3895,2018-06-21,IBM,103.3990424970551,103.7978786283826,102.12277845069369,102.4273452758789,4066534.0,0.0,0.0,-1.000732421875,1.000732421875,0.0,24.899620561540658,102.12277845069369,106.9740474092172,6.27808575012328,-93.72191424987672,-0.2660891519210651,-0.08922377342443,-0.033461361800529055,-132441380.0,-1.0
3896,2018-06-22,IBM,102.7101762675772,102.83344976116572,102.08655197112282,102.44912719726562,5869420.0,0.0,0.0,0.02178192138671875,0.0,0.02178192138671875,25.29800499066556,102.08655197112282,106.9740474092172,7.418425873440309,-92.5815741265597,-0.4043362654627458,-0.1522462718320932,-0.03615779573313482,-126571960.0,1.0
3897,2018-06-25,IBM,101.81099426189544,101.81099426189544,100.27368078274488,100.64350128173828,9348207.0,0.0,0.0,-1.8056259155273438,1.8056259155273438,0.0,16.782682465281326,100.27368078274488,106.9740474092172,5.519406916216941,-94.48059308378306,-0.6520802449410183,-0.2522130664538783,-0.055014562819557855,-135920167.0,-1.0
3898,2018-06-26,IBM,101.05683865847442,101.41216864417596,100.30994083862235,100.85379791259766,4329917.0,0.0,0.0,0.210296630859375,0.0,0.210296630859375,20.384049259605817,100.27368078274488,106.9740474092172,8.657990856213877,-91.34200914378613,-0.8219747398489972,-0.36616540113290214,-0.04967541927631136,-131590250.0,1.0
3899,2018-06-27,IBM,100.87556046421496,101.36140922086388,99.67180645535252,99.69356536865234,4290483.0,0.0,0.0,-1.1602325439453125,1.1602325439453125,0.0,15.981280688173356,99.67180645535252,106.9740474092172,0.2979758328613371,-99.70202416713866,-1.038269891902459,-0.5005862992868136,-0.05316788294934327,-135880733.0,-1.0
3900,2018-06-28,IBM,100.14316238330636,101.91253256259434,100.03439095453436,101.54995727539062,4731790.0,0.0,0.0,1.8563919067382812,0.0,1.8563919067382812,39.93328294080238,99.67180645535252,106.9740474092172,25.720197839323518,-74.27980216067648,-1.0478115268267345,-0.6100313447947978,-0.036797546772323164,-131148943.0,1.0
3901,2018-06-29,IBM,101.75296288946302,102.50711737444716,101.23811009464974,101.30337524414062,3880765.0,0.0,0.0,-0.24658203125,0.24658203125,0.0,38.26154597197345,99.67180645535252,106.9740474092172,22.343398404630836,-77.65660159536915,-1.0630166560913352,-0.7006284070541053,-0.03308411905048503,-135029708.0,-1.0
3902,2018-07-02,IBM,100.27366914174452,101.68046370293278,100.2156608130814,101.41940307617188,3562048.0,0.0,0.0,0.11602783203125,0.0,0.11602783203125,39.63361746493471,99.67180645535252,106.93780778215434,24.051696968084222,-75.94830303191577,-1.053559575255207,-0.7712146406943258,-0.028075192098402924,-131467660.0,1.0
3903,2018-07-03,IBM,101.99226509538904,102.202551051604,101.06407406503128,101.2091064453125,2053507.0,0.0,0.0,-0.210296630859375,0.210296630859375,0.0,37.8733728727993,99.67180645535252,106.58246860298732,22.245335643938606,-77.7546643560614,-1.0509196041244735,-0.8271556333803555,-0.021454244358344088,-133521167.0,-1.0
3904,2018-07-05,IBM,101.86901758991412,102.5579071044922,101.47018133594726,102.5579071044922,3916956.0,0.0,0.0,1.3488006591797017,0.0,1.3488006591797017,53.2418274005044,99.67180645535252,105.48752431180984,49.625871137045976,-50.374128862954024,-0.9292783251088537,-0.8475801717260552,0.0012746774629532887,-129604211.0,1.0
3905,2018-07-06,IBM,102.63039318057594,103.65285354011937,102.36934415056189,103.31928253173828,2980054.0,0.0,0.0,0.7613754272460795,0.0,0.7613754272460795,59.730137013184695,99.67180645535252,104.79859973432838,71.14537056415878,-28.85462943584122,-0.7626487610273216,-0.8305938895863085,0.008493535848257405,-126624157.0,1.0
3906,2018-07-09,IBM,103.39905445783828,104.94362452141937,103.31204196851245,104.7043228149414,4084316.0,0.0,0.0,1.385040283203125,0.0,1.385040283203125,68.81358842242759,99.67180645535252,104.94362452141937,95.46073662863529,-4.539263371364716,-0.5129198348272581,-0.7670590786344985,0.04034857175562068,-122539841.0,1.0
3907,2018-07-10,IBM,104.79135370951276,105.57451246005124,104.61006031743352,104.93638610839844,3950742.0,0.0,0.0,0.23206329345703125,0.0,0.23206329345703125,70.11672774603231,99.67180645535252,105.57451246005124,89.18925741609299,-10.810742583907023,-0.2929058568753362,-0.6722284342826661,0.040480262323277616,-118589099.0,1.0
3908,2018-07-11,IBM,104.42151292749276,106.00960078017644,104.42151292749276,105.10315704345705,3688824.0,0.0,0.0,0.16677093505860796,0.0,0.16677093505860796,71.11747057702541,99.67180645535252,106.00960078017644,85.69780446851942,-14.302195531480578,-0.10388861030577345,-0.5585604694872875,0.05426219490496509,-114900275.0,1.0
3909,2018-07-12,IBM,105.76306102669234,106.473709431389,105.68329377851774,106.19815826416016,3262997.0,0.0,0.0,1.0950012207031108,0.0,1.0950012207031108,76.96234036093905,99.67180645535252,106.473709431389,95.94891064751107,-4.051089352488922,0.13273626555616147,-0.4203011224785977,0.04577255484376219,-111637278.0,1.0
3910,2018-07-13,IBM,106.19816794225903,106.58249056040664,105.72680966524044,105.79933166503906,3203480.0,0.0,0.0,-0.39882659912109375,0.39882659912109375,0.0,70.92998519522074,99.67180645535252,106.58249056040664,88.66741868876895,-11.332581311231053,0.28479823428669704,-0.2792812511255387,0.04438111178490556,-114840758.0,-1.0
3911,2018-07-16,IBM,105.6325098762276,105.71953393612324,104.57380009369076,105.48023223876952,3628365.0,0.0,0.0,-0.31909942626954546,0.31909942626954546,0.0,66.14381957436476,99.67180645535252,106.58249056040664,84.04993912497044,-15.950060875029557,0.37523431556363107,-0.1483781377877047,0.04003996315722458,-118469123.0,-1.0
3912,2018-07-17,IBM,104.96540119815364,105.14668303521196,103.94294061911984,104.0517120361328,5331148.0,0.0,0.0,-1.4285202026367188,1.4285202026367188,0.0,49.04807294053316,99.67180645535252,106.58249056040664,63.37875547772526,-36.62124452227474,0.3278565930994688,-0.053131191610269975,0.028086460701599814,-123800271.0,-1.0
3913,2018-07-18,IBM,104.06619599029092,105.0016439023016,103.50782534460345,104.79859161376952,7254324.0,0.0,0.0,0.7468795776367188,0.0,0.7468795776367188,55.921012395586345,100.03439095453436,106.58249056040664,72.7569973884127,-27.243002611587297,0.34658117464871907,0.02681128164152786,0.02184799370948909,-116545947.0,1.0
3914,2018-07-19,IBM,107.21337017388092,109.1640221275341,106.77828447714764,108.22132873535156,15329967.0,0.0,0.0,3.4227371215820455,0.0,3.4227371215820455,74.2719841307181,100.2156608130814,109.1640221275341,89.46518408169361,-10.534815918306393,0.6303406465340089,0.1475171546200241,0.047445608249432336,-101215980.0,1.0
3915,2018-07-20,IBM,107.74271392200558,107.9457662380247,106.06036807729556,106.1256332397461,6709672.0,0.0,0.0,-2.0956954956054688,2.0956954956054688,0.0,57.39172001835865,100.2156608130814,109.1640221275341,66.04530392753996,-33.95469607246003,0.6782979636433311,0.2536733164246855,0.013574515231016493,-107925652.0,-1.0
3916,2018-07-23,IBM,106.12562057728724,106.37942436813896,105.15392323291474,105.6542739868164,4077203.0,0.0,0.0,-0.4713592529296875,0.4713592529296875,0.0,54.19513487602589,101.06407406503128,109.1640221275341,56.669498203755076,-43.33050179624493,0.6705401609893755,0.33704668533762355,0.006841172114278704,-112002855.0,-1.0
3917,2018-07-24,IBM,106.37944482830795,106.6259918387768,105.8138288109569,106.14739990234376,4070614.0,0.0,0.0,0.49312591552735796,0.0,0.49312591552735796,57.08077771311832,101.47018133594726,109.1640221275341,60.791725395604914,-39.20827460439509,0.6961583070320216,0.40886900967650325,0.009935409061546663,-107932241.0,1.0
3918,2018-07-25,IBM,105.87907632384676,106.34316609839269,105.5092442959192,106.32141876220705,3797921.0,0.0,0.0,0.17401885986328125,0.0,0.17401885986328125,58.15419670705245,102.36934415056189,109.1640221275341,58.164266578035104,-41.835733421964896,0.7221779224444731,0.47153079223009725,0.0011606651194484563,-104134320.0,1.0
3919,2018-07-26,IBM,106.90878635648453,108.24307055365676,106.32866832783472,106.38668823242188,4997788.0,0.0,0.0,0.06526947021482954,0.0,0.06526947021482954,58.60227671225117,103.31204196851245,109.1640221275341,52.54027150398707,-47.459728496012936,0.7395403945660064,0.5251327126972791,0.0055516094302219265,-99136532.0,1.0
3920,2018-07-27,IBM,106.5172096290267,106.69850302780684,104.9001289924865,105.25544738769533,3921768.0,0.0,0.0,-1.1312408447265483,1.1312408447265483,0.0,48.26651487638882,103.50782534460345,109.1640221275341,30.897475992452712,-69.10252400754729,0.6544742253432645,0.5510010152264763,-0.0021310613970336734,-103058300.0,-1.0
3921,2018-07-30,IBM,105.00167091496162,106.04587891978012,104.92190365934256,105.50202178955078,3774177.0,0.0,0.0,0.24657440185545454,0.0,0.24657440185545454,50.46382468290583,103.50782534460345,109.1640221275341,35.25684344939074,-64.74315655060926,0.6000382988883501,0.5608084719588511,0.013938355506484701,-99284123.0,1.0
3922,2018-07-31,IBM,105.6832876745695,105.72679392363656,104.53755367246892,105.0959243774414,5726013.0,0.0,0.0,-0.406097412109375,0.406097412109375,0.0,46.694886438376884,103.50782534460345,109.1640221275341,28.07715314344344,-71.92284685655656,0.5181557903136564,0.5522779356298122,0.0028371828198578974,-105010136.0,-1.0
3923,2018-08-01,IBM,104.9726451672702,105.28446890436996,103.94293934579096,104.05896759033205,3544266.0,0.0,0.0,-1.0369567871093608,1.0369567871093608,0.0,38.27299481445362,103.50782534460345,109.1640221275341,9.744042982942949,-90.25595701705706,0.36537771892233195,0.5148978922883162,-0.03846156015325142,-108554402.0,-1.0
3924,2018-08-02,IBM,103.5948479920152,103.95742317190212,103.21051390325776,103.6673583984375,4018104.0,0.0,0.0,-0.39160919189454546,0.39160919189454546,0.0,35.484206510811745,103.21051390325776,109.1640221275341,7.6735342922158845,-92.32646570778411,0.21027647139709416,0.45397360811007176,-0.023163817885120785,-112572506.0,-1.0
3925,2018-08-03,IBM,103.87041831523904,107.26412586714252,103.69639330764949,107.1045913696289,8424066.0,0.0,0.0,3.4372329711914062,0.0,3.4372329711914062,62.878228267966456,103.21051390325776,109.1640221275341,65.4081143365596,-34.591885663440394,0.36055730968294597,0.43529034842464664,0.013727011015129076,-104148440.0,1.0
3926,2018-08-06,IBM,106.56071964198703,106.7420014535916,105.56000654253188,105.8935775756836,4093730.0,0.0,0.0,-1.2110137939453125,1.2110137939453125,0.0,53.62224113472432,103.21051390325776,109.1640221275341,45.06693484499159,-54.93306515500841,0.37758470301460534,0.4237492193426384,-0.0023912250973051608,-108242170.0,-1.0
3927,2018-08-07,IBM,106.3431797586118,107.06108499661084,106.1256369254811,106.60424041748048,3670205.0,0.0,0.0,0.7106628417968892,0.0,0.7106628417968892,57.825928427894844,103.21051390325776,109.1640221275341,57.00380996173459,-42.99619003826542,0.44331334667403155,0.427662044808917,0.002660062841203903,-104571965.0,1.0
3928,2018-08-08,IBM,106.83628854771943,106.9087989696472,106.04587286620126,106.51721954345705,3745831.0,0.0,0.0,-0.0870208740234375,0.0870208740234375,0.0,57.09474802337492,103.21051390325776,108.24307055365676,65.70627754259087,-34.293722457409125,0.48281630720676105,0.4386928972884858,0.001226951540685306,-108317796.0,-1.0
3929,2018-08-09,IBM,106.67115036011486,106.97167251381047,106.08476481395766,106.11408233642578,3235801.0,1.500956,0.0,-0.4031372070312642,0.4031372070312642,0.0,53.48005732068922,103.21051390325776,108.24307055365676,57.69569296230003,-42.30430703769997,0.4761046465822574,0.4461752471472401,0.008157629557810742,-111553597.0,-1.0
3930,2018-08-10,IBM,105.91616327669595,106.3339671867126,105.46171831590864,105.90150451660156,3141243.0,0.0,0.0,-0.21257781982421875,0.21257781982421875,0.0,51.496408029445206,103.21051390325776,108.24307055365676,53.47164076395339,-46.528359236046605,0.4484627542371129,0.44663274856521473,0.0037864935692668578,-114694840.0,-1.0
3931,2018-08-13,IBM,105.6596074691464,105.76956570788768,104.4721778198221,104.60411834716795,2989991.0,0.0,0.0,-1.297386169433608,1.297386169433608,0.0,40.83129614824825,103.21051390325776,108.24307055365676,27.691778567454406,-72.3082214325456,0.3182001213140211,0.42094622311497604,-0.004679591841327602,-117684831.0,-1.0
3932,2018-08-14,IBM,104.81666658655708,105.41771066837704,104.76535509202924,105.08053588867188,2991560.0,0.0,0.0,0.47641754150392046,0.0,0.47641754150392046,45.60457937517819,103.21051390325776,108.24307055365676,37.158488524234485,-62.84151147576551,0.25052110884394097,0.38686120026076903,0.009817205782413962,-114693271.0,1.0
3933,2018-08-15,IBM,104.48683781542432,105.54966217880543,104.08370439765233,105.48370361328124,4436609.0,0.0,0.0,0.4031677246093608,0.0,0.4031677246093608,49.57652963931875,103.21051390325776,107.26412586714252,56.07812810590216,-43.92187189409784,0.22680282800182283,0.3548495258089798,0.01752089802329837,-110256662.0,1.0
3934,2018-08-16,IBM,105.82088069498576,106.78109387254716,105.82088069498576,106.5318832397461,5492232.0,0.0,0.0,1.048179626464858,0.0,1.048179626464858,58.63701046524748,103.21051390325776,107.26412586714252,81.93604533635012,-18.06395466364988,0.28925095050161076,0.341729810747506,-0.005347185611365046,-104764430.0,1.0
3935,2018-08-17,IBM,106.12874730961448,107.30151847057382,106.05545349915413,107.05963134765624,2801816.0,0.0,0.0,0.527748107910142,0.0,0.527748107910142,62.54674245630126,103.21051390325776,107.30151847057382,94.08734165563934,-5.9126583443606675,0.37698079923926286,0.34878000844585744,0.011011562728053592,-101962614.0,1.0
3936,2018-08-20,IBM,107.28686518140309,107.86592725984195,107.12560709123191,107.38948822021484,2614686.0,0.0,0.0,0.32985687255860796,0.0,0.32985687255860796,64.93692890026763,103.21051390325776,107.86592725984195,89.76591328988482,-10.23408671011518,0.46773230248011544,0.3725704672527091,0.007366009078618285,-99347928.0,1.0
3937,2018-08-21,IBM,107.7486193936394,107.83658364833263,106.93500560764453,106.99365234375,3249817.0,0.0,0.0,-0.39583587646484375,0.39583587646484375,0.0,59.664667548461026,103.21051390325776,107.86592725984195,81.26321232338505,-18.73678767661496,0.5019269738200194,0.3984417685661712,0.0044728242281857344,-102597745.0,-1.0
3938,2018-08-22,IBM,107.0229602573217,107.13290679162334,106.421916083425,106.45855712890624,2498894.0,0.0,0.0,-0.5350952148437642,0.5350952148437642,0.0,52.958084956450065,103.69639330764949,107.86592725984195,66.24634438590721,-33.75365561409279,0.48031204706094854,0.4148158242651267,0.0032462684018539356,-105096639.0,-1.0
3939,2018-08-23,IBM,106.31200335116884,106.663825353439,106.0994337445034,106.55387878417967,2322538.0,0.0,0.0,0.0953216552734375,0.0,0.0953216552734375,54.02041033860378,104.08370439765233,107.86592725984195,65.31012255309828,-34.68987744690172,0.4655076405101397,0.42495418751412933,0.006160198295160679,-102774101.0,1.0
3940,2018-08-24,IBM,106.61983257333416,107.08161277236712,106.1873698950444,107.04496002197266,2904324.0,0.0,0.0,0.49108123779298296,0.0,0.49108123779298296,59.462207320820795,104.08370439765233,107.86592725984195,78.29405437536757,-21.705945624632438,0.4877783877884525,0.43751902756899397,0.023334087733561937,-99869777.0,1.0
3941,2018-08-27,IBM,107.70466779200255,108.20310081898032,107.39681037843796,107.52141571044922,3652214.0,0.0,0.0,0.4764556884765625,0.0,0.4764556884765625,64.20483174751939,104.08370439765233,108.20310081898032,83.45182063562262,-16.548179364377376,0.5376761120839717,0.4575504444719895,0.023228657915899342,-96217563.0,1.0
3942,2018-08-28,IBM,107.71198594216057,107.74130346281618,107.15491795291156,107.44810485839844,2568244.0,0.0,0.0,-0.07331085205078125,0.07331085205078125,0.0,62.89838477474329,104.08370439765233,108.20310081898032,81.67217030453972,-18.327829695460284,0.5647942484814337,0.47899920527387835,0.01862279364326258,-98785807.0,-1.0
3943,2018-08-29,IBM,107.65333437159777,108.43029542983304,107.4554352665866,108.1444320678711,3298875.0,0.0,0.0,0.6963272094726562,0.0,0.6963272094726562,69.66359369118459,104.08370439765233,108.43029542983304,93.42327447313292,-6.576725526867075,0.6351517196512759,0.5102297081493579,0.015136772007456445,-95486932.0,1.0
3944,2018-08-30,IBM,107.77063059454996,107.96852972608954,106.46591891650432,106.96434020996094,3494058.0,0.0,0.0,-1.1800918579101562,1.1800918579101562,0.0,51.35293335612919,104.08370439765233,108.43029542983304,66.27344949136791,-33.72655050863208,0.5888985164365153,0.5259634698067893,-0.0008900753392832028,-98980990.0,-1.0
3945,2018-08-31,IBM,106.81040941949428,107.58737052409616,106.67846887565948,107.3674774169922,3648971.0,0.0,0.0,0.4031372070312642,0.0,0.4031372070312642,55.91987940909701,104.08370439765233,108.43029542983304,75.54823987414308,-24.45176012585692,0.5781082510435169,0.5363924260541348,-0.00020496236258715772,-95332019.0,1.0
3946,2018-09-04,IBM,107.00099053056766,107.15492507263376,106.14340034922134,106.78109741210938,3479205.0,0.0,0.0,-0.5863800048828267,0.5863800048828267,0.0,48.30844576631503,104.08370439765233,108.43029542983304,62.05766759482201,-37.94233240517799,0.5162894586675577,0.5323718325768194,-0.0019866125418144254,-98811224.0,-1.0
3947,2018-09-05,IBM,106.42193689974454,107.5653904392863,106.31931387489432,107.49942016601562,3270319.0,0.0,0.0,0.71832275390625,0.0,0.71832275390625,56.648884459021396,105.82088069498576,108.43029542983304,64.32628162223149,-35.673718377768516,0.51927439134937,0.5297523443313296,0.009777166487885625,-95540905.0,1.0
3948,2018-09-06,IBM,107.66069022933108,108.23241706280126,106.67848294965732,107.30152130126952,4444245.0,0.0,0.0,-0.19789886474610796,0.19789886474610796,0.0,53.88506723488284,106.05545349915413,108.43029542983304,52.46950485496815,-47.53049514503184,0.49990855291407854,0.5237835860478793,0.007016567821094277,-99985150.0,-1.0
3949,2018-09-07,IBM,106.97165255398008,107.38212118980766,106.37060835873758,106.61249542236328,4908983.0,0.0,0.0,-0.6890258789062358,0.6890258789062358,0.0,45.05436964533222,106.0994337445034,108.43029542983304,22.011674098427765,-77.98832590157222,0.4240738965302171,0.5038416481443468,-0.004040027662400969,-104894133.0,-1.0
3950,2018-09-10,IBM,107.45544566457288,107.96852570053466,106.69314329224306,106.75910186767578,3784742.0,0.0,0.0,0.1466064453125,0.0,0.1466064453125,47.179542117585456,106.0994337445034,108.43029542983304,28.301470109715606,-71.69852989028439,0.37152162979819536,0.47737764447511655,-0.00708987914394954,-101109391.0,1.0
3951,2018-09-11,IBM,107.01565560351985,107.74131697594876,106.46592277495152,107.37482452392578,3529936.0,0.0,0.0,0.61572265625,0.0,0.61572265625,55.51702287520272,106.0994337445034,108.43029542983304,54.71756593064471,-45.28243406935529,0.3752318135717019,0.4569484782944336,-0.0006820067656775342,-97579455.0,1.0
3952,2018-09-12,IBM,107.28684948561968,108.46695576464438,107.0376388548683,107.4334487915039,4714008.0,0.0,0.0,0.058624267578125,0.0,0.058624267578125,56.275251550656456,106.0994337445034,108.46695576464438,56.346468402480475,-43.65353159751952,0.3785390864367173,0.44126659992289036,-0.006574386334758153,-92865447.0,1.0
3953,2018-09-13,IBM,108.0051995761901,109.21462364558602,107.83661794123527,109.17797088623048,5592439.0,0.0,0.0,1.7445220947265767,0.0,1.7445220947265767,72.41803717000187,106.14340034922134,109.21462364558602,98.8065745854781,-1.1934254145218977,0.51598057459762,0.45620939485783635,0.020695034176103855,-87273008.0,1.0
3954,2018-09-14,IBM,109.1046772623708,109.43451700036188,108.32038074414277,108.72352600097656,3610897.0,0.0,0.0,-0.45444488525392046,0.45444488525392046,0.0,65.18453848331923,106.14340034922134,109.43451700036188,78.39666366310894,-21.603336336891054,0.5815305180698402,0.48127361950023717,0.012629975264462523,-90883905.0,-1.0
3955,2018-09-17,IBM,108.80411443089692,109.26589457125472,108.31301677352108,108.4376220703125,3715287.0,0.0,0.0,-0.2859039306640625,0.2859039306640625,0.0,60.777647032687234,106.14340034922134,109.43451700036188,69.70952306707501,-30.290476932924985,0.6034530318134017,0.5057095019628701,0.015513276210394888,-94599192.0,-1.0
3956,2018-09-18,IBM,108.30569669517952,109.2072748137138,108.0931388176002,108.89208221435548,3796352.0,0.0,0.0,0.45446014404298296,0.0,0.45446014404298296,65.10457648328116,106.14340034922134,109.43451700036188,83.51821453006187,-16.481785469938128,0.6500050636807231,0.5345686143064408,0.012955065675601896,-90802840.0,1.0
3957,2018-09-19,IBM,108.94340975145144,109.91828181618816,108.65022279820091,109.2585906982422,4441525.0,0.0,0.0,0.36650848388671875,0.0,0.36650848388671875,68.35328633362077,106.14340034922134,109.91828181618816,82.52418986612507,-17.475810133874933,0.7083071322209378,0.5693163178893402,0.018238971575042617,-86361315.0,1.0
3958,2018-09-20,IBM,109.63968561280429,110.95905547209934,109.537074326497,110.79047393798828,6226001.0,0.0,0.0,1.5318832397460795,0.0,1.5318832397460795,78.1593942799699,106.14340034922134,110.95905547209934,96.49930217572754,-3.500697824272462,0.8681150269005968,0.6290760596915916,0.0391884506508664,-80135314.0,1.0
3959,2018-09-21,IBM,111.03239105550074,111.85332836427868,110.48998186972608,110.93710327148438,20865085.0,0.0,0.0,0.14662933349609375,0.0,0.14662933349609375,78.88210063015003,106.14340034922134,111.85332836427868,83.95382410464408,-16.046175895355923,0.9951245205393349,0.7022857518611404,0.039134849682297634,-59270229.0,1.0
3960,2018-09-24,IBM,110.75386627190392,110.82717177659616,109.55177766383903,109.9695816040039,4461190.0,0.0,0.0,-0.9675216674804688,0.9675216674804688,0.0,63.00824806633518,106.31931387489432,111.85332836427868,65.9605741205001,-34.03942587949991,1.0061117170608185,0.7630509449010761,0.02416541392810334,-63731419.0,-1.0
3961,2018-09-25,IBM,109.88159769839694,110.24809005955832,108.7454795680473,109.14861297607422,4599785.0,0.0,0.0,-0.8209686279296875,0.8209686279296875,0.0,52.637443869449555,106.37060835873758,111.85332836427868,50.6683656019102,-49.3316343980898,0.9377638839928153,0.797993532719424,0.01596489923635369,-68331204.0,-1.0
3962,2018-09-26,IBM,111.7067434851878,112.40308728039211,110.9297823536582,111.12769317626952,7742387.0,0.0,0.0,1.9790802001952983,0.0,1.9790802001952983,67.51150032591457,106.37060835873758,112.40308728039211,78.85787715653063,-21.142122843469373,1.0314035876275653,0.8446755437010522,0.017858202293123293,-60588817.0,1.0
3963,2018-09-27,IBM,111.42087404039758,111.6994138831266,110.79783578325208,111.04705810546876,3637570.0,0.0,0.0,-0.08063507080075283,0.08063507080075283,0.0,66.52926510441856,106.46592277495152,112.40308728039211,77.16032335501676,-22.839676644983246,1.0865817134584006,0.8930567776525219,0.021371014995147597,-64226387.0,-1.0
3964,2018-09-28,IBM,110.79781228452318,111.14232232480448,110.52661942783476,110.83446502685548,3457867.0,0.0,0.0,-0.21259307861328125,0.21259307861328125,0.0,63.709487161049196,106.46592277495152,112.40308728039211,73.57960602069885,-26.420393979301153,1.1004707492090375,0.9345395719638251,0.02210342601379467,-67684254.0,-1.0
3965,2018-10-01,IBM,111.2009682492205,112.45436815115708,111.2009682492205,112.14652252197266,3930240.0,0.0,0.0,1.3120574951171733,0.0,1.3120574951171733,72.12333496230798,107.0376388548683,112.45436815115708,94.31676178842193,-5.683238211578067,1.2034770503425989,0.9883270676395799,0.029886840635582335,-63754014.0,1.0
3966,2018-10-02,IBM,112.13922097223058,112.7622593454038,111.78006373067248,112.6962890625,3169275.0,0.0,0.0,0.5497665405273438,0.0,0.5497665405273438,74.9331320869094,107.83661794123527,112.7622593454038,98.66067629592412,-1.339323704075884,1.3143211749725765,1.0535258891061794,0.031463872472529575,-60584739.0,1.0
3967,2018-10-03,IBM,112.87953474317769,113.14340416088729,111.9999505192585,112.30780792236328,3467804.0,0.0,0.0,-0.38848114013671875,0.38848114013671875,0.0,69.24267047701998,108.0931388176002,113.14340416088729,83.45440918991123,-16.54559081008876,1.3551968947717796,1.1138600902392994,0.013695527516420558,-64052543.0,-1.0
3968,2018-10-04,IBM,111.18630397711182,111.99991768333682,110.21143223553462,110.90777587890624,4432843.0,0.0,0.0,-1.4000320434570455,1.4000320434570455,0.0,52.62466496306637,108.0931388176002,113.14340416088729,55.73245898945301,-44.26754101054699,1.260094724255822,1.143107017042604,-0.000264360540461972,-68485386.0,-1.0
3969,2018-10-05,IBM,110.60727306967796,111.25962892323469,108.3863360947657,109.23660278320312,4813901.0,0.0,0.0,-1.6711730957031108,1.6711730957031108,0.0,39.55107752309949,108.0931388176002,113.14340416088729,22.641661138118923,-77.35833886188107,1.0379114693595284,1.122067907505989,-0.00666528698308777,-73299287.0,-1.0
3970,2018-10-08,IBM,108.848085071778,109.2658889149806,107.88054856562096,108.7674560546875,3388308.0,0.0,0.0,-0.469146728515625,0.469146728515625,0.0,36.60539653666916,107.88054856562096,113.14340416088729,16.852210230968,-83.147789769032,0.8145834084696304,1.0605710076987171,-0.003492091296389388,-76687595.0,-1.0
3971,2018-10-09,IBM,108.54026367288172,108.74550974714994,107.6973321781728,107.924560546875,3809950.0,0.0,0.0,-0.8428955078125,0.8428955078125,0.0,31.709524334493437,107.6973321781728,113.14340416088729,4.172335022809269,-95.82766497719074,0.563088751497105,0.9610745564583947,-0.028823892027649123,-80497545.0,-1.0
3972,2018-10-10,IBM,108.11512604482212,108.25439012596148,104.45021345792314,104.5894775390625,5802894.0,0.0,0.0,-3.3350830078125,3.3350830078125,0.0,19.687865378927015,104.45021345792314,113.14340416088729,1.6019904071801132,-98.39800959281989,0.0935853045108388,0.7875767060688835,-0.058151748245983015,-86300439.0,-1.0
3973,2018-10-11,IBM,104.53816240678177,105.68895116646377,101.72350486430663,101.89942169189452,9111183.0,0.0,0.0,-2.690055847167983,2.690055847167983,0.0,14.552993895562622,101.72350486430663,113.14340416088729,1.5404411459263616,-98.45955885407363,-0.4899171252896508,0.5320779397971767,-0.08061610919307438,-95411622.0,-1.0
3974,2018-10-12,IBM,103.43869045012802,103.74654783888695,101.94340318861045,103.24079132080078,6865316.0,0.0,0.0,1.3413696289062642,0.0,1.3413696289062642,25.702156181768785,101.72350486430663,113.14340416088729,13.286338321288472,-86.71366167871153,-0.8344902024537504,0.2587643113469912,-0.07941156801742999,-88546306.0,1.0
3975,2018-10-15,IBM,102.89626996278967,104.27428698232816,102.72035314537902,103.44601440429688,5193913.0,0.0,0.0,0.20522308349609375,0.0,0.20522308349609375,27.375006711962314,101.72350486430663,113.14340416088729,15.083403936022407,-84.9165960639776,-1.078573932004815,-0.008703337323370168,-0.08208144860096533,-83352393.0,1.0
3976,2018-10-16,IBM,104.7653870443543,106.61250781929144,103.775856386505,106.37062072753906,9095493.0,0.0,0.0,2.9246063232421875,0.0,2.9246063232421875,46.99790249780527,101.72350486430663,113.14340416088729,40.69314222958051,-59.3068577704195,-1.0242142535083474,-0.21180552056036567,-0.05286531101139924,-74256900.0,1.0
3977,2018-10-17,IBM,99.60515730626028,100.5287175214842,97.79468961895051,98.2564697265625,20359344.0,0.0,0.0,-8.114151000976562,8.114151000976562,0.0,25.200365877691084,97.79468961895051,113.14340416088729,3.0085914123315014,-96.9914085876685,-1.617235505436497,-0.49289151753559207,-0.1140705063471561,-94616244.0,-1.0
3978,2018-10-18,IBM,97.2889520790392,97.78005567568468,95.3172258602597,95.69104766845705,10472238.0,0.0,0.0,-2.5654220581054545,2.5654220581054545,0.0,21.553567522448148,95.3172258602597,113.14340416088729,2.097038422330757,-97.90296157766925,-2.2680723142269414,-0.8479276768738622,-0.12400198074293212,-105088482.0,-1.0
3979,2018-10-19,IBM,95.76435146884322,96.6732531965948,93.7926251647214,94.62822723388672,8150014.0,0.0,0.0,-1.0628204345703267,1.0628204345703267,0.0,20.159050094784106,93.7926251647214,113.14340416088729,4.318183104312662,-95.68181689568735,-2.836923611458971,-1.245726863790884,-0.129995030992466,-113238496.0,-1.0
3980,2018-10-22,IBM,94.98005623568372,95.61042390932084,94.11513668548648,95.30256652832033,5982597.0,0.0,0.0,0.674339294433608,0.0,0.674339294433608,23.769807227503023,93.7926251647214,113.14340416088729,7.803000405813649,-92.19699959418635,-3.196481765444233,-1.635877844121554,-0.11695200753745527,-107255899.0,1.0
3981,2018-10-23,IBM,94.56957283594345,96.68056877495044,94.1224572662779,96.17481231689452,6760926.0,0.0,0.0,0.8722457885741903,0.0,0.8722457885741903,28.58974558089095,93.7926251647214,111.99991768333682,13.08369791794981,-86.9163020820502,-3.372178868589785,-1.9831380490152006,-0.08045422369592814,-100494973.0,1.0
3982,2018-10-24,IBM,96.14548993554142,96.52664109033113,93.08895131728288,93.2428741455078,5972974.0,0.0,0.0,-2.9319381713867188,2.9319381713867188,0.0,22.959360631485794,93.08895131728288,111.25962892323469,0.8470945969263346,-99.15290540307366,-3.705290711010008,-2.3275685814141625,-0.08495188100832274,-106467947.0,-1.0
3983,2018-10-25,IBM,93.27219761658604,93.66800753168982,91.72559900645037,92.68580627441406,10778298.0,0.0,0.0,-0.5570678710937358,0.5570678710937358,0.0,22.00912400601254,91.72559900645037,109.2658889149806,5.474295310801712,-94.52570468919829,-3.9684887002184155,-2.6557526051750133,-0.10223657637017858,-117246245.0,-1.0
3984,2018-10-26,IBM,91.77690488321,92.19470291252036,90.67742776476084,91.46904754638672,9170282.0,0.0,0.0,-1.2167587280273438,1.2167587280273438,0.0,19.93024644935548,90.67742776476084,108.74550974714994,4.381316082124666,-95.61868391787533,-4.226536382885655,-2.969909360717142,-0.1157798773290647,-126416527.0,-1.0
3985,2018-10-29,IBM,87.47430548567179,90.85336061209163,86.71199723798988,87.69419860839844,21391118.0,0.0,0.0,-3.7748489379882812,3.7748489379882812,0.0,14.89422928424267,86.71199723798988,108.25439012596148,4.55938843709875,-95.44061156290124,-4.681672387061212,-3.3122619659859565,-0.1755787640553399,-147807645.0,-1.0
3986,2018-10-30,IBM,88.30988718911053,89.05753655242326,84.40308803984843,84.58633422851562,22445696.0,0.0,0.0,-3.1078643798828125,3.1078643798828125,0.0,12.011080796110036,84.40308803984843,106.61250781929144,0.8250831876157797,-99.17491681238421,-5.232828837878159,-3.6963753403643977,-0.13912707769869437,-170253341.0,-1.0
3987,2018-10-31,IBM,85.38529087316142,85.39262025339244,83.62612847787196,84.60832977294922,22640670.0,0.0,0.0,0.02199554443359375,0.0,0.02199554443359375,12.14995178975498,83.62612847787196,106.61250781929144,4.2729708776162845,-95.72702912238371,-5.603258562604694,-4.077751984812457,-0.11581770881960007,-147612671.0,1.0
3988,2018-11-01,IBM,84.65962678099272,85.7591038968476,84.37376343280624,85.6344985961914,14253528.0,0.0,0.0,1.0261688232421875,0.0,1.0261688232421875,19.029244047700217,83.62612847787196,106.61250781929144,8.737218195562175,-91.26278180443782,-5.747766861745987,-4.411754960199163,-0.09504276789911825,-133359143.0,1.0
3989,2018-11-02,IBM,86.1329284842294,86.30884529651547,83.95596816875309,84.78424072265625,11079964.0,0.0,0.0,-0.8502578735351562,0.8502578735351562,0.0,17.70383803343853,83.62612847787196,106.61250781929144,5.038254296523649,-94.96174570347635,-5.863310836890861,-4.702066135537502,-0.11036770770006943,-144439107.0,-1.0
3990,2018-11-05,IBM,85.09942135294726,88.52245810396927,85.02612170646262,88.00203704833984,9565252.0,0.0,0.0,3.2177963256835938,0.0,3.2177963256835938,36.896548472901635,83.62612847787196,100.5287175214842,25.888983984507462,-74.11101601549254,-5.630328081045107,-4.887718524639023,-0.08497833342918837,-134873855.0,1.0
3991,2018-11-06,IBM,88.47116606965348,90.75074989534,88.18530264996156,90.24498748779295,10038880.0,0.0,0.0,2.242950439453111,0.0,2.242950439453111,46.86342967853227,83.62612847787196,97.78005567568468,46.763410023359754,-53.236589976640246,-5.204703629516757,-4.95111554561457,-0.03215137548244773,-124834975.0,1.0
3992,2018-11-07,IBM,90.736054109448,91.6669437113204,89.66590046096674,91.50569152832033,12952304.0,0.0,0.0,1.2607040405273722,0.0,1.2607040405273722,51.80071409464672,83.62612847787196,96.68056877495044,60.35925609320664,-39.64074390679336,-4.711355333724356,-4.903163503236527,-0.01273242143030806,-111882671.0,1.0
3993,2018-11-08,IBM,91.05290564277637,92.34453768295153,91.03063152866136,91.58737182617188,10874634.0,1.500956,0.0,0.08168029785154829,0.0,0.08168029785154829,52.133205973197654,83.62612847787196,96.68056877495044,60.98494586613261,-39.01505413386738,-4.264622424842173,-4.775455287557657,0.0012935991240659028,-101008037.0,1.0
3994,2018-11-09,IBM,91.75810534994922,92.47073481777014,90.53327789510683,91.70614624023438,7282043.0,0.0,0.0,0.1187744140625,0.0,0.1187744140625,52.68089052484262,83.62612847787196,96.68056877495044,61.894785057699345,-38.105214942300655,-3.856543441264634,-4.591672918299053,0.04574929351656931,-93725994.0,1.0
3995,2018-11-12,IBM,91.67644230399358,91.72840733365469,89.56083410201299,89.74641418457031,5626539.0,0.0,0.0,-1.9597320556640625,1.9597320556640625,0.0,43.257997367039636,83.62612847787196,96.52664109033113,47.44219001644518,-52.557809983554826,-3.649206128756674,-4.403179560390577,0.06100370707772229,-99352533.0,-1.0
3996,2018-11-13,IBM,89.96167943366663,90.7485360899044,89.00408816455617,89.70186614990234,4272282.0,0.0,0.0,-0.04454803466796875,0.04454803466796875,0.0,43.056000513799304,83.62612847787196,93.66800753168982,60.50399172772774,-39.49600827227226,-3.448729660141268,-4.212289580340715,0.06020135831332318,-103624815.0,-1.0
3997,2018-11-14,IBM,89.90229356523328,90.5109988164286,88.90758863069404,89.2267837524414,4981366.0,0.0,0.0,-0.4750823974609375,0.4750823974609375,0.0,40.716429774155465,83.62612847787196,92.47073481777014,63.32283268849165,-36.677167311508356,-3.290257750224171,-4.027883214317407,0.04194904174297065,-108606181.0,-1.0
3998,2018-11-15,IBM,88.82593384667285,90.1472625732422,88.71458698525917,90.1472625732422,5447463.0,0.0,0.0,0.9204788208007955,0.0,0.9204788208007955,47.137968583712386,83.62612847787196,92.47073481777014,73.73006603983369,-26.26993396016632,-3.055174521704174,-3.83334147579476,0.06325493753172018,-103158718.0,1.0
3999,2018-11-16,IBM,89.73896880587422,90.45159211473772,89.47915557107532,90.24374389648438,4263810.0,0.0,0.0,0.09648132324217329,0.0,0.09648132324217329,47.82152365894954,83.62612847787196,92.47073481777014,74.82091530473475,-25.179084695265242,-2.8284791855771374,-3.632369017751236,0.025473351791994947,-98894908.0,1.0
4000,2018-11-19,IBM,90.28829886546404,90.69657263179644,88.90758249493648,89.30843353271484,4321235.0,0.0,0.0,-0.9353103637695312,0.9353103637695312,0.0,41.77863840352338,83.62612847787196,92.47073481777014,64.24599169789961,-35.754008302100395,-2.6932471514127485,-3.444544644483539,-0.01037790553414164,-103216143.0,-1.0
4001,2018-11-20,IBM,87.95740805290309,88.6997282498338,86.6286567960659,86.99981689453125,6520555.0,0.0,0.0,-2.3086166381835938,2.3086166381835938,0.0,30.722162908003384,83.95596816875309,92.47073481777014,35.74788190031663,-64.25211809968337,-2.740767002889328,-3.3037891161646966,-0.049241468574602765,-109736698.0,-1.0
4002,2018-11-21,IBM,87.30415547338755,88.71456248435936,87.14084362896867,88.01678466796875,5581247.0,0.0,0.0,1.0169677734375,0.0,1.0169677734375,38.9360811266933,83.95596816875309,92.47073481777014,47.69145963247796,-52.30854036752204,-2.665638209408556,-3.176158934813469,-0.03898558378746708,-104155451.0,1.0
4003,2018-11-23,IBM,87.6605035448908,87.84608364151529,86.78456217140202,86.99241638183594,2442096.0,0.0,0.0,-1.0243682861328125,1.0243682861328125,0.0,34.220461592620225,85.02612170646262,92.47073481777014,26.412315132760117,-73.58768486723987,-2.6581149642999407,-3.0725501407107636,-0.05140037011314702,-106597547.0,-1.0
4004,2018-11-26,IBM,87.86835081512142,89.2639128886386,87.63823434147234,88.751708984375,5241611.0,0.0,0.0,1.7592926025390625,0.0,1.7592926025390625,46.952106603422735,86.6286567960659,92.47073481777014,36.34070240797247,-63.65929759202753,-2.4815863456869494,-2.954357381706001,-0.011083509121039947,-101355936.0,1.0
4005,2018-11-27,IBM,87.87575118105505,89.10800103607825,87.86832845308228,89.10057830810547,5129375.0,0.0,0.0,0.34886932373046875,0.0,0.34886932373046875,49.201756859288835,86.6286567960659,92.47073481777014,42.3123673264204,-57.6876326735796,-2.287170230114924,-2.820919951387786,-0.006703180966068811,-96226561.0,1.0
4006,2018-11-28,IBM,89.82807808428235,91.37210071651384,89.24164094318688,91.30529022216795,5339307.0,0.0,0.0,2.204711914062486,0.0,2.204711914062486,61.199955741393296,86.6286567960659,92.47073481777014,80.05085534167172,-19.94914465832828,-1.9329108389567864,-2.643318128901586,0.02329464744009302,-90887254.0,1.0
4007,2018-11-29,IBM,90.88958558938374,91.39436080734976,90.11757434168298,90.1769561767578,5439305.0,0.0,0.0,-1.1283340454101562,1.1283340454101562,0.0,53.70883425321347,86.6286567960659,92.47073481777014,60.73693927930114,-39.26306072069885,-1.72333926444729,-2.459322356010727,0.0003293899633554087,-96326559.0,-1.0
4008,2018-11-30,IBM,90.31056575335748,92.5597887241065,90.1769447933746,92.24801635742188,7585174.0,0.0,0.0,2.0710601806640767,0.0,2.0710601806640767,63.238747816272216,86.6286567960659,92.5597887241065,94.74345925082773,-5.256540749172282,-1.3742930390726684,-2.2423164926231154,0.022209544666459413,-88741385.0,1.0
4009,2018-12-03,IBM,93.28727080696098,93.97020334533984,92.31483406457478,93.02003479003906,6115334.0,0.0,0.0,0.7720184326171875,0.0,0.7720184326171875,66.22906202626176,86.6286567960659,93.97020334533984,87.05765128745597,-12.942348712544039,-1.0235767990509999,-1.9985685539086924,0.0415593590717791,-82626051.0,1.0
4010,2018-12-04,IBM,92.41132645988112,92.73052154889486,90.06559621634827,90.26602172851562,6276732.0,0.0,0.0,-2.7540130615234375,2.7540130615234375,0.0,49.61643491458542,86.6286567960659,93.97020334533984,49.544941355843505,-50.455058644156495,-0.9568277748928864,-1.7902203981055314,0.03754266331323386,-88902783.0,-1.0
4011,2018-12-06,IBM,88.87047609988785,91.98078918457033,88.55869777933101,91.98078918457033,7257148.0,0.0,0.0,1.7147674560547017,0.0,1.7147674560547017,57.309630445395925,86.6286567960659,93.97020334533984,72.90197443526037,-27.09802556473963,-0.7568369443726795,-1.583543707358961,0.04503691576050217,-81645635.0,1.0
4012,2018-12-07,IBM,91.9733739040486,92.0847207744226,88.23950979982423,88.5884017944336,7342502.0,0.0,0.0,-3.392387390136733,3.392387390136733,0.0,42.49720042287672,86.6286567960659,93.97020334533984,26.6938986930691,-73.3061013069309,-0.862141846803695,-1.439263335247908,0.018346259122087094,-88988137.0,-1.0
4013,2018-12-10,IBM,88.88531273168222,90.32541090508218,87.97968062451227,89.9171371459961,6850777.0,0.0,0.0,1.3287353515625,0.0,1.3287353515625,48.51156005253646,86.6286567960659,93.97020334533984,44.792746703423376,-55.20725329657662,-0.82882472696771,-1.3171756135918686,0.013131332060617229,-82137360.0,1.0
4014,2018-12-11,IBM,91.4908615368336,91.90656399911369,89.07832640560687,89.7389907836914,5275083.0,0.0,0.0,-0.1781463623046875,0.1781463623046875,0.0,47.73912629385176,86.6286567960659,93.97020334533984,42.366195824681,-57.633804175319,-0.8074873801920859,-1.2152379669119122,0.007165076677486226,-87412443.0,-1.0
4015,2018-12-12,IBM,90.94154266217356,91.21620141515297,89.82064538656665,89.93941497802734,3724283.0,0.0,0.0,0.2004241943359375,0.0,0.2004241943359375,48.797474271141944,86.78456217140202,93.97020334533984,43.90495893488136,-56.09504106511864,-0.7655796955041438,-1.1253063126303586,-0.014959431603766893,-83688160.0,1.0
4016,2018-12-13,IBM,90.0136506487634,90.40707900393188,89.20451982619791,89.6202163696289,4177306.0,0.0,0.0,-0.3191986083984375,0.3191986083984375,0.0,47.046662773229656,86.78456217140202,93.97020334533984,39.4627859864719,-60.53721401352809,-0.7494846213273831,-1.0501419743697635,-0.006173858940610177,-87865466.0,-1.0
4017,2018-12-14,IBM,88.70717002712104,89.90230058773614,88.66262772527828,89.00409698486328,4763693.0,0.0,0.0,-0.616119384765625,0.616119384765625,0.0,43.56540937706441,87.63823434147234,93.97020334533984,21.57089907668035,-78.42910092331965,-0.7774825099015032,-0.9956100814761115,-0.035165193796577565,-92629159.0,-1.0
4018,2018-12-17,IBM,88.38797569849878,88.91502508737054,85.41869997062075,86.18328857421875,7713727.0,0.0,0.0,-2.8208084106445312,2.8208084106445312,0.0,31.32178613387876,85.41869997062075,93.97020334533984,8.94098464438852,-91.05901535561148,-1.0155797316004254,-0.9996040115009744,-0.07349756674733487,-100342886.0,-1.0
4019,2018-12-18,IBM,86.77712517108658,87.76441325539874,86.12388949931712,86.59154510498047,6579549.0,0.0,0.0,0.40825653076171875,0.0,0.40825653076171875,34.400546158990196,85.41869997062075,93.97020334533984,13.715075384604472,-86.28492461539552,-1.1579821081801214,-1.031279630836804,-0.04070719583263038,-93763337.0,1.0
4020,2018-12-19,IBM,86.96270399558009,89.2787434244758,86.08676870261017,86.42823791503906,7300871.0,0.0,0.0,-0.16330718994140625,0.16330718994140625,0.0,33.70320056082835,85.41869997062075,93.97020334533984,11.805385558319736,-88.19461444168026,-1.2693818986218872,-1.0789000843938206,-0.06036642345380849,-101064208.0,-1.0
4021,2018-12-20,IBM,85.88636596961491,86.44310630770092,82.91709009045654,83.8969497680664,8843302.0,0.0,0.0,-2.5312881469726562,2.5312881469726562,0.0,24.73540137707512,82.91709009045654,93.97020334533984,8.865010744162612,-91.13498925583738,-1.5441211661211156,-1.1719443007392796,-0.05295785826742361,-109907510.0,-1.0
4022,2018-12-21,IBM,83.51092976401124,85.57457884163014,81.98175274107471,82.35291290283203,10864279.0,0.0,0.0,-1.544036865234375,1.544036865234375,0.0,20.833767378884076,81.98175274107471,93.97020334533984,3.095981073861781,-96.90401892613822,-1.8649469385552067,-1.310544828302465,-0.0841243892238498,-120771789.0,-1.0
4023,2018-12-24,IBM,81.58090400733101,82.39745164749846,79.7993363644726,79.8512954711914,3997184.0,0.0,0.0,-2.501617431640625,2.501617431640625,0.0,16.089397986713905,79.7993363644726,92.73052154889486,0.401812409131724,-99.59818759086828,-2.294612430723575,-1.507358348786687,-0.11018282271898394,-124768973.0,-1.0
4024,2018-12-26,IBM,80.17049150725268,82.68695068359375,78.64131453629122,82.68695068359375,6951507.0,0.0,0.0,2.8356552124023438,0.0,2.8356552124023438,35.346234540067655,78.64131453629122,92.0847207744226,30.093832438294804,-69.90616756170519,-2.3788893956128447,-1.6816645581519187,-0.08063721891236908,-117817466.0,1.0
4025,2018-12-27,IBM,81.64769823286117,84.46109008789062,81.2616926502568,84.46109008789062,6323698.0,0.0,0.0,1.774139404296875,0.0,1.774139404296875,44.535221134054474,78.64131453629122,92.0847207744226,43.290929757757176,-56.709070242242824,-2.27628171595984,-1.800587989713503,-0.05756654570504516,-111493768.0,1.0
4026,2018-12-28,IBM,84.78771601253322,85.21826393175488,83.51092956139983,83.90435791015625,5352905.0,0.0,0.0,-0.556732177734375,0.556732177734375,0.0,42.35555174043065,78.64131453629122,91.90656399911369,39.67541951333349,-60.32458048666651,-2.2143622350713628,-1.8833428387850752,-0.057297801421145045,-116846673.0,-1.0
4027,2018-12-31,IBM,84.1270573517739,84.88422318352102,83.45154747183804,84.37944793701172,5212009.0,0.0,0.0,0.47509002685546875,0.0,0.47509002685546875,45.00576996517469,78.64131453629122,91.90656399911369,43.25688270546544,-56.74311729453455,-2.1027160044828292,-1.9272174719246262,-0.020930283202799993,-111634664.0,1.0
4028,2019-01-02,IBM,83.14719946998153,86.09420690512906,82.90966026348438,85.52262115478516,4434935.0,0.0,0.0,1.1431732177734375,0.0,1.1431732177734375,51.23095716394664,78.64131453629122,91.21620141515297,54.72261249571431,-45.27738750428569,-1.9000880058291756,-1.921791578705536,-0.012344437888241688,-107199729.0,1.0
4029,2019-01-03,IBM,85.01782848825293,85.27764175537797,83.65195759671165,83.81526947021484,4546648.0,0.0,0.0,-1.7073516845703125,1.7073516845703125,0.0,42.868523781482764,78.64131453629122,90.40707900393188,43.97466010945173,-56.025339890548274,-1.8558794460425645,-1.9086091521729418,-0.03023280941343298,-111746377.0,-1.0
4030,2019-01-04,IBM,85.29992259036192,87.2151052899434,84.95103060631071,87.08891296386719,4683779.0,0.0,0.0,3.2736434936523438,0.0,3.2736434936523438,58.02625552637282,78.64131453629122,89.90230058773614,75.0165073376682,-24.9834926623318,-1.538948136789685,-1.8346769490962906,0.03804623653928996,-107062598.0,1.0
4031,2019-01-07,IBM,87.2225329113029,88.20982115857478,86.60641078147265,87.70503997802734,3923755.0,0.0,0.0,0.6161270141601562,0.0,0.6161270141601562,60.31288141071047,78.64131453629122,89.2787434244758,85.20597916103169,-14.794020838968306,-1.2239525271367455,-1.7125320647043818,0.0649901367971073,-103138843.0,1.0
4032,2019-01-08,IBM,88.82593323045181,89.50144304737657,88.3211580310276,88.9521255493164,4982726.0,0.0,0.0,1.2470855712890625,0.0,1.2470855712890625,64.79236696467503,78.64131453629122,89.50144304737657,94.9418876811683,-5.0581123188317045,-0.8637303084495613,-1.5427717134534178,0.11397222830790987,-98156117.0,1.0
4033,2019-01-09,IBM,89.75381936980398,90.11755673443396,88.98180827293943,89.59050750732422,3800850.0,0.0,0.0,0.6383819580078125,0.0,0.6383819580078125,66.9928539440001,78.64131453629122,90.11755673443396,95.4074755655206,-4.592524434479411,-0.5207367865208141,-1.338364728066897,0.08349028192063002,-94355267.0,1.0
4034,2019-01-10,IBM,89.13770437873654,90.45903307766476,89.041202977668,90.40707397460938,4089860.0,0.0,0.0,0.8165664672851562,0.0,0.8165664672851562,69.78044394370174,78.64131453629122,90.45903307766476,99.56032881580761,-0.4396711841923946,-0.18093614047958795,-1.1068790105494353,0.07039909004881806,-90265407.0,1.0
4035,2019-01-11,IBM,90.2511880502514,90.28087896734657,89.22678624684336,90.162109375,3893630.0,0.0,0.0,-0.244964599609375,0.244964599609375,0.0,67.79845860942382,78.64131453629122,90.45903307766476,97.4874701777231,-2.512529822276895,0.06781005164060616,-0.8719411981114269,0.07458195999240558,-94159037.0,-1.0
4036,2019-01-14,IBM,89.45689940581606,89.56082352890346,88.90015922387012,89.3678207397461,5469220.0,0.0,0.0,-0.7942886352539062,0.7942886352539062,0.0,61.2859195280848,78.64131453629122,90.45903307766476,90.76630286887985,-9.23369713112015,0.19856184890382167,-0.6578405887083771,0.05911833894028473,-99628257.0,-1.0
4037,2019-01-15,IBM,89.79094787996002,90.51100000053538,89.68702374770673,90.36253356933594,3668845.0,0.0,0.0,0.9947128295898438,0.0,0.9947128295898438,66.00457505424532,78.64131453629122,90.51100000053538,98.74919658446997,-1.2508034155300343,0.3780902138048958,-0.45065442820572255,0.05659218986975567,-95959412.0,1.0
4038,2019-01-16,IBM,90.2511928703816,90.56296528842964,89.69445260131755,90.2808837890625,4017791.0,0.0,0.0,-0.0816497802734375,0.0816497802734375,0.0,65.25131694731536,81.2616926502568,90.56296528842964,96.9672806040599,-3.032719395940108,0.5079242469813323,-0.25893869316831153,0.07714124597720606,-99977203.0,-1.0
4039,2019-01-17,IBM,89.4940205208703,90.86731426912968,89.48659779174179,90.7040023803711,5261275.0,0.0,0.0,0.42311859130859375,0.0,0.42311859130859375,67.47102160652585,82.90966026348438,90.86731426912968,97.94773825749739,-2.0522617425026133,0.6376108073580582,-0.07962879306303752,0.04151032885212147,-94715928.0,1.0
4040,2019-01-18,IBM,91.50571407092944,92.5820809945213,91.09001750047264,91.91399383544922,6284891.0,0.0,0.0,1.209991455078125,0.0,1.209991455078125,73.13381747742453,82.90966026348438,92.5820809945213,93.09286498540821,-6.907135014591795,0.8284744017066572,0.10199184589090148,0.047989874452783354,-88431037.0,1.0
4041,2019-01-22,IBM,91.5279583029942,91.89911837285592,90.22147533099805,90.94894409179688,10514810.0,0.0,0.0,-0.9650497436523438,0.9650497436523438,0.0,63.0352601478892,82.90966026348438,92.5820809945213,83.11553076383443,-16.884469236165575,0.8915860769681103,0.2599106921063433,0.022448238646904484,-98945847.0,-1.0
4042,2019-01-23,IBM,97.5184941542974,100.21311069645476,96.73163747568896,98.64682006835938,23078630.0,0.0,0.0,7.6978759765625,0.0,7.6978759765625,83.72240273056124,83.65195759671165,100.21311069645476,90.54238180963569,-9.457618190364315,1.544947597574307,0.5169180731999361,0.10108562629020468,-75867217.0,1.0
4043,2019-01-24,IBM,98.4538261173648,98.88436814099596,97.5630393030136,98.3795928955078,6613753.0,0.0,0.0,-0.2672271728515767,0.2672271728515767,0.0,81.88677654947978,84.95103060631071,100.21311069645476,87.98644883189274,-12.013551168107247,2.01791701904601,0.817117862369151,0.08818468036182092,-82480970.0,-1.0
4044,2019-01-25,IBM,98.63198611954223,99.79742581520772,98.30536230421784,99.44853973388672,5969940.0,0.0,0.0,1.0689468383789205,0.0,1.0689468383789205,83.5513265155385,86.60641078147265,100.21311069645476,94.38092287369263,-5.619077126307366,2.4507530142116565,1.1438448927376523,0.10299703970170926,-76511030.0,1.0
4045,2019-01-28,IBM,98.80269278823596,100.07206226843869,98.41668721913612,99.67121124267578,5604154.0,0.0,0.0,0.2226715087890625,0.0,0.2226715087890625,83.90679418628415,88.3211580310276,100.21311069645476,95.44314151741945,-4.556858482580547,2.7797036947239206,1.4710166531349063,0.115291952043173,-70906876.0,1.0
4046,2019-01-29,IBM,99.68609886903576,100.5174921855877,99.1738948536947,99.71578979492188,5268807.0,0.0,0.0,0.04457855224609375,0.0,0.04457855224609375,83.9867331262951,88.90015922387012,100.5174921855877,93.09908398676649,-6.900916013233516,3.0093071757064394,1.7786747576492132,0.10350812284838273,-65638069.0,1.0
4047,2019-01-30,IBM,99.4707812757168,100.2353756208486,98.91404702279983,99.75286865234376,4707941.0,0.0,0.0,0.03707885742188921,0.0,0.03707885742188921,84.06270950647846,88.90015922387012,100.5174921855877,93.41825240127328,-6.5817475987267215,3.157859701561648,2.0545117464317,0.10491683804748919,-60930128.0,1.0
4048,2019-01-31,IBM,99.80483636574868,100.00525596302911,99.27778116445872,99.78256225585938,5108664.0,0.0,0.0,0.02969360351561079,0.0,0.02969360351561079,84.13227562523413,88.90015922387012,100.5174921855877,93.67384982293159,-6.326150177068414,3.240628723505722,2.291735141846505,0.10008995895701434,-55821464.0,1.0
4049,2019-02-01,IBM,100.19083990348184,100.36156858270812,98.98827495265128,99.5450210571289,3981076.0,0.0,0.0,-0.23754119873046875,0.23754119873046875,0.0,80.87379564845568,88.90015922387012,100.5174921855877,91.62913612217743,-8.370863877822575,3.249596850503309,2.4833074835778657,0.08302356260724864,-59802540.0,-1.0
4050,2019-02-04,IBM,99.48562867508488,100.36156988790306,98.72104616295483,100.35414123535156,4149064.0,0.0,0.0,0.8091201782226562,0.0,0.8091201782226562,83.40057571093611,89.48659779174179,100.5174921855877,98.51915044778899,-1.4808495522110074,3.28413591749063,2.643473170360419,0.1034118343810766,-55653476.0,1.0
4051,2019-02-05,IBM,100.42096745065555,100.82181855297438,100.15373733175387,100.62139892578124,5647249.0,0.0,0.0,0.2672576904296733,0.0,0.2672576904296733,84.19629982152857,89.48659779174179,100.82181855297438,98.2318859825069,-1.768114017493104,3.295090091517949,2.773796554591925,0.020016649863153546,-50006227.0,1.0
4052,2019-02-06,IBM,100.37643024784325,101.43794575688224,100.33931067543608,101.19297790527344,5104166.0,0.0,0.0,0.5715789794922017,0.0,0.5715789794922017,85.86802986352617,89.48659779174179,101.43794575688224,97.95029102722701,-2.049708972772986,3.311717581310589,2.8813807599356585,0.02859724183605672,-44902061.0,1.0
4053,2019-02-07,IBM,100.29181112529405,100.98270664351035,99.21792777713488,100.0214614868164,4580852.0,1.500956,0.0,-1.1715164184570312,1.1715164184570312,0.0,68.68533038774368,90.22147533099805,101.43794575688224,87.37139031903456,-12.628609680965438,3.1935501444186656,2.9438146368322604,0.005760987084000968,-49482913.0,-1.0
4054,2019-02-08,IBM,99.3831514484634,100.41197967529295,99.27050724701246,100.41197967529295,3399291.0,0.0,0.0,0.3905181884765483,0.0,0.3905181884765483,70.92325990052379,90.22147533099805,101.43794575688224,90.85303983665244,-9.146960163347567,3.095727533462508,2.97419721615831,0.00743212030215612,-46083622.0,1.0
4055,2019-02-11,IBM,100.84753416941167,101.49336245927567,100.56216009730278,100.62224578857422,3237475.0,0.0,0.0,0.2102661132812642,0.0,0.2102661132812642,72.1593601920392,96.73163747568896,101.49336245927567,81.70585924840003,-18.29414075159996,3.0005803056137665,2.9794738340494016,0.009090395768980963,-42846147.0,1.0
4056,2019-02-12,IBM,101.49336570876028,102.28188705291194,101.27559252709987,102.16924285888672,3469791.0,0.0,0.0,1.5469970703125,0.0,1.5469970703125,79.54234476141868,97.5630393030136,102.28188705291194,97.6128877218459,-2.3871122781541043,3.015247283072128,2.9866285238539474,0.024223606189857527,-39376356.0,1.0
4057,2019-02-13,IBM,102.82257847094124,103.5735476973592,102.43957865191996,103.27315521240234,4448638.0,0.0,0.0,1.103912353515625,0.0,1.103912353515625,83.20866907489273,98.30536230421784,103.5735476973592,94.29798948708337,-5.702010512916632,3.080438096653893,3.005390438413937,0.03498199362321941,-34927718.0,1.0
4058,2019-02-14,IBM,103.01032267197247,103.33323682714314,102.2893902416542,102.49215698242188,2917712.0,0.0,0.0,-0.7809982299804688,0.7809982299804688,0.0,72.5890380504815,98.41668721913612,103.5735476973592,79.03005676605106,-20.96994323394894,3.0341069596422585,3.0111337426596014,0.029606060594448147,-37845430.0,-1.0
4059,2019-02-15,IBM,103.31821389405914,103.77630585642832,103.17553285269116,103.65615844726562,4020929.0,0.0,0.0,1.16400146484375,0.0,1.16400146484375,77.52239249863082,98.72104616295483,103.77630585642832,97.62331875219364,-2.3766812478063613,3.0560857359922835,3.0201241413261384,0.03290364673810653,-33824501.0,1.0
4060,2019-02-19,IBM,103.49094744909225,104.15930938720705,103.15300288388391,104.15930938720705,3541442.0,0.0,0.0,0.5031509399414205,0.0,0.5031509399414205,79.373909208973,98.72104616295483,104.15930938720705,100.0,-0.0,3.078615784056794,3.03182246987227,0.035160616918428866,-30283059.0,1.0
4061,2019-02-20,IBM,104.20434967603336,104.5648158364143,103.04785907230008,103.63361358642578,3976892.0,0.0,0.0,-0.5256958007812642,0.5256958007812642,0.0,72.20386062918145,98.72104616295483,104.5648158364143,84.06504188182262,-15.934958118177372,3.019247743201049,3.029307524538026,0.02411862692129696,-34259951.0,-1.0
4062,2019-02-21,IBM,103.4984627117106,103.896481029944,103.14551166473196,103.51348114013672,3072416.0,0.0,0.0,-0.1201324462890625,0.1201324462890625,0.0,70.52406901247879,98.72104616295483,104.5648158364143,82.00930640623287,-17.99069359376714,2.9287437241006984,3.009194764450561,0.03491270374789113,-37332367.0,-1.0
4063,2019-02-22,IBM,104.18183882415023,104.6699676926441,103.95655042114936,104.57234191894533,3256930.0,0.0,0.0,1.058860778808608,0.0,1.058860778808608,76.16380073551814,98.72104616295483,104.6699676926441,98.35893324173894,-1.6410667582610678,2.908927546487149,2.989141320857879,0.04143292719759062,-34075437.0,1.0
4064,2019-02-25,IBM,105.13556298047996,105.48851397272615,104.62490053525126,104.73004150390624,3341133.0,0.0,0.0,0.15769958496090908,0.0,0.15769958496090908,76.92258390663925,99.21792777713488,105.48851397272615,87.90428127192983,-12.095718728070176,2.872831903607448,2.9658794374077933,0.04082393195599354,-30734304.0,1.0
4065,2019-02-26,IBM,104.88774091054132,105.50353233809604,104.73754466368116,104.92529296875,3201178.0,0.0,0.0,0.1952514648437642,0.0,0.1952514648437642,77.92642510276988,99.21792777713488,105.50353233809604,90.80057671878717,-9.199423281212828,2.827388631839028,2.9381812762940407,0.026975340452212837,-27533126.0,1.0
4066,2019-02-27,IBM,104.57233414375176,104.81265294266194,103.9340210447013,104.51226043701172,2647321.0,0.0,0.0,-0.41303253173828125,0.41303253173828125,0.0,70.44684454222346,99.21792777713488,105.50353233809604,84.22948991667496,-15.770510083325027,2.7266155117468713,2.895868123384607,0.01199832833673864,-30180447.0,-1.0
4067,2019-02-28,IBM,104.211868204768,104.42965337123452,103.42335885082372,103.73125457763672,3616859.0,0.0,0.0,-0.781005859375,0.781005859375,0.0,58.248632829349376,99.27050724701246,105.50353233809604,71.56633040039283,-28.433669599607164,2.5542872093684394,2.827551940581374,0.01208968209564909,-33797306.0,-1.0
4068,2019-03-01,IBM,104.61739737563214,105.16559989343332,104.11423815017407,104.5347900390625,3169380.0,0.0,0.0,0.8035354614257812,0.0,0.8035354614257812,65.36758480960667,100.56216009730278,105.50353233809604,80.39527783322754,-19.604722166772454,2.4542631664293424,2.752894185750968,0.008476405116285335,-30627926.0,1.0
4069,2019-03-04,IBM,105.12805216915254,105.19564108240267,103.01032215519795,103.95654296875,3563617.0,0.0,0.0,-0.5782470703125,0.5782470703125,0.0,57.260629473656955,101.27559252709987,105.50353233809604,63.410326577436685,-36.589673422563315,2.3017999685868347,2.6626753423181415,-0.0019466951120352682,-34191543.0,-1.0
4070,2019-03-05,IBM,103.91148421501713,104.18934307910445,103.30319600207466,103.5435028076172,4445814.0,0.0,0.0,-0.4130401611327983,0.4130401611327983,0.0,51.95042556581602,102.2893902416542,105.50353233809604,39.01857877880833,-60.98142122119167,2.123168333849648,2.554773940624443,-0.0008695130439838605,-38637357.0,-1.0
4071,2019-03-06,IBM,103.72375125836976,103.9265180213496,102.67240133729754,102.8676528930664,2895642.0,0.0,0.0,-0.6758499145507955,0.6758499145507955,0.0,44.20974753881592,102.2893902416542,105.50353233809604,17.991197466109536,-82.00880253389047,1.9051051700446777,2.42484018650849,-0.0062390737897799475,-41532999.0,-1.0
4072,2019-03-07,IBM,102.58975978409896,102.80002969820876,101.1028399759198,101.65105438232422,4559305.0,0.0,0.0,-1.2165985107421875,1.2165985107421875,0.0,33.76125935195091,101.1028399759198,105.50353233809604,12.457458083557317,-87.54254191644269,1.615496768257401,2.262971502858272,-0.02793556578168077,-46092304.0,-1.0
4073,2019-03-08,IBM,100.78744895255296,101.56093977081466,100.3143326194546,101.44829559326172,3947186.0,0.0,0.0,-0.2027587890625,0.2027587890625,0.0,32.29357759329811,100.3143326194546,105.50353233809604,21.852367133481508,-78.14763286651849,1.3540108888890785,2.0811793800644334,-0.031335287024803815,-50039490.0,-1.0
4074,2019-03-11,IBM,102.15422796718867,103.43086620564506,102.01153492864032,103.41584777832033,4120508.0,0.0,0.0,1.967552185058608,0.0,1.967552185058608,54.46017705892371,100.3143326194546,105.50353233809604,59.76866042993081,-40.23133957006919,1.290668441025261,1.9230771922565988,-0.01438590398674644,-45918982.0,1.0
4075,2019-03-12,IBM,104.02412805854694,104.91027513262814,103.52848403691348,103.8438949584961,4136616.0,0.0,0.0,0.42804718017576704,0.0,0.42804718017576704,57.918560053084384,100.3143326194546,105.50353233809604,68.01746956013389,-31.982530439866107,1.260478908598671,1.7905575355250134,-0.00639509159710927,-41782366.0,1.0
4076,2019-03-13,IBM,103.6711732395339,104.6248972032184,103.52097699737064,104.05416107177734,3319167.0,0.0,0.0,0.21026611328125,0.0,0.21026611328125,59.65514281221563,100.3143326194546,105.50353233809604,72.06946456286813,-27.93053543713187,1.239235074183199,1.6802930432566503,0.003112914188258875,-38463199.0,1.0
4077,2019-03-14,IBM,104.01662059591456,104.339546747611,103.67868800290256,104.22689056396484,2864576.0,0.0,0.0,0.1727294921875,0.0,0.1727294921875,61.17385097112793,100.3143326194546,105.50353233809604,75.39809906438857,-24.601900935611436,1.2222476981725663,1.5886839742398335,-0.0029454258719283644,-35598623.0,1.0
4078,2019-03-15,IBM,104.66244136960646,105.38337368885868,104.55730041222664,104.7074966430664,7482770.0,0.0,0.0,0.4806060791015625,0.0,0.4806060791015625,65.3601720998914,100.3143326194546,105.50353233809604,84.65975992078336,-15.340240079216638,1.2333486982273456,1.517616919037336,0.007223726885013271,-28115853.0,1.0
4079,2019-03-18,IBM,105.00791181285167,105.41343333363234,104.17433513670083,105.29327392578124,3418851.0,0.0,0.0,0.5857772827148295,0.0,0.5857772827148295,69.9211742068621,100.3143326194546,105.41343333363234,97.64351765955497,-2.3564823404450346,1.2747194792477785,1.4690374310794247,0.01689889824777402,-24697002.0,1.0
4080,2019-03-19,IBM,105.85648773300623,106.41219343042378,105.1355553885016,105.50352478027344,3642486.0,0.0,0.0,0.2102508544922017,0.0,0.2102508544922017,71.4765649989811,100.3143326194546,106.41219343042378,85.09856688568914,-14.901433114310864,1.3093779145452373,1.4371055277725875,0.02562391396202157,-21054516.0,1.0
4081,2019-03-20,IBM,105.53355799167696,105.6612205928702,104.36956417046946,104.8351593017578,3817377.0,0.0,0.0,-0.6683654785156392,0.6683654785156392,0.0,60.080909954942584,100.3143326194546,106.41219343042378,74.13791200630348,-25.86208799369652,1.2682933693890561,1.4033430960958813,0.0313238749837037,-24871893.0,-1.0
4082,2019-03-21,IBM,104.45969324101164,106.72761957358593,104.29447855629742,106.21695709228516,3771248.0,0.0,0.0,1.381797790527358,0.0,1.381797790527358,71.07991821906002,100.3143326194546,106.72761957358593,92.03742971501049,-7.962570284989515,1.3318800210678603,1.3890504810902773,0.047005831602558557,-21100645.0,1.0
4083,2019-03-22,IBM,105.86398342717004,106.21693436883962,104.30947466808102,104.7225112915039,4055551.0,0.0,0.0,-1.49444580078125,1.49444580078125,0.0,52.89313825045682,100.3143326194546,106.72761957358593,68.73509174900765,-31.264908250992352,1.2473054532773347,1.360701475527689,0.01263504135250626,-25156196.0,-1.0
4084,2019-03-25,IBM,104.42963759912573,105.06796258941904,103.8964535659988,104.51976013183594,2970431.0,0.0,0.0,-0.20275115966796875,0.20275115966796875,0.0,50.856172850060986,100.3143326194546,106.72761957358593,65.57366826806766,-34.42633173193234,1.1506551386727608,1.3186922081567034,0.006508472872767124,-28126627.0,-1.0
4085,2019-03-26,IBM,105.08301131242092,105.90156961817604,104.7000114134254,105.30079650878906,2671170.0,0.0,0.0,0.781036376953125,0.0,0.781036376953125,58.038866586114025,100.3143326194546,106.72761957358593,77.7520782244473,-22.247921775552708,1.124123974808768,1.2797785614871164,0.01198063992992826,-25455457.0,1.0
4086,2019-03-27,IBM,105.44345113653164,105.50352483661456,103.93400952714588,104.5648193359375,3240717.0,0.0,0.0,-0.7359771728515625,0.7359771728515625,0.0,50.08043549354482,100.3143326194546,106.72761957358593,66.27625969152699,-33.72374030847302,1.0318164910433154,1.2301861473983564,0.0032422417107922374,-28696174.0,-1.0
4087,2019-03-28,IBM,105.06796675116446,105.46597299397772,104.45967858568916,105.07546997070312,2786439.0,0.0,0.0,0.510650634765625,0.0,0.510650634765625,55.01842982804901,102.01153492864032,106.72761957358593,64.96777035896787,-35.03222964103213,0.988472883561144,1.181843494630914,0.003514297824262602,-25909735.0,1.0
4088,2019-03-29,IBM,105.51103219764872,106.05173141611644,105.24819180036694,105.96160888671876,3244064.0,0.0,0.0,0.8861389160156392,0.0,0.8861389160156392,62.45478658773909,103.52097699737064,106.72761957358593,76.11175337878588,-23.888246621214122,1.0139387127822346,1.1482625382611782,0.006347366132889221,-22665671.0,1.0
4089,2019-04-01,IBM,106.26953037049294,107.69637687577602,106.26953037049294,107.61376953125,4167578.0,0.0,0.0,1.6521606445312358,0.0,1.6521606445312358,72.30466046074409,103.52097699737064,107.69637687577602,98.02157046195123,-1.978429538048778,1.154132006889185,1.1494364319867796,0.02000165165449652,-18498093.0,1.0
4090,2019-04-02,IBM,107.6513096153114,108.10189839984452,107.08808861711464,107.38848114013672,2515421.0,0.0,0.0,-0.22528839111328125,0.22528839111328125,0.0,69.43843427559521,103.67868800290256,108.10189839984452,83.87105302065154,-16.12894697934846,1.2328458328170626,1.1661183121528362,0.024355586955607356,-21013514.0,-1.0
4091,2019-04-03,IBM,107.87659832094704,108.3046414388428,107.39597273334338,107.86157989501952,2804535.0,0.0,0.0,0.4730987548827983,0.0,0.4730987548827983,72.11667510031671,103.8964535659988,108.3046414388428,89.94912293659958,-10.050877063400426,1.3182067557105484,1.1965360008643788,0.015483618131758803,-18208979.0,1.0
4092,2019-04-04,IBM,107.85406884334402,108.24457190444944,107.04302586812123,107.22325897216795,2898571.0,0.0,0.0,-0.6383209228515625,0.6383209228515625,0.0,63.458979871065175,103.8964535659988,108.3046414388428,75.46877542727842,-24.531224572721573,1.3191424848644857,1.2210572976644003,0.02387975278498633,-21107550.0,-1.0
4093,2019-04-05,IBM,107.60625047393782,107.76396193655802,106.9829438019027,107.59874725341795,2857463.0,0.0,0.0,0.37548828125,0.0,0.37548828125,66.21214601878715,103.8964535659988,108.3046414388428,83.98674907271085,-16.013250927289143,1.3347961243313478,1.24380506299779,0.029458421237269716,-18250087.0,1.0
4094,2019-04-08,IBM,107.40347661988208,107.70385709274925,107.29083244431028,107.68133544921876,2215637.0,0.0,0.0,0.08258819580080967,0.0,0.08258819580080967,66.84609733733456,103.8964535659988,108.3046414388428,85.86026713008728,-14.139732869912727,1.3384372520763321,1.2627315008134985,0.022607036407659153,-16034450.0,1.0
4095,2019-04-09,IBM,107.13311740799088,107.35090253262692,106.5173260726412,106.7200927734375,3178271.0,0.0,0.0,-0.9612426757812642,0.9612426757812642,0.0,53.392497435828126,103.8964535659988,108.3046414388428,64.05442074811111,-35.94557925188888,1.2493568138987996,1.2600565634305587,0.02061184106841618,-19212721.0,-1.0
4096,2019-04-10,IBM,106.78766957969124,107.7639390441264,106.62246691762068,107.40347290039062,2801188.0,0.0,0.0,0.683380126953125,0.0,0.683380126953125,59.996896993704524,103.8964535659988,108.3046414388428,79.5569389407451,-20.443061059254912,1.2198414173183636,1.2520135342081198,0.022155531927067207,-16411533.0,1.0
4097,2019-04-11,IBM,107.9892234403655,108.22201499412438,107.4109721933496,107.97420501708984,3077332.0,0.0,0.0,0.5707321166992188,0.0,0.5707321166992188,64.80307745721018,103.8964535659988,108.3046414388428,92.504030425097,-7.495969574902999,1.2283439801066578,1.2472796233878274,0.018993635067609205,-13334201.0,1.0
4098,2019-04-12,IBM,108.33469379550944,108.46987163417803,107.91415383740274,108.40228271484376,3032249.0,0.0,0.0,0.42807769775392046,0.0,0.42807769775392046,68.11811589798633,103.93400952714588,108.46987163417803,98.50989916052599,-1.4901008394740118,1.2551559584071157,1.2488548903916852,0.007327251772969223,-10301952.0,1.0
4099,2019-04-15,IBM,108.43982331827726,108.48487859774671,107.59122828471553,108.06433868408205,3768947.0,0.0,0.0,-0.33794403076171875,0.33794403076171875,0.0,62.73579751989968,103.93400952714588,108.48487859774671,90.75912958293159,-9.24087041706841,1.2349002243263953,1.2460639571786274,0.0062935757799140735,-14070899.0,-1.0
4100,2019-04-16,IBM,108.4398190878309,109.18327312098546,108.15444502370758,108.99553680419922,6591578.0,0.0,0.0,0.9311981201171733,0.0,0.9311981201171733,70.21767473435958,104.45967858568916,109.18327312098546,96.025562410503,-3.974437589497009,1.2792410208898701,1.252699369920876,0.010513075279291906,-7479321.0,1.0
4101,2019-04-17,IBM,103.16050672460636,106.62247543316604,102.32693019888929,104.46719360351562,13101882.0,0.0,0.0,-4.528343200683594,4.528343200683594,0.0,33.01898611125202,102.32693019888929,109.18327312098546,31.215816200336732,-68.78418379966327,0.9381673609247798,1.1897929681216568,-0.025703988062587446,-20581203.0,-1.0
4102,2019-04-18,IBM,104.384593448971,105.50353211304208,104.15930507214856,105.38338470458984,5188160.0,0.0,0.0,0.9161911010742188,0.0,0.9161911010742188,40.39102294892022,102.32693019888929,109.18327312098546,44.57849527698527,-55.42150472301473,0.733339511625573,1.0985022768224402,-0.020589110982960235,-15393043.0,1.0
4103,2019-04-22,IBM,104.69998530750767,105.55609546475452,103.99408337262548,104.3019790649414,4700724.0,0.0,0.0,-1.0814056396484375,1.0814056396484375,0.0,35.125845273258534,102.32693019888929,109.18327312098546,28.806156408645506,-71.1938435913545,0.47823872953458135,0.9744495673648684,-0.03138293530795799,-20093767.0,-1.0
4104,2019-04-23,IBM,104.49724566720784,105.82645438418446,104.33954618850902,105.46598815917967,4667461.0,0.0,0.0,1.164009094238267,0.0,1.164009094238267,44.165403577993565,102.32693019888929,109.18327312098546,45.78326953533837,-54.21673046466162,0.3657788567297757,0.8527154252378499,-0.011751344865490676,-15426306.0,1.0
4105,2019-04-24,IBM,105.58615132762468,106.11933547755008,104.9703598321079,105.0980224609375,2902545.0,0.0,0.0,-0.3679656982421733,0.3679656982421733,0.0,42.02928026442921,102.32693019888929,109.18327312098546,40.41647702768364,-59.58352297231636,0.2441474607211518,0.7310018323345103,-0.021465324883779835,-18328851.0,-1.0
4106,2019-04-25,IBM,104.91027496535328,104.94781503773866,103.41583968273646,104.1067352294922,3043965.0,0.0,0.0,-0.9912872314452983,0.9912872314452983,0.0,36.53629201953219,102.32693019888929,109.18327312098546,25.958518277536495,-74.04148172246352,0.06699285608945615,0.5982000370854995,-0.03581846040899783,-21372816.0,-1.0
4107,2019-04-26,IBM,104.6398998645311,105.05293647176136,104.24189366662954,104.71500396728516,2426511.0,0.0,0.0,0.6082687377929545,0.0,0.6082687377929545,41.91144898400525,102.32693019888929,109.18327312098546,34.83013897539666,-65.16986102460335,-0.024044075648063767,0.4737512145387868,-0.03401477030938671,-18946305.0,1.0
4108,2019-04-29,IBM,104.49724942635189,104.85771566432396,104.24192416861162,104.42215728759766,3094382.0,0.0,0.0,-0.2928466796875,0.2928466796875,0.0,40.02813066163837,102.32693019888929,109.18327312098546,30.558959966194347,-69.44104003380566,-0.11845628919927265,0.35530971379117493,-0.03370382348919043,-22040687.0,-1.0
4109,2019-04-30,IBM,104.4671936460541,105.4659728474426,104.14427952894474,105.33831024169922,4852185.0,0.0,0.0,0.9161529541015625,0.0,0.9161529541015625,48.39824046216755,102.32693019888929,109.18327312098546,43.92108266791985,-56.078917332080145,-0.11799261642131853,0.26064924774867626,-0.03355391119427098,-17188502.0,1.0
4110,2019-05-01,IBM,105.54859898993598,106.49481986534984,105.26323687752904,105.55611419677734,3194170.0,0.0,0.0,0.217803955078125,0.0,0.217803955078125,50.30097043713646,102.32693019888929,109.18327312098546,47.097760928515605,-52.90223907148439,-0.09891002034780172,0.18873739412938065,0.010423565099245469,-13994332.0,1.0
4111,2019-05-02,IBM,105.51102453707156,106.09677898472329,104.69246655684891,104.82764434814452,3704304.0,0.0,0.0,-0.7284698486328267,0.7284698486328267,0.0,44.03479747175232,102.32693019888929,109.18327312098546,36.47300284815236,-63.52699715184764,-0.14094364359597478,0.12280118658430957,-0.005273510221779021,-17698636.0,-1.0
4112,2019-05-03,IBM,104.9102785106373,105.88653617319116,104.85770802435172,105.32330322265624,2698575.0,0.0,0.0,0.49565887451171875,0.0,0.49565887451171875,49.02065096090126,102.32693019888929,109.18327312098546,43.702204773195255,-56.297795226804745,-0.13273003485676327,0.071694942296095,0.009791992125853355,-15000061.0,1.0
4113,2019-05-06,IBM,103.85892421184371,105.65374019338589,103.55854367109438,105.42093658447266,2921792.0,0.0,0.0,0.09763336181642046,0.0,0.09763336181642046,50.03240088241991,102.32693019888929,109.18327312098546,45.12619075122698,-54.87380924877302,-0.11699386199759942,0.0339571814373561,-0.0004271668572338738,-12078269.0,1.0
4114,2019-05-07,IBM,104.49723834783714,104.76758200466716,102.27436744466418,103.36328125,4944233.0,0.0,0.0,-2.0576553344726562,2.0576553344726562,0.0,33.74604125584543,102.27436744466418,106.62247543316604,25.043393775300522,-74.95660622469948,-0.2674751337382588,-0.026329281597766905,-0.01650593579515036,-17022502.0,-1.0
4115,2019-05-08,IBM,103.460895711481,104.15929440247908,102.980270168982,103.63361358642578,3994569.0,0.0,0.0,0.27033233642578125,0.0,0.27033233642578125,36.861624466678904,102.27436744466418,106.49481986534984,32.20617143080545,-67.79382856919455,-0.3607604436351437,-0.09321551400524229,-0.004544582461677216,-13027933.0,1.0
4116,2019-05-09,IBM,102.5013836695626,103.02570438963126,101.08799421676436,102.84333038330078,4385564.0,1.548757,0.0,-0.790283203125,0.790283203125,0.0,31.815089051661758,101.08799421676436,106.49481986534984,32.465189015215415,-67.53481098478458,-0.49277852948871725,-0.17312811710193732,-0.01787397710999583,-17413497.0,-1.0
4117,2019-05-10,IBM,102.49379039444035,103.15489464536056,100.62445987856084,102.82813262939452,4160570.0,0.0,0.0,-0.01519775390626421,0.01519775390626421,0.0,31.71873294393717,100.62445987856084,106.49481986534984,37.53897130317305,-62.46102869682695,-0.5918081494350247,-0.2568641235685548,-0.015265195621393834,-21574067.0,-1.0
4118,2019-05-13,IBM,101.2779661275723,101.49833219071188,99.51502549410527,99.86457061767578,5186068.0,0.0,0.0,-2.963562011718736,2.963562011718736,0.0,18.864011397670524,99.51502549410527,106.49481986534984,5.007957326229659,-94.99204267377034,-0.8990607113028659,-0.3853034411154171,-0.05196342727981795,-26760135.0,-1.0
4119,2019-05-14,IBM,100.16852984924655,102.06824804149782,100.06214601858773,101.30076599121094,3431298.0,0.0,0.0,1.4361953735351562,0.0,1.4361953735351562,33.85390258481992,99.51502549410527,106.49481986534984,25.584428453402257,-74.41557154659775,-1.014971654919563,-0.5112370838762464,-0.040313611749989264,-23328837.0,1.0
4120,2019-05-15,IBM,100.7536476430568,102.27342710390532,100.586476511137,102.1290512084961,2668346.0,0.0,0.0,0.8282852172851562,0.0,0.8282852172851562,41.09569806467968,99.51502549410527,106.49481986534984,37.451328439704646,-62.548671560295354,-1.0281444093096894,-0.6146185489629351,-0.025743143961969528,-20660491.0,1.0
4121,2019-05-16,IBM,102.38740540181053,103.42845453490816,102.31142128303917,103.2536849975586,3156096.0,0.0,0.0,1.1246337890625,0.0,1.1246337890625,49.719872353992855,99.51502549410527,106.49481986534984,53.56403505031453,-46.43596494968546,-0.9370338216353105,-0.6791016034974102,-0.019650145426244547,-17504395.0,1.0
4122,2019-05-17,IBM,102.34182731024164,102.89654176525042,101.77950837826042,102.0682601928711,2739579.0,0.0,0.0,-1.1854248046875,1.1854248046875,0.0,42.20465338930456,99.51502549410527,106.49481986534984,36.58037132561762,-63.41962867438238,-0.9495362365477149,-0.7331885301074712,-0.03180275664611554,-20243974.0,-1.0
4123,2019-05-20,IBM,101.46793647452922,102.91171953697432,101.01200147028727,102.67616271972656,3414667.0,0.0,0.0,0.6079025268554688,0.0,0.6079025268554688,46.94936745358138,99.51502549410527,106.49481986534984,45.289833159621104,-54.710166840378896,-0.9000170012279654,-0.7665542243315702,-0.006647607563962099,-16829307.0,1.0
4124,2019-05-21,IBM,103.43605208576508,104.150339139446,103.18528631808236,103.68680572509766,2618661.0,0.0,0.0,1.0106430053710938,0.0,1.0106430053710938,54.167178360491256,99.51502549410527,106.09677898472329,63.38402428682666,-36.61597571317334,-0.7703421810905411,-0.7673118156833645,0.0005132710983537514,-14210646.0,1.0
4125,2019-05-22,IBM,103.34487720652918,103.91480060867444,103.12450504554133,103.61083984375,1934891.0,0.0,0.0,-0.07596588134765625,0.07596588134765625,0.0,53.53545757658744,99.51502549410527,105.88653617319116,64.28325331210695,-35.71674668789305,-0.6660262278585947,-0.7470546981184106,0.007462899709574478,-16145537.0,-1.0
4126,2019-05-23,IBM,102.6837537232674,102.6837537232674,99.11988051795142,100.6016616821289,5589196.0,0.0,0.0,-3.0091781616210938,3.0091781616210938,0.0,34.92093105620246,99.11988051795142,105.65374019338589,22.67849690357728,-77.32150309642272,-0.8167555625456799,-0.7609948710038645,-0.021652352234092342,-21734733.0,-1.0
4127,2019-05-24,IBM,101.46792839605683,102.01505035758748,99.99374574124742,100.51806640625,2715521.0,0.0,0.0,-0.08359527587890625,0.08359527587890625,0.0,34.53601639145505,99.11988051795142,104.76758200466716,24.756724334445273,-75.24327566555473,-0.9322091594498829,-0.7952377286930683,0.006543820140939571,-24450254.0,-1.0
4128,2019-05-28,IBM,100.40409969088856,100.79164295746408,98.99070410401151,99.13508605957033,5134605.0,0.0,0.0,-1.3829803466796733,1.3829803466796733,0.0,28.532557693869165,98.99070410401151,104.15929440247908,2.7934494169836084,-97.2065505830164,-1.1223640090734932,-0.8606629847691534,-0.021378712297481672,-29584859.0,-1.0
4129,2019-05-29,IBM,98.78552013936356,98.9982877708568,97.50890828622954,98.54995727539062,3848234.0,0.0,0.0,-0.5851287841797017,0.5851287841797017,0.0,26.300636266670423,97.50890828622954,104.150339139446,15.675070811840206,-84.32492918815979,-1.3052321958747086,-0.9495768269902644,-0.0350448172263812,-33433093.0,-1.0
4130,2019-05-30,IBM,98.58794216139258,98.76271772604538,97.97243454414492,98.4587631225586,2868027.0,0.0,0.0,-0.09119415283203125,0.09119415283203125,0.0,25.9357972826748,97.50890828622954,104.150339139446,14.301960787095078,-85.69803921290492,-1.440905298057416,-1.0478425212036948,-0.046438263923591405,-36301120.0,-1.0
4131,2019-05-31,IBM,97.60010450738204,97.60010450738204,96.39187823746212,96.4982681274414,3702108.0,0.0,0.0,-1.9604949951171875,1.9604949951171875,0.0,19.29606706255666,96.39187823746212,104.150339139446,1.3712757120691135,-98.6287242879309,-1.6871740780326263,-1.175708832569481,-0.05457124531077995,-40003228.0,-1.0
4132,2019-06-03,IBM,96.5818571544926,97.69129808481988,96.5514635062674,97.47093200683594,4463177.0,0.0,0.0,0.9726638793945312,0.0,0.9726638793945312,29.611707957891696,96.39187823746212,104.150339139446,13.908090573710238,-86.09190942628976,-1.7833012277705365,-1.2972273116096922,-0.05069561011058876,-35540051.0,1.0
4133,2019-06-04,IBM,98.4511796733089,100.86762611204172,98.09403007945537,100.82962799072266,4093521.0,0.0,0.0,3.3586959838867188,0.0,3.3586959838867188,53.36302519052456,96.39187823746212,104.150339139446,57.19884148833921,-42.80115851166078,-1.5703618366537881,-1.3518542166185115,-0.027555846806103457,-31446530.0,1.0
4134,2019-06-05,IBM,101.3539379824256,101.52870748052496,99.14266114675806,99.9177474975586,3306720.0,0.0,0.0,-0.9118804931640625,0.9118804931640625,0.0,48.26146610235894,96.39187823746212,104.150339139446,45.44547307307931,-54.55452692692069,-1.4583757224226304,-1.3731585177793353,-0.035643880039586184,-34753250.0,-1.0
4135,2019-06-06,IBM,100.44970235929038,100.79925360851708,99.46944645589105,100.47250366210938,2403917.0,0.0,0.0,0.5547561645507812,0.0,0.5547561645507812,51.51518717945477,96.39187823746212,104.150339139446,52.59581089857414,-47.40418910142586,-1.3097635944719883,-1.360479533117866,-0.0012838557322008004,-32349333.0,1.0
4136,2019-06-07,IBM,100.66245694308242,102.37220877386648,100.46488610554806,101.30076599121094,2670856.0,0.0,0.0,0.8282623291015625,0.0,0.8282623291015625,56.25447923514266,96.39187823746212,104.150339139446,63.27141189167539,-36.728588108324615,-1.1123313016538816,-1.3108498868250693,0.0077866558017303245,-29678477.0,1.0
4137,2019-06-10,IBM,102.11385043959686,102.85093884086184,101.75669476051615,102.3874053955078,3045220.0,0.0,0.0,1.0866394042968608,0.0,1.0866394042968608,61.893144451744156,96.39187823746212,104.150339139446,77.27727488466928,-22.722725115330718,-0.8582882559219343,-1.2203375606444424,0.032806945201854676,-26633257.0,1.0
4138,2019-06-11,IBM,102.82813163582664,103.69441118177257,102.62296846276332,103.3068618774414,3564036.0,0.0,0.0,0.919456481933608,0.0,0.919456481933608,66.1526660215259,96.39187823746212,103.91480060867444,91.91884880323357,-8.081151196766434,-0.5761236630612103,-1.091494781127796,0.048268966659802404,-23069221.0,1.0
4139,2019-06-12,IBM,103.0105115361728,103.2992754441368,102.13663959293189,102.48619079589844,2358416.0,0.0,0.0,-0.8206710815429688,0.8206710815429688,0.0,59.32346247222162,96.39187823746212,103.69441118177257,83.4547766495805,-16.5452233504195,-0.41395566475426904,-0.9559869578530905,0.04090471529006123,-25427637.0,-1.0
4140,2019-06-13,IBM,102.68375298662062,103.55003250921744,102.6533593416786,103.16248321533205,3091244.0,0.0,0.0,0.676292419433608,0.0,0.676292419433608,62.959381720637516,96.39187823746212,103.69441118177257,92.71584297534794,-7.284157024652062,-0.22823426892074394,-0.8104364200666212,0.06906046312758152,-22336393.0,1.0
4141,2019-06-14,IBM,102.91933148941456,103.25368587154053,102.15183730574832,102.69895935058594,2294192.0,0.0,0.0,-0.46352386474610796,0.46352386474610796,0.0,58.802644274514826,96.39187823746212,103.69441118177257,86.36840341867673,-13.631596581323274,-0.11710135519706455,-0.6717694070927099,0.05363678417872664,-24630585.0,-1.0
4142,2019-06-17,IBM,102.88132854860028,103.36766327513595,102.3570078283114,102.5469741821289,2295029.0,0.0,0.0,-0.15198516845703125,0.15198516845703125,0.0,57.3696277825132,96.39187823746212,103.69441118177257,84.28713696474794,-15.71286303525206,-0.04082109315147875,-0.5455797443044638,0.01703215836087657,-26925614.0,-1.0
4143,2019-06-18,IBM,102.73694804725324,104.24912284747656,102.73694804725324,103.63362121582033,3048776.0,0.0,0.0,1.0866470336914205,0.0,1.0866470336914205,64.5055482523521,96.39187823746212,104.24912284747656,92.16644431723886,-7.833555682761148,0.10609193641691661,-0.4152454081601877,0.03718932633416827,-23876838.0,1.0
4144,2019-06-19,IBM,103.67160791801231,105.13819226081638,103.52723203920831,104.16553497314452,2491990.0,0.0,0.0,0.5319137573241903,0.0,0.5319137573241903,67.57145518998698,96.39187823746212,105.13819226081638,88.87923203906593,-11.12076796093408,0.2624175791255112,-0.27971281070304793,0.0367566366560832,-21384848.0,1.0
4145,2019-06-20,IBM,105.57131584550686,106.03484918441195,105.01660158502118,105.51052856445312,3212266.0,0.0,0.0,1.344993591308608,0.0,1.344993591308608,74.09890473764716,96.5514635062674,106.03484918441195,94.4711663349601,-5.528833665039899,0.4891973568605579,-0.12593077719032672,0.04155706555671479,-18172582.0,1.0
4146,2019-06-21,IBM,105.19899647609807,106.03487027019894,105.16099835370922,105.7765121459961,5531980.0,0.0,0.0,0.26598358154296875,0.0,0.26598358154296875,75.2363067696528,98.09403007945537,106.03487027019894,96.7464636235344,-3.2535363764656067,0.6825169857292366,0.035758775393586,0.03310081681820787,-12640602.0,1.0
4147,2019-06-24,IBM,105.7765054393094,106.49839694882324,105.66252320772035,105.89048767089844,2286556.0,0.0,0.0,0.11397552490234375,0.0,0.11397552490234375,75.76255113001645,99.14266114675806,106.49839694882324,91.73557487268468,-8.264425127315322,0.8352923267355976,0.19566548566198838,0.025009237010046093,-10354046.0,1.0
4148,2019-06-25,IBM,105.97408478928472,106.0424644310632,104.96342931759268,105.13819885253906,2930055.0,0.0,0.0,-0.752288818359375,0.752288818359375,0.0,65.2089608165799,99.46944645589105,106.49839694882324,80.6486317174677,-19.35136828253231,0.8854574622220355,0.33362388097399787,0.025876735548910235,-13284101.0,-1.0
4149,2019-06-26,IBM,105.52574347651918,106.14125725193315,105.1761922938353,105.25978088378906,2389692.0,0.0,0.0,0.12158203125,0.0,0.12158203125,66.08982384378163,100.46488610554806,106.49839694882324,79.47105595385291,-20.52894404614709,0.9243687992159977,0.4517728646223979,0.020330042502750834,-10894409.0,1.0
4150,1.0,1.0,1.0,1.0,1.0,1.0,1.0,1.0,1.0,1.0,1.0,1.0,1.0,1.0,1.0,1.0,1.0,1.0,1.0,1.0,1.0,1.0
4151,2019-06-28,IBM,105.29777437730117,105.7309020025526,104.74304791774276,104.78865051269533,6436979.0,0.0,0.0,-0.4711303710937358,0.4711303710937358,0.0,58.45451572011381,102.13663959293189,106.49839694882324,60.801431702325495,-39.198568297674505,0.9116081198315982,0.6225475808580077,0.021859994879859457,-17331388.0,-1.0
4152,2019-07-01,IBM,106.0804833379261,107.51667440697402,105.83732198520904,106.29325103759766,3533074.0,0.0,0.0,1.5046005249023295,0.0,1.5046005249023295,70.85991609745679,102.13663959293189,107.51667440697402,77.25993582451972,-22.74006417548029,0.9956149655543101,0.6971610577972682,0.02566377388510399,-13798314.0,1.0
4153,2019-07-02,IBM,106.1944495344774,106.7111779431324,105.98168186699624,106.55160522460938,2520546.0,0.0,0.0,0.25835418701171875,0.0,0.25835418701171875,72.48755601794134,102.15183730574832,107.51667440697402,82.01121181956943,-17.988788180430586,1.0706957061464948,0.7718679874671136,0.022906523276437163,-11277768.0,1.0
4154,2019-07-03,IBM,106.93154321485186,107.7674170068348,106.71117108524564,107.55464935302734,2019198.0,0.0,0.0,1.0030441284179688,0.0,1.0030441284179688,77.99389717492001,102.15183730574832,107.7674170068348,96.21111861761493,-3.7888813823850676,1.1973329039640532,0.8569609707665016,0.01937361907276891,-9258570.0,1.0
4155,2019-07-05,IBM,107.0455453233089,107.51667118811558,106.3160491586444,107.4330825805664,2232896.0,0.0,0.0,-0.1215667724609375,0.1215667724609375,0.0,75.87041244416845,102.3570078283114,107.7674170068348,93.8205334340416,-6.179466565958398,1.2732076280525888,0.9402103022237192,0.015661042333139807,-11491466.0,-1.0
4156,2019-07-08,IBM,107.18229867999162,107.3646726903976,106.5895861782599,106.81755065917967,2505484.0,0.0,0.0,-0.615531921386733,0.615531921386733,0.0,65.4583414930569,102.73694804725324,107.7674170068348,81.11773762472156,-18.88226237527844,1.2690418867799593,1.0059766191349673,0.008754922266129173,-13996950.0,-1.0
4157,2019-07-09,IBM,106.84795487826791,107.13670664900036,105.72331718520358,105.87529754638672,3519999.0,0.0,0.0,-0.9422531127929545,0.9422531127929545,0.0,52.687082036925794,103.52723203920831,107.7674170068348,55.376487702911945,-44.623512297088055,1.1761506230896686,1.0400114199259076,0.0070107601413400555,-17516949.0,-1.0
4158,2019-07-10,IBM,106.38443356806432,107.83582131960702,106.22484871288212,106.7415771484375,2629539.0,0.0,0.0,0.8662796020507812,0.0,0.8662796020507812,60.80024961242272,104.74304791774276,107.83582131960702,64.61932288637985,-35.38067711362015,1.1590740671074116,1.0638239493622084,0.014077516143458535,-14887410.0,1.0
4159,2019-07-11,IBM,106.98473181142316,107.58504881133302,106.61239142923368,107.32669067382812,2231013.0,0.0,0.0,0.585113525390625,0.0,0.585113525390625,65.42138096734357,104.74304791774276,107.83582131960702,83.5380553430781,-16.461944656921904,1.1791619005757639,1.0868915396049195,0.019636272968504676,-12656397.0,1.0
4160,2019-07-12,IBM,107.84340082157432,108.60329049519828,107.64582999156612,108.4665069580078,2914365.0,0.0,0.0,1.1398162841796733,0.0,1.1398162841796733,72.6646191652687,104.74304791774276,108.60329049519828,96.45660772746974,-3.5433922725302556,1.2723880047310843,1.1239908326301524,0.0350978510298392,-9742032.0,1.0
4161,2019-07-15,IBM,108.5804995645588,109.05162533296078,107.9953794314455,108.9072494506836,2477242.0,0.0,0.0,0.44074249267579546,0.0,0.44074249267579546,75.00101031733,104.74304791774276,109.05162533296078,96.64910553150912,-3.350894468490885,1.366087196807186,1.1724101054655591,0.024592327241560463,-7264790.0,1.0
4162,2019-07-16,IBM,108.79325569527792,109.45435987318396,108.6792734709854,109.06681060791016,3634536.0,0.0,0.0,0.1595611572265625,0.0,0.1595611572265625,75.86279268736084,104.74304791774276,109.45435987318396,91.77406911409857,-8.22593088590143,1.4366588248301042,1.2252598493384683,0.023605513760198704,-3630254.0,1.0
4163,2019-07-17,IBM,109.12761602816852,109.27200404750266,107.8662068764804,108.71727752685548,6343258.0,0.0,0.0,-0.3495330810546733,0.3495330810546733,0.0,69.78242013739616,104.74304791774276,109.45435987318396,84.35505113438298,-15.644948865617025,1.4476948252217028,1.2697468445151152,0.010809650543437188,-9973512.0,-1.0
4164,2019-07-18,IBM,108.28416912075994,114.21889981440988,108.05619246537708,113.7021713256836,13276460.0,0.0,0.0,4.984893798828111,0.0,4.984893798828111,86.96908839620453,104.74304791774276,114.21889981440988,94.54689146304585,-5.45310853695415,1.8374986633242543,1.3832972082769432,0.058353428892965686,3302948.0,1.0
4165,2019-07-19,IBM,113.95293340389328,115.18394908632378,113.64138027676616,113.74016571044922,7626072.0,0.0,0.0,0.037994384765625,0.0,0.037994384765625,87.0339445668266,105.72331718520358,115.18394908632378,84.73903867136393,-15.260961328636064,2.1249912661685215,1.531636019855259,0.06480784298600306,10929020.0,1.0
4166,2019-07-22,IBM,114.10487067955256,115.45747258789127,113.75531955512884,113.78571319580078,4280860.0,0.0,0.0,0.0455474853515625,0.0,0.0455474853515625,87.12259842448323,105.72331718520358,115.45747258789127,82.82584032273715,-17.174159677262857,2.3296517513746267,1.6912391661591328,0.07471445967788948,15209880.0,1.0
4167,2019-07-23,IBM,114.41645986975136,114.53044212248872,112.75230442576348,114.2720718383789,3914341.0,0.0,0.0,0.486358642578125,0.0,0.486358642578125,88.12313235342256,105.72331718520358,115.45747258789127,87.82225369871259,-12.177746301287403,2.5022473878941867,1.8534408105061437,0.0705488422704239,19124221.0,1.0
4168,2019-07-24,IBM,114.07449842183946,115.0851539769937,113.3754080959707,114.00611877441406,3088210.0,0.0,0.0,-0.26595306396484375,0.26595306396484375,0.0,84.00495765781538,105.72331718520358,115.45747258789127,85.09008996223257,-14.909910037767423,2.5877406206585505,2.000300772536625,0.06223454816924434,16036011.0,-1.0
4169,2019-07-25,IBM,113.84653089914303,114.4544402600716,112.92706844555178,114.27967071533205,3244797.0,0.0,0.0,0.27355194091798296,0.0,0.27355194091798296,84.84546252946095,105.72331718520358,115.45747258789127,87.90031775911419,-12.099682240885809,2.647054383830252,2.1296514947953504,0.0535940901975831,19280808.0,1.0
4170,2019-07-26,IBM,114.74321441727928,115.0547675377376,114.05930874499946,115.01676940917967,3037898.0,0.0,0.0,0.7370986938476278,0.0,0.7370986938476278,86.97365610600652,105.72331718520358,115.45747258789127,95.4726099956251,-4.527390004374894,2.7221593147836103,2.2481530587930023,0.05609837719079169,22318706.0,1.0
4171,2019-07-29,IBM,114.82679736610886,115.10795682121044,114.22648032921978,114.65201568603516,2170973.0,0.0,0.0,-0.36475372314451704,0.36475372314451704,0.0,80.51740779193611,106.22484871288212,115.45747258789127,91.27596972691234,-8.724030273087667,2.720883287732306,2.342699104580863,0.05120902543124273,20147733.0,-1.0
4172,2019-07-30,IBM,113.98330988197824,114.28727061444448,113.39059736918496,113.80854034423828,2753804.0,0.0,0.0,-0.843475341796875,0.843475341796875,0.0,67.20607362449962,106.61239142923368,115.45747258789127,81.35763579694219,-18.642364203057802,2.621590552232732,2.398477394111237,0.046830300879500575,17393929.0,-1.0
4173,2019-07-31,IBM,113.755345448162,114.12009347594577,111.24010737733884,112.64590454101562,3894153.0,0.0,0.0,-1.1626358032226562,1.1626358032226562,0.0,53.214131790955484,107.64582999156612,115.45747258789127,64.00797895953023,-35.992021040469766,2.4211755466442924,2.4030170246178484,-0.009289767929254733,13499776.0,-1.0
4174,2019-08-01,IBM,113.14745093349704,116.12621071281067,112.84349016107504,114.22648620605467,6635824.0,0.0,0.0,1.5805816650390483,0.0,1.5805816650390483,64.7319869758553,107.8662068764804,116.12621071281067,77.00092464363787,-22.999075356362127,2.362649785669049,2.394943576828089,0.004275714674475628,20135600.0,1.0
4175,2019-08-02,IBM,113.24622561708328,116.22498511368288,110.63220203307937,111.89362335205078,8474378.0,0.0,0.0,-2.332862854003892,2.332862854003892,0.0,45.609871259152214,107.8662068764804,116.22498511368288,48.18187971114637,-51.81812028885362,2.103774163666273,2.3367096941957257,-0.016628536136993888,11661222.0,-1.0
4176,2019-08-05,IBM,110.16865285394732,110.25984591535094,105.73850630187584,106.96192932128906,7442185.0,0.0,0.0,-4.931694030761719,4.931694030761719,0.0,26.508693378415543,105.73850630187584,116.22498511368288,11.666671352406018,-88.33332864759397,1.4835652589176789,2.1660808071401165,-0.0639713833790374,4219037.0,-1.0
4177,2019-08-06,IBM,107.92697911683206,108.26133345213236,105.86009007471054,106.93912506103516,5303952.0,0.0,0.0,-0.02280426025390625,0.02280426025390625,0.0,26.449593297962096,105.73850630187584,116.22498511368288,11.449207886707406,-88.5507921132926,0.9789207314856441,1.928648792009222,-0.06198784582222727,-1084915.0,-1.0
4178,2019-08-07,IBM,105.42696282512092,106.0652657994909,103.65641766160982,105.70812225341795,6204767.0,0.0,0.0,-1.2310028076172017,1.2310028076172017,0.0,23.22453389455795,103.65641766160982,116.22498511368288,16.324092619399718,-83.6759073806003,0.47418851899836056,1.6377567374070496,-0.07500501540003224,-7289682.0,-1.0
4179,2019-08-08,IBM,106.44620785544208,107.96082437434868,105.91570921065444,107.7147979736328,5503111.0,1.548757,0.0,2.0066757202148438,0.0,2.0066757202148438,37.547544079122254,103.65641766160982,116.22498511368288,32.28991949558729,-67.7100805044127,0.23341589123772621,1.356888568173185,-0.06348614617725556,-1786571.0,1.0
4180,2019-08-09,IBM,107.07664384446473,107.107407878446,104.06278702838976,104.66248321533205,5485852.0,0.0,0.0,-3.052314758300753,3.052314758300753,0.0,28.28599991408518,103.65641766160982,116.22498511368288,8.004615940190408,-91.9953840598096,-0.2013731384817703,1.045236226842194,-0.08712914823982332,-7272423.0,-1.0
4181,2019-08-12,IBM,104.30114727737543,104.46260019159354,102.39441498908516,102.77114868164062,4271759.0,0.0,0.0,-1.8913345336914205,1.8913345336914205,0.0,24.04545383120309,102.39441498908516,116.22498511368288,2.723920193900319,-97.27607980609967,-0.6906006529042514,0.6980688508929048,-0.09698210370867344,-11544182.0,-1.0
4182,2019-08-13,IBM,102.871093994052,105.00078878268984,102.1099386971964,104.40109252929688,4730117.0,0.0,0.0,1.62994384765625,0.0,1.62994384765625,33.899353893328296,102.1099386971964,116.22498511368288,16.231996441927336,-83.76800355807266,-0.9360044595144785,0.37125418881142813,-0.07319229265646954,-6814065.0,1.0
4183,2019-08-14,IBM,102.955660492583,103.14787743620552,100.70295865818709,100.9105453491211,5349453.0,0.0,0.0,-3.4905471801757812,3.4905471801757812,0.0,25.670239821673903,100.70295865818709,116.22498511368288,1.3373684907005738,-98.66263150929943,-1.3960538897842127,0.017792573092299875,-0.11657489693688705,-12163518.0,-1.0
4184,2019-08-15,IBM,100.88747264604196,101.77164105788096,100.14169330410408,101.4256591796875,3910889.0,0.0,0.0,0.5151138305664062,0.0,0.5151138305664062,28.62071170237013,100.14169330410408,116.22498511368288,7.983228127582204,-92.01677187241779,-1.6994903299813018,-0.3256640075224206,-0.09355282149929078,-8252629.0,1.0
4185,2019-08-16,IBM,102.2867710702727,103.47847560577569,102.21757346256936,102.84033966064452,3150552.0,0.0,0.0,1.414680480957017,0.0,1.414680480957017,36.59603379749495,100.14169330410408,116.22498511368288,16.77919165113445,-83.22080834886555,-1.805006017353051,-0.6215324094885468,-0.038533239693762766,-5102077.0,1.0
4186,2019-08-19,IBM,103.7014481951558,104.81626722336328,103.7014481951558,103.82445526123048,3310695.0,0.0,0.0,0.9841156005859659,0.0,0.9841156005859659,41.81431889194592,100.14169330410408,116.22498511368288,22.89806092390268,-77.10193907609732,-1.788600185847102,-0.854945964760258,-0.02912563384100053,-1791382.0,1.0
4187,2019-08-20,IBM,103.9782072475685,104.00895900843314,102.1099211981358,102.2560043334961,3157456.0,0.0,0.0,-1.5684509277343892,1.5684509277343892,0.0,36.31762510505141,100.14169330410408,116.22498511368288,13.146009252488868,-86.85399074751113,-1.8804822985793948,-1.0600532315240856,-0.03265707351839975,-4948838.0,-1.0
4188,2019-08-21,IBM,103.76295370685229,104.51642108594991,102.87109724015392,103.21707916259766,2934762.0,0.0,0.0,0.9610748291015625,0.0,0.9610748291015625,41.733055013062675,100.14169330410408,116.22498511368288,19.121619472588037,-80.87838052741196,-1.8543727732011064,-1.2189171398594898,-0.04175581160293429,-2014076.0,1.0
4189,2019-08-22,IBM,103.55536153665804,104.31652299804524,102.8787858422365,103.27088928222656,2818865.0,0.0,0.0,0.05381011962890625,0.0,0.05381011962890625,42.051409682966586,100.14169330410408,110.25984591535094,30.926554464539475,-69.07344553546054,-1.8084915939377453,-1.3368320306751411,-0.013296014869458306,804789.0,1.0
4190,2019-08-23,IBM,102.74036574599975,103.22473047734051,99.04992162964516,99.61886596679688,5040046.0,0.0,0.0,-3.6520233154296875,3.6520233154296875,0.0,29.450556059066272,99.04992162964516,108.26133345213236,6.17651613146634,-93.82348386853366,-2.0432647055014144,-1.478118565640396,-0.03067283722408065,-4235257.0,-1.0
4191,2019-08-26,IBM,100.756758472923,100.9489692508233,99.30365186389868,99.94178771972656,2964259.0,0.0,0.0,0.3229217529296875,0.0,0.3229217529296875,31.543444676839016,99.04992162964516,107.96082437434868,10.008706363802663,-89.99129363619733,-2.1781585453190218,-1.6181265615761211,-0.04271320061443751,-1270998.0,1.0
4192,2019-08-27,IBM,100.87208573288066,101.25650729638076,100.18782222175258,100.8490219116211,4945488.0,0.0,0.0,0.9072341918945312,0.0,0.9072341918945312,37.54911052113761,99.04992162964516,107.96082437434868,20.189876755700105,-79.81012324429989,-2.186650324223635,-1.7318313141056243,-0.0006096829353874345,3674490.0,1.0
4193,2019-08-28,IBM,100.28778974384686,102.17145206473155,99.98024752885284,102.07150268554688,2838426.0,0.0,0.0,1.2224807739257812,0.0,1.2224807739257812,45.045010552660116,99.04992162964516,107.107407878446,37.50029429279395,-62.49970570720605,-2.070864501522621,-1.799637951589024,0.0063676540146038185,6512916.0,1.0
4194,2019-08-29,IBM,103.1632614037842,104.32420814857568,103.05561794351898,103.70145416259766,3108503.0,0.0,0.0,1.6299514770507812,0.0,1.6299514770507812,53.61105291438698,99.04992162964516,105.00078878268984,78.16562550169861,-21.834374498301386,-1.8265248986557054,-1.8050153410023604,0.00837331444834466,9621419.0,1.0
4195,2019-08-30,IBM,104.239620703379,104.61636049264492,103.30164281105894,104.20118713378906,3096788.0,0.0,0.0,0.49973297119140625,0.0,0.49973297119140625,56.035361134847975,99.04992162964516,105.00078878268984,86.56327509358582,-13.436724906414184,-1.574410899862599,-1.7588944527744081,0.0036285465848164833,12718207.0,1.0
4196,2019-09-03,IBM,103.6783795425012,103.7168253867623,102.50973877251631,103.10175323486328,2957983.0,0.0,0.0,-1.0994338989257812,1.0994338989257812,0.0,49.472193306239134,99.04992162964516,104.81626722336328,70.26688808995773,-29.733111910042265,-1.4466478112653647,-1.6964451244725995,0.00827089721410279,9760224.0,-1.0
4197,2019-09-04,IBM,104.33957575448945,104.89314435352728,103.90902649010069,104.8085708618164,2351303.0,0.0,0.0,1.706817626953125,0.0,1.706817626953125,58.234774712244004,99.04992162964516,104.89314435352728,98.55262248749811,-1.4473775125018866,-1.1939061184904602,-1.5959373232761718,0.015418879434784927,12111527.0,1.0
4198,2019-09-05,IBM,106.3308731916796,108.94493261230426,106.1386685344114,108.38368225097656,5242134.0,0.0,0.0,3.5751113891601562,0.0,3.5751113891601562,70.56990313522152,99.04992162964516,108.94493261230426,94.32794604966807,-5.672053950331933,-0.6970892840644183,-1.4161677154338213,0.049508559520363704,17353661.0,1.0
4199,2019-09-06,IBM,108.80655096897722,108.8142327743069,107.99158014252272,108.07614135742188,2695333.0,0.0,0.0,-0.3075408935546875,0.3075408935546875,0.0,68.56006416259697,99.04992162964516,108.94493261230426,91.21990610818999,-8.780093891810013,-0.32443446473709514,-1.197821065294476,0.08489632268494018,14658328.0,-1.0
4200,2019-09-09,IBM,108.0915261079657,109.95981227860987,107.99157674304443,109.63689422607422,4421024.0,0.0,0.0,1.5607528686523438,0.0,1.5607528686523438,73.0538967415266,99.04992162964516,109.95981227860987,97.04013483795735,-2.9598651620426493,0.09573332300143989,-0.9391101876352929,0.09700753536184781,19079352.0,1.0
4201,2019-09-10,IBM,109.94443374590654,111.83577755745932,109.91366971253451,111.5205535888672,5208766.0,0.0,0.0,1.883659362792983,0.0,1.883659362792983,77.52703005625223,99.04992162964516,111.83577755745932,97.53458845170945,-2.4654115482905445,0.5740970566034491,-0.6364687387875444,0.10581690803702681,24288118.0,1.0
4202,2019-09-11,IBM,111.36680974059963,111.57440259254275,109.72149189490104,110.40576171875,4047706.0,0.0,0.0,-1.1147918701172017,1.1147918701172017,0.0,69.63346472311001,99.04992162964516,111.83577755745932,88.81564248195158,-11.184357518048419,0.8534117749819643,-0.3384926360336426,0.08165118386547698,20240412.0,-1.0
4203,2019-09-12,IBM,110.73635133565394,110.7440454129753,109.08333956587305,110.42112731933594,2620648.0,0.0,0.0,0.0153656005859375,0.0,0.0153656005859375,69.68255735089829,99.04992162964516,111.83577755745932,88.93581903229509,-11.064180967704914,1.0637483484023704,-0.058044439146439926,0.06479825390107097,22861060.0,1.0
4204,2019-09-13,IBM,110.95931105669044,111.2130192476376,110.14434021822014,110.45956420898438,2308104.0,0.0,0.0,0.0384368896484375,0.0,0.0384368896484375,69.82336893785453,99.30365186389868,111.83577755745932,89.01851623478302,-10.981483765216984,1.2194856623828656,0.19746158115942125,0.060060516077997006,25169164.0,1.0
4205,2019-09-16,IBM,109.6061401242742,110.43648678878483,109.38317144141784,109.54462432861328,2017211.0,0.0,0.0,-0.9149398803710938,0.9149398803710938,0.0,61.92392482337819,99.98024752885284,111.83577755745932,80.6743922598343,-19.325607740165694,1.2546181468407696,0.408892894295691,0.062490412544908835,23151953.0,-1.0
4206,2019-09-17,IBM,109.5446203018903,109.5446203018903,108.14532927428904,109.329345703125,3068127.0,0.0,0.0,-0.21527862548828125,0.21527862548828125,0.0,60.07860423765733,99.98024752885284,111.83577755745932,78.85854239931494,-21.14145760068505,1.2506727312421475,0.5772488616849824,0.04313363691666927,20083826.0,-1.0
4207,2019-09-18,IBM,109.21403305663624,109.40624999238744,108.0300164912747,109.34473419189452,2074846.0,0.0,0.0,0.01538848876951704,0.0,0.01538848876951704,60.17648467751396,102.50973877251631,111.83577755745932,73.28937373082103,-26.710626269178967,1.234556484720656,0.7087103862921171,0.008867127605911351,22158672.0,1.0
4208,2019-09-19,IBM,109.5292481852756,111.50517775028688,109.52156638037005,109.9213638305664,3232035.0,0.0,0.0,0.5766296386718892,0.0,0.5766296386718892,63.99346897719205,102.50973877251631,111.83577755745932,79.47238081420207,-20.52761918579793,1.2538597216167204,0.8177402533570379,0.017073356339047496,25390707.0,1.0
4209,2019-09-20,IBM,110.13661282943649,110.582537819148,109.03717009702224,109.0832977294922,5432296.0,0.0,0.0,-0.8380661010742045,0.8380661010742045,0.0,55.13185891710411,102.50973877251631,111.83577755745932,70.486077836058,-29.513922163942,1.187840064721783,0.8917602156299871,-0.0050493631773305125,19958411.0,-1.0
4210,2019-09-23,IBM,108.55284779723164,109.3447487912959,108.06847676167304,109.22942352294922,1901523.0,0.0,0.0,0.14612579345701704,0.0,0.14612579345701704,56.34798279355815,103.90902649010069,111.83577755745932,67.11951703336891,-32.880482966631085,1.1342353818494075,0.9402552488738714,-0.020544464604834056,21859934.0,1.0
4211,2019-09-24,IBM,109.56002571603608,109.8598738406235,108.46057032129356,108.9295654296875,3380254.0,0.0,0.0,-0.29985809326171875,0.29985809326171875,0.0,52.94984319463299,106.1386685344114,111.83577755745932,48.987949572061865,-51.012050427938135,1.0553913478647132,0.9632824686720397,-0.01337064539098054,18479680.0,-1.0
4212,2019-09-25,IBM,108.97571001334492,110.42882304958914,108.29912204916472,110.06745910644533,2642928.0,0.0,0.0,1.1378936767578267,0.0,1.1378936767578267,62.778434808096605,107.99157674304443,111.83577755745932,54.00036219795804,-45.99963780204196,1.0723638498931223,0.9850987449162563,-0.0032029034794022193,21122608.0,1.0
4213,2019-09-26,IBM,110.07515550417152,110.62103006222829,108.7219918185435,110.3673095703125,2416051.0,0.0,0.0,0.2998504638671733,0.0,0.2998504638671733,65.001396017432,107.99157674304443,111.83577755745932,61.80043504386145,-38.19956495613856,1.097360418686634,1.007551079670332,-0.0008351892326619037,23538659.0,1.0
4214,2019-09-27,IBM,111.02850862317868,111.55131315828572,109.4677522807884,110.1289520263672,2465213.0,0.0,0.0,-0.2383575439452983,0.2383575439452983,0.0,61.625642001714766,108.0300164912747,111.83577755745932,55.15153207441747,-44.84846792558253,1.0854248161595592,1.0231258269681773,0.005334152189897079,21073446.0,-1.0
4215,2019-09-30,IBM,110.50570413314378,112.68921462350887,110.50570413314378,111.80504608154295,4171866.0,0.0,0.0,1.6760940551757528,0.0,1.6760940551757528,73.00188652058236,108.0300164912747,112.68921462350887,81.02316070551086,-18.976839294489135,1.1974095557189486,1.0579825727183316,0.022644426914805837,25245312.0,1.0
4216,2019-10-01,IBM,111.93571529359554,113.28887858502408,110.35959561434098,110.45185089111328,3096997.0,0.0,0.0,-1.3531951904296733,1.3531951904296733,0.0,57.2041376746543,108.0300164912747,113.28887858502408,46.05244170059428,-53.94755829940572,1.1635539996617439,1.0790968581070142,0.010125011573724585,22148315.0,-1.0
4217,2019-10-02,IBM,109.32168511931197,109.38318865339689,108.0761526553015,108.93726348876952,3494477.0,0.0,0.0,-1.5145874023437642,1.5145874023437642,0.0,44.709071198832156,108.0300164912747,113.28887858502408,17.25177388798929,-82.74822611201071,1.002947329633244,1.0638669524122601,-0.008952766846250126,18653838.0,-1.0
4218,2019-10-03,IBM,108.88343680496784,109.22941257533212,107.00746865946029,109.19097900390624,3063525.0,0.0,0.0,0.25371551513671875,0.0,0.25371551513671875,46.94885689278125,107.00746865946029,113.28887858502408,34.761468688098184,-65.23853131190181,0.8859257081160337,1.0282787035530148,0.0009871472228595302,21717363.0,1.0
4219,2019-10-04,IBM,109.22173839820113,109.99058167799218,108.429825156939,109.93675994873048,2524626.0,0.0,0.0,0.7457809448242472,0.0,0.7457809448242472,53.35724672805209,107.00746865946029,113.28887858502408,46.634295866421674,-53.365704133578326,0.8436385790715377,0.9913506786567193,0.006475694945260457,24241989.0,1.0
4220,2019-10-07,IBM,109.37548412779168,109.71376576624677,108.5758892657562,108.62201690673828,2538119.0,0.0,0.0,-1.3147430419922017,1.3147430419922017,0.0,42.832627387304456,107.00746865946029,113.28887858502408,25.703596269162126,-74.29640373083787,0.6960137358256304,0.9322832900905016,-0.002823370512275991,21703870.0,-1.0
4221,2019-10-08,IBM,107.82242724073296,107.99925600864565,106.2924227687766,106.39237213134766,3373768.0,0.0,0.0,-2.229644775390625,2.229644775390625,0.0,30.90439811351976,106.2924227687766,113.28887858502408,1.4285713394908608,-98.57142866050914,0.39455806475194777,0.8247382450227909,-0.03338940505152865,18330102.0,-1.0
4222,2019-10-09,IBM,107.46106519767376,107.8916266887215,106.7075979274078,107.38418579101562,2741357.0,0.0,0.0,0.9918136596679688,0.0,0.9918136596679688,39.545553713893845,106.2924227687766,113.28887858502408,15.604515356241965,-84.39548464375804,0.23299749685006077,0.7063900953882449,-0.02702905227019592,21071459.0,1.0
4223,2019-10-10,IBM,107.46107260761664,109.00645309366588,107.2996197068746,108.50670623779295,2713010.0,0.0,0.0,1.1225204467773295,0.0,1.1225204467773295,48.03273307053783,106.2924227687766,113.28887858502408,31.648645073613483,-68.3513549263865,0.19330925283109934,0.6037739268768159,-0.01473042064529817,23784469.0,1.0
4224,2019-10-11,IBM,109.7676076482334,111.09770130404492,109.64458831176164,109.75992584228516,3134653.0,0.0,0.0,1.2532196044922017,0.0,1.2532196044922017,55.99160457171574,106.2924227687766,113.28887858502408,49.56085144504401,-50.43914855495599,0.2599834545668358,0.5350158324148199,-0.018291842013697934,26919122.0,1.0
4225,2019-10-14,IBM,109.41393278256064,109.5062003485029,108.652783651998,109.20635223388672,2415737.0,0.0,0.0,-0.5535736083984375,0.5535736083984375,0.0,51.93746697391344,106.2924227687766,113.28887858502408,41.64865099759882,-58.35134900240118,0.2650985845494631,0.4810323828417485,-0.011276394620624464,24503385.0,-1.0
4226,2019-10-15,IBM,109.5907881228999,110.49801439060307,109.02952539099844,109.9444580078125,3164673.0,0.0,0.0,0.7381057739257812,0.0,0.7381057739257812,56.754779471390755,106.2924227687766,113.28887858502408,52.19836064075443,-47.80163935924557,0.324965331207423,0.4498189725148834,0.009245638147931112,27668058.0,1.0
4227,2019-10-16,IBM,109.5523316598406,109.90600151048038,108.7066090119018,109.26017761230467,5577900.0,0.0,0.0,-0.6842803955078267,0.6842803955078267,0.0,51.258972594269586,106.2924227687766,113.28887858502408,42.41797449268842,-57.58202550731157,0.31357969853476675,0.4225711177188601,0.0006337392432020916,22090158.0,-1.0
4228,2019-10-17,IBM,103.79368345924487,104.56252655882288,102.18680579877802,103.22473907470705,16484751.0,0.0,0.0,-6.035438537597628,6.035438537597628,0.0,25.816803564171508,102.18680579877802,113.28887858502408,9.3490044238845,-90.6509955761155,-0.18037371124260915,0.3019821519265662,-0.06105347180646059,5605407.0,-1.0
4229,2019-10-18,IBM,103.19398163962164,103.4015744190188,101.67936547981596,103.09403228759766,7507665.0,0.0,0.0,-0.1307067871093892,0.1307067871093892,0.0,25.500524414336894,101.67936547981596,113.28887858502408,12.185410317914785,-87.81458968208523,-0.5757454573476508,0.12643663007172273,-0.050891934955386575,-1902258.0,-1.0
4230,2019-10-21,IBM,101.9561677982418,102.33289531835392,100.64144397369678,101.93309783935548,6596181.0,0.0,0.0,-1.1609344482421733,1.1609344482421733,0.0,22.656005072722664,100.64144397369678,111.09770130404492,12.352927293686804,-87.6470727063132,-0.971558599513699,-0.0931624158453617,-0.041913477467039995,-8498439.0,-1.0
4231,2019-10-22,IBM,101.91003527951462,103.06330008428952,101.1873258590486,102.99410247802734,4353034.0,0.0,0.0,1.0610046386718608,0.0,1.0610046386718608,30.796408098609504,100.64144397369678,111.09770130404492,22.500005786030442,-77.49999421396956,-1.1859581716356047,-0.31172156700341036,-0.040882028211602695,-4145405.0,1.0
4232,2019-10-23,IBM,102.65581073581976,103.46309361405822,102.02535663362832,103.3170166015625,3777001.0,0.0,0.0,0.32291412353515625,0.0,0.32291412353515625,33.263034781423016,100.64144397369678,111.09770130404492,25.588243893923345,-74.41175610607665,-1.3146603203193479,-0.5123093176665979,-0.04782828468553113,-368404.0,1.0
4233,2019-10-24,IBM,103.66300232326375,103.8475251935813,102.4866736267102,103.07868194580078,2718031.0,0.0,0.0,-0.23833465576171875,0.23833465576171875,0.0,32.28309800580408,100.64144397369678,111.09770130404492,23.30889433095899,-76.69110566904102,-1.4195259042739963,-0.6937526349880777,-0.06087143231205083,-3086435.0,-1.0
4234,2019-10-25,IBM,103.1171416262758,104.50873901076008,103.10176574095745,104.13201141357422,2697739.0,0.0,0.0,1.0533294677734375,0.0,1.0533294677734375,41.12759091755525,100.64144397369678,111.09770130404492,33.38257016443589,-66.61742983556411,-1.4014823341109661,-0.8352985748126556,-0.04646561959550488,-388696.0,1.0
4235,2019-10-28,IBM,104.56253681623684,105.04690777106192,104.13966938861036,104.53946685791016,3374501.0,0.0,0.0,0.4074554443359375,0.0,0.4074554443359375,44.370570828217936,100.64144397369678,111.09770130404492,37.27933199290909,-62.72066800709091,-1.3388707569808247,-0.9360130112462893,-0.04916110596059575,2985805.0,1.0
4236,2019-10-29,IBM,104.11660963327502,104.2319348801087,102.59429919531463,102.88645935058594,4352092.0,0.0,0.0,-1.6530075073242188,1.6530075073242188,0.0,35.274798189085416,100.64144397369678,111.09770130404492,21.47054444015304,-78.52945555984697,-1.406422162867898,-1.030094841570611,-0.05833523614006042,-1366287.0,-1.0
4237,2019-10-30,IBM,102.89414729465148,104.00896619491576,102.40977634943276,103.98590850830078,2356638.0,0.0,0.0,1.0994491577148438,0.0,1.0994491577148438,44.0733573860486,100.64144397369678,111.09770130404492,31.985292910658004,-68.014707089342,-1.3556141046099555,-1.09519869417848,0.007373905135694692,990351.0,1.0
4238,2019-10-31,IBM,103.87827946305362,103.98592291968905,102.4328543678236,102.81727600097656,3569057.0,0.0,0.0,-1.1686325073242188,1.1686325073242188,0.0,37.775422128344765,100.64144397369678,110.49801439060307,22.07494022005593,-77.92505977994408,-1.3935828731732016,-1.1548755299774243,-0.002684503462324961,-2578706.0,-1.0
4239,2019-11-01,IBM,103.4092739856673,104.2242448212921,103.09404999600368,104.20118713378906,3231931.0,0.0,0.0,1.3839111328125,0.0,1.3839111328125,47.94029412080929,100.64144397369678,110.49801439060307,36.1154337616916,-63.8845662383084,-1.297051728282753,-1.1833107696384901,0.0222507639079903,653225.0,1.0
4240,2019-11-04,IBM,104.74706115525234,105.9003259341154,104.73936707861613,105.84650421142578,3488828.0,0.0,0.0,1.6453170776367188,0.0,1.6453170776367188,57.47080939259977,100.64144397369678,109.90600151048038,56.18250215472303,-43.81749784527697,-1.0753903324655738,-1.161726682203907,0.02769480644784461,4142053.0,1.0
4241,2019-11-05,IBM,105.94646553445745,106.68455703961185,105.81576438693132,106.01566314697266,3153690.0,0.0,0.0,0.169158935546875,0.0,0.169158935546875,58.3748006752039,100.64144397369678,106.68455703961185,88.93130270204693,-11.068697297953072,-0.8759746761268445,-1.1045762809884945,0.02612005876841539,7295743.0,1.0
4242,2019-11-06,IBM,106.10023202964427,106.6999282836914,105.75425625336834,106.6999282836914,4683256.0,0.0,0.0,0.68426513671875,0.0,0.68426513671875,62.13170592695938,100.64144397369678,106.6999282836914,100.0,-0.0,-0.6551694680761528,-1.014694918406026,0.035130894861409745,11978999.0,1.0
4243,2019-11-07,IBM,107.2522429278752,108.24019918232884,107.02664075188646,107.11221313476562,4261195.0,1.548757,0.0,0.41228485107421875,0.0,0.41228485107421875,64.36754495632562,100.64144397369678,108.24019918232884,85.15564698963011,-14.844353010369895,-0.44181879594988516,-0.9001196939147978,0.02861945794319798,16240194.0,1.0
4244,2019-11-08,IBM,107.0266529821142,107.04999542236328,105.922009245902,107.04999542236328,2383206.0,0.0,0.0,-0.06221771240234375,0.06221771240234375,0.0,63.71252552900716,101.1873258590486,108.24019918232884,83.1245549804941,-16.875445019505907,-0.27459197523403134,-0.7750141501786445,0.024015126917238172,13856988.0,-1.0
4245,2019-11-11,IBM,106.7310391152334,106.7310391152334,105.01960382541948,105.38522338867188,2686128.0,0.0,0.0,-1.6647720336914062,1.6647720336914062,0.0,48.480892134640115,102.02535663362832,108.24019918232884,54.06197709298494,-45.93802290701506,-0.2732468850504546,-0.6746606971530066,0.0242866170520204,11170860.0,-1.0
4246,2019-11-12,IBM,105.69641681810388,106.31098111164034,105.035180055945,105.47859954833984,3186639.0,0.0,0.0,0.09337615966796875,0.0,0.09337615966796875,49.265858622561204,102.40977634943276,108.24019918232884,52.63465938683461,-47.365340613165394,-0.26163030439123247,-0.5920546186006518,0.014354743459493946,14357499.0,1.0
4247,2019-11-13,IBM,105.32300623634922,105.47080858666274,104.12500511280236,104.61509704589844,3052646.0,0.0,0.0,-0.8635025024414062,0.8635025024414062,0.0,42.376437604585114,102.40977634943276,108.24019918232884,37.824369855697995,-62.175630144302005,-0.3184308433357046,-0.5373298635476623,0.017485593033069735,11304853.0,-1.0
4248,2019-11-14,IBM,104.34280619924354,104.49839347786762,103.72046950093734,104.2416763305664,4425940.0,0.0,0.0,-0.37342071533203125,0.37342071533203125,0.0,39.61236078924183,102.40977634943276,108.24019918232884,31.419676301996567,-68.58032369800343,-0.38909239565960263,-0.5076823699700503,0.0003885675191526161,6878913.0,-1.0
4249,2019-11-15,IBM,104.54506386485548,105.1129555581511,104.26501670183386,104.55284881591795,3412575.0,0.0,0.0,0.3111724853515483,0.0,0.3111724853515483,43.17611138261978,102.40977634943276,108.24019918232884,36.75672464771635,-63.24327535228365,-0.4151970330287895,-0.48918530258179815,-0.012221994530152713,10291488.0,1.0
4250,2019-11-18,IBM,104.47504891124656,104.61507870077352,103.64267374942789,104.48283386230467,3358078.0,0.0,0.0,-0.07001495361328125,0.07001495361328125,0.0,42.524577830883274,102.40977634943276,108.24019918232884,35.555869141692895,-64.44413085830712,-0.4365030325888455,-0.4786488485832077,-0.014458517158384199,6933410.0,-1.0
4251,2019-11-19,IBM,104.92625403916357,105.31521602262102,104.59952199987852,104.6461944580078,3132770.0,0.0,0.0,0.163360595703125,0.0,0.163360595703125,44.76838440789153,102.4328543678236,108.24019918232884,38.11277203061636,-61.88722796938364,-0.4351897592811014,-0.4699570307227865,-0.019247752634127258,10066180.0,1.0
4252,2019-11-20,IBM,104.2883634994488,104.59953810058896,103.2692921339081,103.61935424804688,4328557.0,0.0,0.0,-1.0268402099609233,1.0268402099609233,0.0,34.88961427556477,103.09404999600368,108.24019918232884,10.207715187097326,-89.79228481290268,-0.5111145931333709,-0.4781885432049034,-0.032609342898406335,5737623.0,-1.0
4253,2019-11-21,IBM,103.77493467034502,104.37392897597908,103.44820260242304,104.11721801757812,3499184.0,0.0,0.0,0.49786376953125,0.0,0.49786376953125,42.044191705999054,103.2692921339081,108.24019918232884,17.057769847847304,-82.94223015215269,-0.5250595657543613,-0.487562747714795,-0.027396333771094072,9236807.0,1.0
4254,2019-11-22,IBM,104.38948003691809,104.74732705762348,103.9227306110704,104.50617980957033,3449185.0,0.0,0.0,0.3889617919922017,0.0,0.3889617919922017,47.26761761362873,103.2692921339081,108.24019918232884,24.882534789202925,-75.11746521079708,-0.49897323821014083,-0.48984484581386417,-0.00834124131292624,12685992.0,1.0
4255,2019-11-25,IBM,104.60732668514032,105.79754288101633,104.51396933507988,105.77420043945312,2709245.0,0.0,0.0,1.2680206298827983,0.0,1.2680206298827983,60.61868456711446,103.2692921339081,108.24019918232884,50.39137286505567,-49.60862713494432,-0.3716962847508256,-0.4662151336012565,0.0028024726568143254,15395237.0,1.0
4256,2019-11-26,IBM,105.91422667971052,105.91422667971052,104.840697895519,105.08963012695312,3967687.0,0.0,0.0,-0.6845703125,0.6845703125,0.0,52.36054221098282,103.2692921339081,108.24019918232884,36.61983568216894,-63.38016431783105,-0.32235161640234367,-0.43744243016147394,0.0045359904493180725,11427550.0,-1.0
4257,2019-11-27,IBM,105.29186759463082,105.57191474366265,103.9460644232405,104.06275177001952,3431821.0,0.0,0.0,-1.026878356933608,1.026878356933608,0.0,42.37010967698216,103.2692921339081,107.04999542236328,20.987090908041957,-79.01290909195804,-0.36193396321914406,-0.422340736773008,-0.0017164397853646207,7995729.0,-1.0
4258,2019-11-29,IBM,103.93050826671282,104.64619609253909,103.4870950751786,104.5917510986328,1909264.0,0.0,0.0,0.5289993286132812,0.0,0.5289993286132812,48.240345543662755,103.2692921339081,106.7310391152334,38.20206883573013,-61.79793116426987,-0.34662179319228414,-0.4071969480568633,0.00037208247460895905,9904993.0,1.0
4259,2019-12-02,IBM,104.5917525886966,104.63064009687078,103.05924083816132,103.39374542236328,3208187.0,0.0,0.0,-1.198005676269517,1.198005676269517,0.0,38.09941648732208,103.05924083816132,106.31098111164034,10.286940409422064,-89.71305959057794,-0.42624237725321734,-0.4110060338961341,-0.01042361122571267,6696806.0,-1.0
4260,2019-12-03,IBM,102.68583131150234,103.02811462223131,101.66675391409426,102.77918243408205,3810055.0,0.0,0.0,-0.6145629882812358,0.6145629882812358,0.0,33.88333568684591,101.66675391409426,105.91422667971052,26.19036263146905,-73.80963736853094,-0.5327906814686543,-0.4353629634106382,-0.017841184130923615,2886751.0,-1.0
4261,2019-12-04,IBM,103.3548580622906,103.99275854332032,102.65473383576092,102.67807006835938,3692380.0,0.0,0.0,-0.10111236572267046,0.10111236572267046,0.0,33.18617391833877,101.66675391409426,105.91422667971052,23.809832577428786,-76.19016742257122,-0.6182629526185366,-0.47194296125221785,-0.009084057573204185,-805629.0,-1.0
4262,2019-12-05,IBM,103.4559896778386,103.65047069060498,102.39801222341806,102.61582946777344,3760788.0,0.0,0.0,-0.0622406005859375,0.0622406005859375,0.0,32.70818127745406,101.66675391409426,105.91422667971052,22.344476493458533,-77.65552350654147,-0.6831477377243829,-0.5141839165466509,-0.014420175436796745,-4566417.0,-1.0
4263,2019-12-06,IBM,103.26928338250885,104.15610981307935,103.23038345661486,103.63490295410156,3595625.0,0.0,0.0,1.019073486328125,0.0,1.019073486328125,47.102179340379486,101.66675391409426,105.91422667971052,46.33694313333039,-53.66305686666961,-0.6449046247216046,-0.5403280581816416,-0.008337084534679073,-970792.0,1.0
4264,2019-12-09,IBM,103.73603157076492,104.70065784142815,103.6660228795763,104.17945098876952,3105051.0,0.0,0.0,0.5445480346679545,0.0,0.5445480346679545,53.26575841476361,101.66675391409426,105.91422667971052,59.157461703246305,-40.842538296753695,-0.5641530020852485,-0.545093046962363,-0.015076922766213419,2134259.0,1.0
4265,2019-12-10,IBM,104.17946158809498,104.89515572449014,103.89940817056156,104.1716766357422,3640498.0,0.0,0.0,-0.007774353027315328,0.007774353027315328,0.0,53.163714648346364,101.66675391409426,105.91422667971052,58.97442690923304,-41.02557309076696,-0.4950771435423178,-0.535089866278354,-0.008734957865033866,-1506239.0,-1.0
4266,2019-12-11,IBM,104.32725348428814,104.63842805576752,103.98497014699431,104.05498504638672,4135152.0,0.0,0.0,-0.11669158935548296,0.11669158935548296,0.0,51.45644793731145,101.66675391409426,105.91422667971052,56.22710877925906,-43.772891220740945,-0.4446247071562084,-0.5169968344539249,-7.46350014840802e-05,-5641391.0,-1.0
4267,2019-12-12,IBM,104.00830092489176,105.53303389606482,103.97718595261315,105.2685317993164,5046009.0,0.0,0.0,1.2135467529296875,0.0,1.2135467529296875,64.95925920232423,101.66675391409426,105.91422667971052,84.79813959912622,-15.201860400873779,-0.30322234841877105,-0.47424193724689406,0.006470689070358748,-595382.0,1.0
4268,2019-12-13,IBM,104.82513682068604,105.4085736581786,104.24947251905796,104.40505981445312,2651610.0,0.0,0.0,-0.8634719848632812,0.8634719848632812,0.0,52.88263893966523,101.66675391409426,105.91422667971052,64.46906316918,-35.53093683082,-0.2578624553410265,-0.43096604086572055,0.009781195061254744,-3246992.0,-1.0
4269,2019-12-16,IBM,104.9729409419849,105.36967551496116,104.1250019631013,104.3428192138672,3189463.0,0.0,0.0,-0.06224060058592329,0.06224060058592329,0.0,52.07739579631634,101.66675391409426,105.91422667971052,63.00370708521008,-36.99629291478992,-0.22435053624889179,-0.38964293994235477,0.015213555340236384,-6436455.0,-1.0
4270,2019-12-17,IBM,104.45948373363925,104.77843079592895,103.82158960905984,104.41281127929688,3040931.0,0.0,0.0,0.06999206542967329,0.0,0.06999206542967329,53.005892285514406,101.66675391409426,105.57191474366265,70.3186753388111,-29.681324661188896,-0.18995464528772743,-0.34970528101142934,0.01689495341880276,-3395524.0,1.0
4271,2019-12-18,IBM,104.66954562591638,105.01960771537064,104.35837104671856,104.56063079833984,3244483.0,0.0,0.0,0.14781951904296875,0.0,0.14781951904296875,55.12463737351163,101.66675391409426,105.53303389606482,74.8491288199629,-25.150871180037104,-0.14904970190120537,-0.3095741651893846,0.01895225464388184,-151041.0,1.0
4272,2019-12-19,IBM,104.5995349478508,104.80957965971824,104.38949023598336,104.67732238769533,4044359.0,0.0,0.0,0.11669158935548296,0.0,0.11669158935548296,56.894829265524685,101.66675391409426,105.53303389606482,77.86731658441983,-22.132683415580175,-0.10599436645716764,-0.2688582054429412,0.010058574899765471,3893318.0,1.0
4273,2019-12-20,IBM,105.59528692799226,106.12427882095793,104.9807226344558,105.47859954833984,7438943.0,0.0,0.0,0.801277160644517,0.0,0.801277160644517,67.15892792328492,101.66675391409426,106.12427882095793,85.51484767647918,-14.485152323520827,-0.007134095200825641,-0.2165133833945181,0.012470295698816525,11332261.0,1.0
4274,2019-12-23,IBM,105.62638893449412,105.91422107993785,105.01960966834646,105.44747161865234,2932147.0,0.0,0.0,-0.0311279296875,0.0311279296875,0.0,66.44967733571985,102.39801222341806,106.12427882095793,81.8368550776152,-18.1631449223848,0.06791869381642357,-0.15962696795232975,0.012247042805802355,8400114.0,-1.0
4275,2019-12-24,IBM,105.49414310478468,105.50192805662326,104.71621906571735,105.0040512084961,1257397.0,0.0,0.0,-0.44342041015625,0.44342041015625,0.0,56.62115897236672,102.39801222341806,106.12427882095793,69.9369977123638,-30.0630022876362,0.09057416595345558,-0.10958674117117267,0.009120813978170217,7142717.0,-1.0
4276,2019-12-26,IBM,105.00404237065077,105.26075951685034,104.7473252244512,104.9495849609375,2227666.0,0.0,0.0,-0.05446624755859375,0.05446624755859375,0.0,55.45857700601464,103.23038345661486,106.12427882095793,59.40786683256292,-40.592133167437076,0.10294710966351772,-0.06707997100423459,-0.003029840284910046,4915051.0,-1.0
4277,2019-12-27,IBM,105.01961531559166,105.60306458976376,104.91848543246232,105.22966003417967,2878801.0,0.0,0.0,0.2800750732421733,0.0,0.2800750732421733,60.29560220638077,103.6660228795763,106.12427882095793,63.607581630599185,-36.39241836940082,0.1338099960806005,-0.026901977587267555,0.007898086751657596,7793852.0,1.0
4278,2019-12-30,IBM,105.17519378519904,105.25298122100082,103.0748026485462,103.31595611572266,4308369.0,0.0,0.0,-1.913703918457017,1.913703918457017,0.0,32.48379472504541,103.0748026485462,106.12427882095793,7.9080292332876185,-92.09197076671238,0.0038052783130240186,-0.02076052640720924,-0.009841243565020252,3485483.0,-1.0
4279,2019-12-31,IBM,103.09814561386582,104.33504662915202,102.99701573262205,104.2728042602539,3951265.0,0.0,0.0,0.95684814453125,0.0,0.95684814453125,46.67426032632108,102.99701573262205,106.12427882095793,40.79568912479153,-59.20431087520846,-0.021763868275186837,-0.02096119478080476,-0.0013408988545329237,7436748.0,1.0
4280,2020-01-02,IBM,105.01959670307392,105.73529071046698,104.8406794093205,105.34632873535156,3293436.0,0.0,0.0,1.0735244750976562,0.0,1.0735244750976562,58.0800676621716,102.99701573262205,106.12427882095793,75.12361244859842,-24.876387551401578,0.04408862592445928,-0.00795123063975195,0.007514280767175752,10730184.0,1.0
4281,2020-01-03,IBM,103.9071731246215,104.9106992896224,103.89939438139704,104.50617980957033,2482890.0,0.0,0.0,-0.8401489257812358,0.8401489257812358,0.0,48.67816819643867,102.99701573262205,106.12427882095793,48.258302365962976,-51.741697634037024,0.028159598800044705,-0.000729064751792616,-0.0016349537246581614,8247294.0,-1.0
4282,2020-01-06,IBM,103.7904966819325,104.42839094198423,103.61935189680806,104.31948852539062,2537073.0,0.0,0.0,-0.1866912841797017,0.1866912841797017,0.0,46.73827919273246,102.99701573262205,106.12427882095793,42.28850452976473,-57.71149547023526,0.0004659326705507283,-0.0004900652673239471,-0.010989063449008074,5710221.0,-1.0
4283,2020-01-07,IBM,104.0005324042158,104.98849495212096,103.7749364168315,104.38948822021484,3232977.0,0.0,0.0,0.06999969482421875,0.0,0.06999969482421875,47.641001134370754,102.99701573262205,106.12427882095793,44.52687376340244,-55.47312623659756,-0.015652672632029407,-0.0035225867402650405,-0.010033274218880006,8943198.0,1.0
4284,2020-01-08,IBM,104.63842834718234,105.68862700861165,104.17945144025784,105.2607650756836,4545916.0,0.0,0.0,0.87127685546875,0.0,0.87127685546875,57.89095925160268,102.99701573262205,106.12427882095793,72.38755675865326,-27.612443241346746,0.04140073530369648,0.005462077668527266,0.002444799645660911,13489114.0,1.0
4285,2020-01-09,IBM,105.59526783236296,106.4120917584099,105.26076324343764,106.3731918334961,3902208.0,0.0,0.0,1.1124267578125,0.0,1.1124267578125,67.31677281378528,102.99701573262205,106.4120917584099,98.86093531681091,-1.1390646831890807,0.1743694915995917,0.039243560454740166,0.013564673677256112,17391322.0,1.0
4286,2020-01-10,IBM,106.5754492139947,107.25224332829748,106.03868489332432,106.33428955078124,3405148.0,0.0,0.0,-0.03890228271485796,0.03890228271485796,0.0,66.71419475860154,102.99701573262205,107.25224332829748,78.42762209830663,-21.572377901693372,0.27345685940288433,0.08608622024436902,0.010497320966757595,13986174.0,-1.0
4287,2020-01-13,IBM,105.39302082913616,106.29541724936524,105.07407368838236,106.26428985595705,3693426.0,0.0,0.0,-0.06999969482419033,0.06999969482419033,0.0,65.49694407018129,102.99701573262205,107.25224332829748,76.78259387712922,-23.21740612287079,0.34238907379950945,0.13734679095539712,0.028537060983416795,10292748.0,-1.0
4288,2020-01-14,IBM,106.01537122517313,106.68439298593302,105.4474917776317,105.65752410888672,3850326.0,0.0,0.0,-0.6067657470703267,0.6067657470703267,0.0,55.38909268709896,102.99701573262205,107.25224332829748,62.523292031865296,-37.476707968134704,0.3440909591154764,0.17869562458741298,0.013279779502013866,6442422.0,-1.0
4289,2020-01-15,IBM,105.79752685755996,107.4000473091261,105.5719246772586,106.27984619140624,4232011.0,0.0,0.0,0.622322082519517,0.0,0.622322082519517,62.27832516003583,102.99701573262205,107.4000473091261,74.55841280590397,-25.441587194096034,0.39114700736611496,0.22118590114315342,0.008861414225452835,10674433.0,1.0
4290,2020-01-16,IBM,106.82438763136646,107.50118178507056,106.58324037030424,107.33782196044922,4519661.0,0.0,0.0,1.057975769042983,0.0,1.057975769042983,71.04851578180111,102.99701573262205,107.50118178507056,96.37313938431436,-3.6268606156856507,0.5079536933281332,0.2785394595801494,0.027095451733463616,15194094.0,1.0
4291,2020-01-17,IBM,106.21759759164024,107.61008568395042,105.921992946994,107.5945281982422,5881972.0,0.0,0.0,0.25670623779298296,0.0,0.25670623779298296,72.81785230025544,102.99701573262205,107.61008568395042,99.66275200956503,-0.33724799043496956,0.6141582475288345,0.34566321716988646,0.03139432256758479,21076066.0,1.0
4292,2020-01-21,IBM,107.20558612853463,108.4035872476459,107.04221387397943,108.26355743408205,7577329.0,0.0,0.0,0.6690292358398438,0.0,0.6690292358398438,77.03782147512682,102.99701573262205,108.4035872476459,97.41000718894146,-2.5899928110585364,0.7437378430234105,0.42527814234059136,0.03711167934547843,28653395.0,1.0
4293,2020-01-22,IBM,111.49193386117624,113.4134015304926,110.89292713287344,111.93534088134766,17228038.0,0.0,0.0,3.671783447265611,0.0,3.671783447265611,88.42117033707635,103.61935189680806,113.4134015304926,84.90858526935095,-15.091414730649058,1.1296904752523176,0.5661606089229366,0.06340991157403209,45881433.0,1.0
4294,2020-01-23,IBM,112.17649735834205,112.339869597498,110.58176180604,111.1418685913086,5918059.0,0.0,0.0,-0.7934722900390625,0.7934722900390625,0.0,78.69370760251533,103.61935189680806,113.4134015304926,76.80701013223828,-23.19298986776173,1.3559041158245435,0.7241093103032581,0.04482968570950496,39963374.0,-1.0
4295,2020-01-24,IBM,111.54638338450836,111.95867540036264,109.26706882983557,109.34485626220705,5836889.0,0.0,0.0,-1.7970123291015483,1.7970123291015483,0.0,61.12218527877184,103.61935189680806,113.4134015304926,58.45900908759268,-41.54099091240731,1.3743337154804323,0.8541541913386931,0.028312285003682547,34126485.0,-1.0
4296,2020-01-27,IBM,107.74234080681931,108.96368425675188,107.43116623056702,107.83568572998048,4358264.0,0.0,0.0,-1.5091705322265625,1.5091705322265625,0.0,50.24951079365531,103.7749364168315,113.4134015304926,42.130663599056575,-57.869336400943425,1.252721265740007,0.9338676062189559,0.0147876193983274,29768221.0,-1.0
4297,2020-01-28,IBM,108.5202631865018,109.2748447606193,107.93681396891937,108.55915069580078,3610374.0,0.0,0.0,0.7234649658202983,0.0,0.7234649658202983,54.70611607725747,104.17945144025784,113.4134015304926,47.43039774683894,-52.56960225316105,1.2008771355445447,0.9872695120840739,0.027462564652979804,33378595.0,1.0
4298,2020-01-29,IBM,108.2635416199105,108.58248871384546,107.04219823821084,107.11221313476562,3194275.0,0.0,0.0,-1.4469375610351562,1.4469375610351562,0.0,45.334475876023426,105.07407368838236,113.4134015304926,24.44009259465115,-75.55990740534885,1.031148086955028,0.9960452270582648,0.007831841813736862,30184320.0,-1.0
4299,2020-01-30,IBM,106.3887452002097,106.5521050126166,104.9962694867922,106.3965301513672,5290563.0,0.0,0.0,-0.7156829833984233,0.7156829833984233,0.0,41.29693991726026,104.9962694867922,113.4134015304926,16.63584053695571,-83.36415946304429,0.829326992239686,0.9627015800945491,-0.00876943273014108,24893757.0,-1.0
4300,2020-01-31,IBM,111.16521095350058,112.05982243566392,109.52379034141492,111.8108901977539,19868352.0,0.0,0.0,5.4143600463867045,0.0,5.4143600463867045,66.97309629799729,104.9962694867922,113.4134015304926,80.96131408633347,-19.038685913666527,1.0936687936161604,0.9888950227988715,0.03918751325107439,44762109.0,1.0
4301,2020-02-03,IBM,112.21541369845036,114.5725161296902,111.9431390095546,113.7868194580078,9295488.0,0.0,0.0,1.975929260253892,0.0,1.975929260253892,72.10988541449004,104.9962694867922,114.5725161296902,91.7953588605083,-8.204641139491697,1.4459347180924311,1.0803029618575835,0.05101681632149102,54057597.0,1.0
4302,2020-02-04,IBM,114.9614602067417,116.20613366160497,114.26133604445263,115.99610137939452,5879566.0,0.0,0.0,2.2092819213867188,0.0,2.2092819213867188,76.7709308501546,104.9962694867922,116.20613366160497,98.12636193503248,-1.8736380649675168,1.8816876644099096,1.2405799023680488,0.036277733788752986,59937163.0,1.0
4303,2020-02-05,IBM,116.8518124303482,122.47619781285589,116.8051399695924,121.61270141601562,15048593.0,0.0,0.0,5.616600036621108,0.0,5.616600036621108,84.41246721623565,104.9962694867922,122.47619781285589,95.06006900753286,-4.939930992467135,2.6496936775297257,1.5224026574003844,0.09421141607048589,74985756.0,1.0
4304,2020-02-06,IBM,121.9938970985622,123.49528778409568,120.90479846165368,121.94721221923828,8786923.0,0.0,0.0,0.33451080322265625,0.0,0.33451080322265625,84.75705689286816,104.9962694867922,123.49528778409568,91.63157990344247,-8.36842009655753,3.247896473507126,1.867501420621733,0.11525330397628397,83772679.0,1.0
4305,2020-02-07,IBM,121.4834510946677,122.26164469778064,120.20219424434988,120.58736419677734,6718876.0,1.548757,0.0,-1.3598480224609375,1.3598480224609375,0.0,76.7939919238252,104.9962694867922,123.49528778409568,84.28065997565821,-15.719340024341788,3.571082907612137,2.208217718019814,0.11825100735879723,77053803.0,-1.0
4306,2020-02-10,IBM,120.24149103110496,121.39697570692518,119.148886119839,121.38912200927734,5480831.0,0.0,0.0,0.8017578125,0.0,0.8017578125,78.18810657521604,104.9962694867922,123.49528778409568,88.61471597589941,-11.385284024100581,3.847553438946676,2.5360848622051866,0.11818415335090537,82534634.0,1.0
4307,2020-02-11,IBM,121.93149019704435,122.01008990199836,120.05283806313751,120.6423797607422,4011515.0,0.0,0.0,-0.746742248535142,0.746742248535142,0.0,73.44630441518578,104.9962694867922,123.49528778409568,84.5780571838813,-15.421942816118703,3.9607454600356533,2.82101698177128,0.12631768339015914,78523119.0,-1.0
4308,2020-02-12,IBM,120.85461034033445,122.30879903720978,120.67382473838488,122.08084106445312,4641939.0,0.0,0.0,1.4384613037109233,0.0,1.4384613037109233,76.60047477649678,104.9962694867922,123.49528778409568,92.35393631753566,-7.6460636824643435,4.119041016910941,3.0806217887992124,0.1474137445156558,83165058.0,1.0
4309,2020-02-13,IBM,121.34197981019216,121.70355105473844,120.58737234256655,121.29480743408205,3996452.0,0.0,0.0,-0.7860336303710795,0.7860336303710795,0.0,71.26323677520489,104.9962694867922,123.49528778409568,88.10488040690035,-11.895119593099647,4.13341757651969,3.2911809463433084,0.08482105114765148,79168606.0,-1.0
4310,2020-02-14,IBM,121.38125321113276,121.49130534262936,117.72614742109376,118.45716857910156,6379763.0,0.0,0.0,-2.837638854980483,2.837638854980483,0.0,55.23277957605228,104.9962694867922,123.49528778409568,72.76547801604963,-27.234521983950373,3.8712124359125113,3.4071872442571496,0.0410447285840283,72788843.0,-1.0
4311,2020-02-18,IBM,117.74185582008198,118.99165999391562,117.62395000266072,118.77156829833984,3496778.0,0.0,0.0,0.31439971923828125,0.0,0.31439971923828125,56.484191687639175,104.9962694867922,123.49528778409568,74.46502614441766,-25.534973855582336,3.646744996391263,3.4550987946839724,0.023927243122313646,76285621.0,1.0
4312,2020-02-19,IBM,119.11745482271316,119.39257263123088,118.15062191671603,118.58293914794922,2858613.0,0.0,0.0,-0.188629150390625,0.188629150390625,0.0,55.411888150436305,104.9962694867922,123.49528778409568,73.44535500641938,-26.554644993580624,3.4142745061780317,3.4469339369827847,-0.024913205880544687,73427008.0,-1.0
4313,2020-02-20,IBM,118.54362817366768,119.18031710686618,117.52176934671508,118.86590576171876,3013003.0,0.0,0.0,0.28296661376954546,0.0,0.28296661376954546,56.830432169984824,109.52379034141492,123.49528778409568,66.86552718225556,-33.134472817744445,3.215803230828172,3.4007077957518623,-0.02526754323813407,76440011.0,1.0
4314,2020-02-21,IBM,118.72444836695064,118.72444836695064,116.99514155406229,117.78118896484376,3699597.0,0.0,0.0,-1.084716796875,1.084716796875,0.0,49.81983385012884,111.9431390095546,123.49528778409568,50.53648519620183,-49.46351480379816,2.9371283477597103,3.307991906153432,-0.023270889538263728,72740414.0,-1.0
4315,2020-02-24,IBM,114.37759879335096,116.37415694458834,114.27541289441965,115.10075378417967,5703210.0,0.0,0.0,-2.680435180664091,2.680435180664091,0.0,36.856315349600244,114.26133604445263,123.49528778409568,9.090558012375844,-90.90944198762415,2.4714978882341825,3.140693102569583,-0.05180339161376479,67037204.0,-1.0
4316,2020-02-25,IBM,115.1636575672408,115.60384109172308,111.0369150699904,111.39063262939452,6497229.0,0.0,0.0,-3.7101211547851562,3.7101211547851562,0.0,26.036252545631626,111.0369150699904,123.49528778409568,2.8391955155077424,-97.16080448449226,1.782558400324092,2.8690661621204847,-0.0766873726272288,60539975.0,-1.0
4317,2020-02-26,IBM,112.32600014063702,113.23781941557267,109.73204687150636,109.8499526977539,5656663.0,0.0,0.0,-1.5406799316406108,1.5406799316406108,0.0,22.82547685438186,109.73204687150636,123.49528778409568,0.8566719640844297,-99.14332803591557,1.0995736970121044,2.5151676690988087,-0.10018679638881145,54883312.0,-1.0
4318,2020-02-27,IBM,107.87699022023052,109.01675500207556,104.55201552542974,104.630615234375,8808471.0,0.0,0.0,-5.219337463378906,5.219337463378906,0.0,15.401398951540699,104.55201552542974,122.30879903720978,0.44264609574767994,-99.55735390425232,0.13558356261481208,2.0392508478020095,-0.1373858663221279,46074841.0,-1.0
4319,2020-02-28,IBM,102.17028353704433,103.04279667503748,99.32479871708604,102.3039093017578,13607832.0,0.0,0.0,-2.3267059326172017,2.3267059326172017,0.0,13.19403337414407,99.32479871708604,122.30879903720978,12.961671350410594,-87.0383286495894,-0.80683064628262,1.4700345489850835,-0.1363637124802386,32467009.0,-1.0
4320,2020-03-02,IBM,102.77553559537846,105.67604638650424,100.57460603177582,105.56599426269533,8923844.0,0.0,0.0,3.2620849609375284,0.0,3.2620849609375284,29.532296645853705,99.32479871708604,122.30879903720978,27.154522531679486,-72.84547746832051,-1.2757714039903476,0.9208733583899972,-0.11118463976558524,41390853.0,1.0
4321,2020-03-03,IBM,105.70749879071263,106.98088933311853,100.45671211368094,101.32136535644533,8259321.0,0.0,0.0,-4.24462890625,4.24462890625,0.0,23.02561080905751,99.32479871708604,122.30879903720978,8.686767366650201,-91.3132326333498,-1.9672393017928016,0.3432508263534373,-0.1455654069255916,33131532.0,-1.0
4322,2020-03-04,IBM,103.42795532653636,105.55027261133276,101.3999514055472,105.50311279296876,5226234.0,0.0,0.0,4.1817474365234375,0.0,4.1817474365234375,38.44286387919961,99.32479871708604,121.70355105473844,27.607946960866396,-72.3920530391336,-2.1529822831769962,-0.15599579555264956,-0.11241905644110728,38357766.0,1.0
4323,2020-03-05,IBM,102.57902406860374,103.98604649714568,100.96762987746648,101.83228302001952,5696725.0,0.0,0.0,-3.670829772949247,3.670829772949247,0.0,31.959317782925268,99.32479871708604,121.49130534262936,11.312040933161775,-88.68795906683823,-2.5668017258850426,-0.6381569816191284,-0.1354113172485022,32661041.0,-1.0
4324,2020-03-06,IBM,99.59206043501494,100.87331724125072,97.87848013706814,100.40168762207033,8570192.0,0.0,0.0,-1.4305953979491903,1.4305953979491903,0.0,29.706390185078774,97.87848013706814,119.39257263123088,11.72816136998013,-88.27183863001987,-2.9758895064655206,-1.105703486588407,-0.12770608079310164,24090849.0,-1.0
4325,2020-03-09,IBM,94.45131673930725,96.21992305407734,92.18750090731834,92.60411071777344,11252345.0,0.0,0.0,-7.797576904296889,7.797576904296889,0.0,20.58164758359122,92.18750090731834,119.39257263123088,1.5313681753278037,-98.46863182467219,-3.8845155319757225,-1.6614658956658703,-0.16865441436287854,12838504.0,-1.0
4326,2020-03-10,IBM,96.51075354836956,98.16144763332868,90.99270326387612,98.07498168945312,11935592.0,0.0,0.0,5.4708709716796875,0.0,5.4708709716796875,36.397413567014475,90.99270326387612,119.18031710686618,25.125498259719787,-74.87450174028021,-4.115711280352855,-2.1523149726032678,-0.10719140717974607,24774096.0,1.0
4327,2020-03-11,IBM,95.11945521914816,96.3535458522769,91.48005681030934,92.72987365722656,8835039.0,0.0,0.0,-5.3451080322265625,5.3451080322265625,0.0,29.72429499339492,90.99270326387612,118.72444836695064,6.264194290311162,-93.73580570968883,-4.676335242132467,-2.657119026509108,-0.11374052948547131,15939057.0,-1.0
4328,2020-03-12,IBM,86.18997427619209,86.30788011076022,80.39681198450627,80.81341552734375,13088284.0,0.0,0.0,-11.916458129882812,11.916458129882812,0.0,20.19827915285289,80.39681198450627,116.37415694458834,1.1579607758707942,-98.84203922412921,-6.012879618649791,-3.3282711449372453,-0.210065225474671,2850773.0,-1.0
4329,2020-03-13,IBM,85.42751428409225,85.80481800553906,79.24132782917503,84.85369873046875,13077197.0,0.0,0.0,4.040283203125,0.0,4.040283203125,29.088798001621313,79.24132782917503,115.60384109172308,15.434496677308154,-84.56550332269185,-6.669205132553387,-3.9964579424604745,-0.1962023441060493,15927970.0,1.0
4330,2020-03-16,IBM,77.0325363695836,84.42923356155895,74.67440070159738,77.8814697265625,11054128.0,0.0,0.0,-6.97222900390625,6.97222900390625,0.0,23.807542679966417,74.67440070159738,113.23781941557267,8.316350396088943,-91.68364960391105,-7.66360714937008,-4.729887783842396,-0.23134208217015262,4873842.0,-1.0
4331,2020-03-17,IBM,79.08410848991277,84.4213606512182,76.32508334375234,83.83182525634766,9684182.0,0.0,0.0,5.950355529785156,0.0,5.950355529785156,35.36355574654344,74.67440070159738,109.01675500207556,26.66510418775445,-73.33489581224555,-7.8806902581823834,-5.360048278710394,-0.20540898711820177,14558024.0,1.0
4332,2020-03-18,IBM,78.1408534001507,84.05192132258914,78.13299342964528,81.39508819580078,9176035.0,0.0,0.0,-2.436737060546875,2.436737060546875,0.0,32.99869044564315,74.67440070159738,106.98088933311853,20.80290300458741,-79.19709699541258,-8.155344764125317,-5.9191075757933795,-0.20069465417171217,5381989.0,-1.0
4333,2020-03-19,IBM,80.43610777699003,81.50513275074542,77.22117915826558,78.87187957763672,8782739.0,0.0,0.0,-2.5232086181640625,2.5232086181640625,0.0,30.557192669980353,74.67440070159738,106.98088933311853,12.992680584741414,-87.00731941525859,-8.478873115653528,-6.43106068376541,-0.21443671470419512,-3400750.0,-1.0
4334,2020-03-20,IBM,79.32779888950647,79.3828249661403,74.4464489299138,74.98096466064453,11031639.0,0.0,0.0,-3.8909149169921875,3.8909149169921875,0.0,27.00244195338857,74.4464489299138,106.98088933311853,1.6429227738556114,-98.35707722614438,-8.94611078483706,-6.934070703979742,-0.19030630412118965,-14432389.0,-1.0
4335,2020-03-23,IBM,74.35998078634978,76.82816225099828,71.18435174244381,74.49360656738281,10176952.0,0.0,0.0,-0.48735809326171875,0.48735809326171875,0.0,26.55596187119373,71.18435174244381,105.55027261133276,9.629466463489509,-90.3705335365105,-9.249107772009296,-7.397078117585653,-0.24044230970890135,-24609341.0,-1.0
4336,2020-03-24,IBM,78.59676168352212,83.3523385836805,78.0229462091041,82.91215515136719,8340699.0,0.0,0.0,8.418548583984375,0.0,8.418548583984375,44.76069134644317,71.18435174244381,103.98604649714568,35.75365083001478,-64.24634916998522,-8.70953050714536,-7.6595685954975945,-0.10587438673916783,-16268642.0,1.0
4337,2020-03-25,IBM,82.91215756941779,88.4144819984105,80.829133629706,83.20299530029297,9052084.0,0.0,0.0,0.29084014892578125,0.0,0.29084014892578125,45.3011604073588,71.18435174244381,100.87331724125072,40.48185363121576,-59.518146368784244,-8.164329954335997,-7.760520867265276,0.029569097622667462,-7216558.0,1.0
4338,2020-03-26,IBM,84.03621280156021,88.94114243663934,82.98291388148337,88.73677062988281,7482561.0,0.0,0.0,5.533775329589844,0.0,5.533775329589844,54.97302936452844,71.18435174244381,98.16144763332868,65.06415278513981,-34.935847214860196,-7.202696959839031,-7.6489560857800285,0.045761963915660786,266003.0,1.0
4339,2020-03-27,IBM,85.3488960302871,87.64415164198465,84.61787487973794,84.91657257080078,6718458.0,0.0,0.0,-3.8201980590820312,3.8201980590820312,0.0,48.186195853686534,71.18435174244381,98.16144763332868,50.903258393342746,-49.096741606657254,-6.67194392373726,-7.453553653371475,0.09033089474220413,-6452455.0,-1.0
4340,2020-03-30,IBM,84.96373211091739,89.18479962341415,84.74364039674245,88.76819610595703,5820467.0,0.0,0.0,3.85162353515625,0.0,3.85162353515625,54.69327454975319,71.18435174244381,96.3535458522769,69.862564080443,-30.13743591955701,-5.872826204058313,-7.137408163508843,0.05888421055505533,-631988.0,1.0
4341,2020-03-31,IBM,88.03717294299423,89.45991535519379,86.59871059055925,87.19610595703125,6635092.0,0.0,0.0,-1.5720901489257812,1.5720901489257812,0.0,51.63905410661492,71.18435174244381,89.45991535519379,87.61291609861385,-12.387083901386141,-5.305218928964237,-6.770970316599922,0.07126987499879323,-7267080.0,-1.0
4342,2020-04-01,IBM,83.60388429441574,86.40220964976864,82.15755551718472,82.64490509033203,6394093.0,0.0,0.0,-4.551200866699219,4.551200866699219,0.0,43.52084494923536,71.18435174244381,89.45991535519379,62.70971221863029,-37.29028778136972,-5.163112797627619,-6.449398812805462,0.04783739823242539,-13661173.0,-1.0
4343,2020-04-02,IBM,82.82570281619478,86.71663343190933,82.64491092216808,86.46509552001953,6619820.0,0.0,0.0,3.8201904296875,0.0,3.8201904296875,50.98406377496841,71.18435174244381,89.45991535519379,83.61298234827125,-16.387017651728748,-4.688192657059744,-6.097157581656319,0.153160617649438,-7041353.0,1.0
4344,2020-04-03,IBM,85.61615549493729,86.52010855592205,82.47196657121889,83.5881576538086,4747585.0,0.0,0.0,-2.8769378662109375,2.8769378662109375,0.0,45.73285076156318,71.18435174244381,89.45991535519379,67.87098977736177,-32.12901022263823,-4.4921768478560296,-5.776161434896261,0.12208498830298087,-11788938.0,-1.0
4345,2020-04-06,IBM,86.7402108041098,90.8905329087857,86.56727888681267,90.25383758544922,7357773.0,0.0,0.0,6.665679931640625,0.0,6.665679931640625,57.44925263995133,71.18435174244381,90.8905329087857,96.76905779987472,-3.230942200125291,-3.755675158373478,-5.372064179591705,0.0885477216299444,-4431165.0,1.0
4346,2020-04-07,IBM,93.3822968244456,93.9875522371058,90.29313999230008,90.34815979003906,5852684.0,0.0,0.0,0.09432220458984375,0.0,0.09432220458984375,57.59872248600549,71.18435174244381,93.9875522371058,84.03999277242382,-15.960007227576172,-3.128319924841506,-4.9233153286416655,0.08587628923643975,1421519.0,1.0
4347,2020-04-08,IBM,91.42503306027706,94.29409778615567,90.45033403948555,93.76744842529295,5395896.0,0.0,0.0,3.419288635253892,0.0,3.419288635253892,63.03069329713343,71.18435174244381,94.29409778615567,97.72109412251191,-2.2789058774880857,-2.3283881564433244,-4.4043298942019975,0.0566921441889392,6817415.0,1.0
4348,2020-04-09,IBM,94.70284993436206,96.62080826997826,94.4591782934668,95.50462341308594,5832705.0,0.0,0.0,1.737174987792983,0.0,1.737174987792983,65.61311428551923,71.18435174244381,96.62080826997826,95.61186969700725,-4.388130302992755,-1.5365485878009508,-3.830773632921788,0.124687684885741,12650120.0,1.0
4349,2020-04-13,IBM,95.6068034843948,95.7404292529173,92.78489222139356,95.22949981689452,5355206.0,0.0,0.0,-0.27512359619142046,0.27512359619142046,0.0,64.78612493046984,78.0229462091041,96.62080826997826,92.5189871366411,-7.481012863358891,-0.9205981176172031,-3.248738529860871,0.0727884985206304,7294914.0,-1.0
4350,2020-04-14,IBM,97.0452693202603,98.39726581289771,96.3849878786978,97.39898681640624,5322780.0,0.0,0.0,2.1694869995117188,0.0,2.1694869995117188,68.4089730745618,80.829133629706,98.39726581289771,94.31767141730309,-5.682328582696919,-0.254460203778649,-2.649882864644427,0.11701073972733123,12617694.0,1.0
4351,2020-04-15,IBM,93.63381830413353,94.47488524836152,91.7787462629062,93.29581451416016,5896616.0,0.0,0.0,-4.1031723022460795,4.1031723022460795,0.0,55.86614133584997,82.15755551718472,98.39726581289771,68.5865621624774,-31.41343783752259,-0.056976036662334195,-2.1313014990480084,0.12887557208985267,6721078.0,-1.0
4352,2020-04-16,IBM,93.54737282978668,94.1290483544142,89.93942011031316,90.9691390991211,6754650.0,0.0,0.0,-2.3266754150390625,2.3266754150390625,0.0,49.88214155580083,82.15755551718472,98.39726581289771,54.25948752461724,-45.74051247538276,-0.0872064113559361,-1.7224824815095938,0.05209088768147763,-33572.0,-1.0
4353,2020-04-17,IBM,93.77531459789432,94.63210785103406,92.69056965112678,94.4198760986328,5194436.0,0.0,0.0,3.4507369995117045,0.0,3.4507369995117045,57.645753497610315,82.15755551718472,98.39726581289771,75.5082471187009,-24.49175288129911,0.16537509460134459,-1.3449109662874061,0.1295843663606655,5160864.0,1.0
4354,2020-04-20,IBM,93.6573930295706,96.57362355183513,92.86348594764983,94.64781188964844,8558058.0,0.0,0.0,0.2279357910156392,0.0,0.2279357910156392,58.13997244892023,82.15755551718472,98.39726581289771,76.91181766808323,-23.088182331916773,0.37956488351383655,-1.0000157963271576,0.048684625737261955,13718922.0,1.0
4355,2020-04-21,IBM,89.60927160083942,92.08531285594154,88.08433695864379,91.77875518798828,15009054.0,0.0,0.0,-2.8690567016601562,2.8690567016601562,0.0,49.71473619586276,82.15755551718472,98.39726581289771,59.244897203267186,-40.755102796732814,0.31418125038105416,-0.7371763869855152,0.015834250540064154,-1290132.0,-1.0
4356,2020-04-22,IBM,94.22336231716766,94.58493977658162,92.39973626043596,93.78317260742188,7412479.0,0.0,0.0,2.0044174194335938,0.0,2.0044174194335938,54.974462176331095,82.47196657121889,98.39726581289771,71.02664674959397,-28.973353250406024,0.41927089035570475,-0.5058869315172713,0.00016769339886058,6122347.0,1.0
4357,2020-04-23,IBM,93.98753346359383,96.70725229176252,93.63381601573072,95.3866958618164,7198154.0,0.0,0.0,1.6035232543945312,0.0,1.6035232543945312,58.93895290994429,82.47196657121889,98.39726581289771,81.09567735341382,-18.90432264658618,0.6247444474914658,-0.2797606557155238,-0.0012347836895755249,13320501.0,1.0
4358,2020-04-24,IBM,96.21991666005592,98.25577438837844,94.92294003666235,98.03568267822266,5215251.0,0.0,0.0,2.64898681640625,0.0,2.64898681640625,64.84000843816827,86.56727888681267,98.39726581289771,96.94350351412672,-3.056496485873284,0.9899235964423099,-0.025823805283956967,0.0294675795496544,18535752.0,1.0
4359,2020-04-27,IBM,98.69596510586224,99.82001619605316,98.62522536924553,98.97894287109376,5150295.0,0.0,0.0,0.943260192871108,0.0,0.943260192871108,66.80035449947019,88.08433695864379,99.82001619605316,92.83319433034316,-7.166805669656845,1.3399972630408996,0.24734040838101445,0.016221483470517883,23686047.0,1.0
4360,2020-04-28,IBM,100.63750148271072,100.77112725566988,98.55447754489012,99.25405883789062,4997893.0,0.0,0.0,0.2751159667968608,0.0,0.2751159667968608,67.41182597856132,88.08433695864379,100.77112725566988,88.04214161138242,-11.957858388617586,1.6209474520231169,0.522061817109435,0.06386400456181396,28683940.0,1.0
4361,2020-04-29,IBM,101.30561857572198,101.64362234259156,100.2444600058114,101.1562728881836,5499450.0,0.0,0.0,1.9022140502929688,0.0,1.9022140502929688,71.58680524107751,88.08433695864379,101.64362234259156,96.40578805882414,-3.594211941175847,1.9743363567815635,0.8125167250438607,0.11198450254610504,34183390.0,1.0
4362,2020-04-30,IBM,99.45055296562782,100.04008829261784,98.4286942413466,98.6959457397461,6941047.0,0.0,0.0,-2.4603271484375,2.4603271484375,0.0,60.09664903448399,88.08433695864379,101.64362234259156,78.26082629446618,-21.73917370553381,2.0324430326368343,1.0565019865624556,0.0452878124585383,27242343.0,-1.0
4363,2020-05-01,IBM,96.83302566878112,97.05311736461576,95.41814331222048,95.79544067382812,5152073.0,0.0,0.0,-2.9005050659179688,2.9005050659179688,0.0,49.32690270004961,88.08433695864379,101.64362234259156,56.86954361409907,-43.13045638590093,1.8234271405683273,1.20988701736363,0.012125254258574136,22090270.0,-1.0
4364,2020-05-04,IBM,94.97010154953357,95.87405458964436,93.84605679534594,95.64610290527344,4202723.0,0.0,0.0,-0.1493377685546875,0.1493377685546875,0.0,48.80728515704414,88.08433695864379,101.64362234259156,55.76817459408064,-44.23182540591936,1.6269754699112156,1.2933047078731472,0.042137722497584074,17887547.0,-1.0
4365,2020-05-05,IBM,96.99025674676244,97.72128429842628,96.26709543972297,96.3535614013672,4078772.0,0.0,0.0,0.7074584960937642,0.0,0.7074584960937642,51.594520866700464,88.08433695864379,101.64362234259156,60.98569510538498,-39.01430489461503,1.5109547479177081,1.3368347158820595,0.02740778246759712,21966319.0,1.0
4366,2020-05-06,IBM,96.8723339402316,97.50902917416956,96.21991876564152,96.81731414794922,4042372.0,0.0,0.0,0.46375274658201704,0.0,0.46375274658201704,53.50907291527067,88.08433695864379,101.64362234259156,64.40588085596319,-35.59411914403681,1.439830985423157,1.357433969790279,0.014998090385742069,26008691.0,1.0
4367,2020-05-07,IBM,97.96439676488748,98.1874401766559,96.2676623163478,96.57036590576172,4615580.0,1.558317,0.0,-0.2469482421875,0.2469482421875,0.0,52.23955317311654,88.08433695864379,101.64362234259156,62.58463264711695,-37.41536735288305,1.3479993346854116,1.3555470427693057,-0.014946769711090546,21393111.0,-1.0
4368,2020-05-08,IBM,97.71746138210936,98.16354822470616,96.4349521740701,97.9723663330078,5232615.0,0.0,0.0,1.4020004272460795,0.0,1.4020004272460795,58.66393413578842,88.08433695864379,101.64362234259156,72.92441374580113,-27.075586254198864,1.3725301343186658,1.3589436610791779,-0.010169602835593983,26625726.0,1.0
4369,2020-05-11,IBM,97.03239432818482,98.3387996878916,96.12428351803678,97.65373229980467,3697924.0,0.0,0.0,-0.318634033203125,0.318634033203125,0.0,56.66512787983931,92.39973626043596,101.64362234259156,56.837524745258726,-43.162475254741274,1.3506899532137737,1.3572929195060972,-0.016123537483738848,22927802.0,-1.0
4370,2020-05-12,IBM,97.9882973801655,99.03183240511332,95.79768371582033,95.79768371582033,5004587.0,0.0,0.0,-1.8560485839843466,1.8560485839843466,0.0,46.10651437781377,93.63381601573072,101.64362234259156,27.015231227665183,-72.98476877233482,1.1701253664096072,1.3198594088867994,-0.05297337495111709,17923215.0,-1.0
4371,2020-05-13,IBM,95.5507337120883,95.58260159746928,91.48813456777944,92.18913269042967,6153409.0,0.0,0.0,-3.6085510253906534,3.6085510253906534,0.0,32.515036496193815,91.48813456777944,101.64362234259156,6.90265340468299,-93.097346595317,0.7274610030257662,1.2013797277145928,-0.06592786563365438,11769806.0,-1.0
4372,2020-05-14,IBM,91.26508340708418,93.27248666256382,89.06649828374474,93.16096496582033,5501332.0,0.0,0.0,0.9718322753906534,0.0,0.9718322753906534,38.178120099144195,89.06649828374474,101.64362234259156,32.55487234536357,-67.44512765463642,0.4498791220237308,1.0510796065764203,-0.02750105526397517,17271138.0,1.0
4373,2020-05-15,IBM,92.34845189420946,93.5114675913642,91.80676777702622,93.18486785888672,5006470.0,0.0,0.0,0.02390289306639204,0.0,0.02390289306639204,38.32499993260668,89.06649828374474,101.64362234259156,32.74492289232926,-67.25507710767073,0.22918039621804098,0.8866997645047444,-0.025732726913341053,22277608.0,1.0
4374,2020-05-18,IBM,95.49499251994732,97.47052840144916,95.391436177945,96.83325958251952,4399162.0,0.0,0.0,3.6483917236327983,0.0,3.6483917236327983,56.518710443217394,89.06649828374474,101.64362234259156,61.75307854510347,-38.24692145489654,0.34469634231571433,0.7782990800669384,0.0049785205048529235,26676770.0,1.0
4375,2020-05-19,IBM,96.5385078902913,97.31916621693551,95.7020918872005,95.8215789794922,3390191.0,0.0,0.0,-1.0116806030273153,1.0116806030273153,0.0,51.64427652014184,89.06649828374474,100.04008829261784,61.557618703499905,-38.442381296500095,0.35056825947476966,0.6927529159485047,-0.01028468076418032,23286579.0,-1.0
4376,2020-05-20,IBM,96.33139747006392,97.55814266493825,96.06852077528411,96.68986511230467,4017372.0,0.0,0.0,0.8682861328124716,0.0,0.8682861328124716,55.44927161107243,89.06649828374474,99.03183240511332,76.498858299324,-23.501141700676005,0.4204386751431173,0.6382900677874273,0.0012374314358460925,27303951.0,1.0
4377,2020-05-21,IBM,96.37919539252788,96.96070649378024,94.7700926709089,94.88957977294922,4184941.0,0.0,0.0,-1.8002853393554545,1.8002853393554545,0.0,46.664691615987245,89.06649828374474,99.03183240511332,58.43337933565215,-41.56662066434785,0.326776624163827,0.5759873790627072,-0.03146587834349324,23119010.0,-1.0
4378,2020-05-22,IBM,95.08873339348786,95.1683935858354,93.67080612649144,94.30807495117188,4373117.0,0.0,0.0,-0.5815048217773438,0.5815048217773438,0.0,44.06298142579445,89.06649828374474,99.03183240511332,52.598102618432726,-47.401897381567274,0.20328287622729135,0.5014464784956241,-0.0342604145263119,18745893.0,-1.0
4379,2020-05-26,IBM,96.62613594400712,97.67763001173812,96.39512713581831,96.99256896972656,5720888.0,0.0,0.0,2.6844940185546875,0.0,2.6844940185546875,56.871340741590195,89.06649828374474,99.03183240511332,79.53642687189001,-20.463573128109992,0.31835957233006695,0.46482909726251265,0.0124730077759585,24466781.0,1.0
4380,2020-05-27,IBM,98.72912469019188,100.2346709041184,98.35472630370867,100.003662109375,5990965.0,0.0,0.0,3.0110931396484375,0.0,3.0110931396484375,66.73067923803683,89.06649828374474,100.2346709041184,97.93154347988872,-2.0684565201112877,0.6450925097918798,0.5008817797683861,0.08476627549134719,30457746.0,1.0
4381,2020-05-28,IBM,101.063139984871,101.14279381534362,98.95217997930696,99.1991195678711,4095404.0,0.0,0.0,-0.8045425415039062,0.8045425415039062,0.0,62.337263665726965,89.06649828374474,101.14279381534362,83.90504569562161,-16.09495430437838,0.8295483405631785,0.5666150919273446,0.06481421273669818,26362342.0,-1.0
4382,2020-05-29,IBM,98.51405144970572,99.6770672191124,97.37492547068562,99.4938507080078,8294675.0,0.0,0.0,0.29473114013670454,0.0,0.29473114013670454,63.357010933486684,89.06649828374474,101.14279381534362,86.34562144474526,-13.65437855525474,0.9881227907730903,0.6509166316964938,0.06770394157423709,34657017.0,1.0
4383,2020-06-01,IBM,99.28673072934356,100.17094533271258,98.80081064873274,99.48587799072266,3003798.0,0.0,0.0,-0.00797271728514204,0.00797271728514204,0.0,63.30351303292818,89.06649828374474,101.14279381534362,86.2796018838271,-13.720398116172907,1.100465373566962,0.7408263800705875,0.02739367051816144,31653219.0,-1.0
4384,2020-06-02,IBM,100.10722523070498,100.37010192871094,99.30267072847217,100.37010192871094,3115093.0,0.0,0.0,0.8842239379882812,0.0,0.8842239379882812,66.88207831899916,89.06649828374474,101.14279381534362,93.60158183765165,-6.39841816234835,1.2464785332185784,0.8419568107001857,0.04746867039408964,34768312.0,1.0
4385,2020-06-03,IBM,101.28617227841242,103.23781169416704,101.16668518880276,102.79969024658205,4097914.0,0.0,0.0,2.429588317871108,0.0,2.429588317871108,74.70319075996314,89.06649828374474,103.23781169416704,96.90839208126769,-3.091607918732314,1.5404847374115036,0.9816623960424493,0.06318992303051463,38866226.0,1.0
4386,2020-06-04,IBM,101.78803284925829,102.72003986556985,101.18262560424488,102.6722412109375,4042581.0,0.0,0.0,-0.12744903564454546,0.12744903564454546,0.0,73.65042325464408,91.80676777702622,103.23781169416704,95.05232866456348,-4.947671335436517,1.743109222327064,1.1339517612993724,0.0820180830878432,34823645.0,-1.0
4387,2020-06-05,IBM,106.655172172662,106.92602059909234,104.9504786474612,105.19741821289062,6163764.0,0.0,0.0,2.525177001953125,0.0,2.525177001953125,80.07108904606066,93.67080612649144,106.92602059909234,86.95907644667078,-13.040923553329225,2.0834347280739394,1.3238483546542859,0.11546565092497874,40987409.0,1.0
4388,2020-06-08,IBM,105.36470963281371,108.24039715285473,105.36470963281371,108.1368408203125,5617543.0,0.0,0.0,2.939422607421875,0.0,2.939422607421875,84.9851925509861,93.67080612649144,108.24039715285473,99.28922965404558,-0.7107703459544167,2.5608125291449113,1.5712411895524112,0.11489820270730533,46604952.0,1.0
4389,2020-06-09,IBM,106.36043696409376,106.42416002049524,104.36896431057284,105.04606628417967,5641706.0,0.0,0.0,-3.0907745361328267,3.0907745361328267,0.0,65.41513241576266,93.67080612649144,108.24039715285473,78.07535665966878,-21.92464334033122,2.65908591423387,1.7888101344887033,0.050422195232108,40963246.0,-1.0
4390,2020-06-10,IBM,105.26911779217323,105.33284721052502,103.39713843952433,103.45289611816406,4952601.0,0.0,0.0,-1.5931701660156108,1.5931701660156108,0.0,57.535155664246766,93.67080612649144,108.24039715285473,67.14045695567015,-32.85954304432986,2.5786872606557694,1.9467855597221166,0.042881192583393624,36010645.0,-1.0
4391,2020-06-11,IBM,100.39400101645562,100.44976505356225,93.8699455985956,94.00536346435548,12304726.0,0.0,0.0,-9.44753265380858,9.44753265380858,0.0,31.53933977668521,93.67080612649144,108.24039715285473,2.2962713041063982,-97.7037286958936,1.7326607846351294,1.9039606047047193,-0.05516408506250092,23705919.0,-1.0
4392,2020-06-12,IBM,96.5863059006556,98.0759213888179,95.01702387542876,97.11205291748048,6506434.0,0.0,0.0,3.106689453125,0.0,3.106689453125,41.55825463286116,93.8699455985956,108.24039715285473,22.56092862944157,-77.43907137055844,1.297901185328243,1.7827487208294244,-0.02386092499946113,30212353.0,1.0
4393,2020-06-15,IBM,94.94531913401816,97.4784693652838,94.22839030305984,96.9049301147461,5385959.0,0.0,0.0,-0.2071228027343892,0.2071228027343892,0.0,41.09560422335377,93.8699455985956,108.24039715285473,21.119618299335745,-78.88038170066424,0.9259640541964131,1.611391787502822,-0.034523944355720815,24826394.0,-1.0
4394,2020-06-16,IBM,99.57350607561234,101.56497238289532,98.10778677173928,99.6929931640625,5864608.0,0.0,0.0,2.7880630493164062,0.0,2.7880630493164062,49.77923856453423,93.8699455985956,108.24039715285473,40.52097836648046,-59.47902163351954,0.8464176100449095,1.4583969520112396,-0.030220879800976208,30691002.0,1.0
4395,2020-06-17,IBM,100.23465950300734,100.56923094097878,98.2989510910858,98.89639282226562,3302013.0,0.0,0.0,-0.796600341796875,0.796600341796875,0.0,47.47207775094784,93.8699455985956,108.24039715285473,34.977656788942575,-65.02234321105742,0.7109026466484778,1.3088980909386874,-0.03677574721403509,27388989.0,-1.0
4396,2020-06-18,IBM,97.9803240400932,99.09554741627284,97.44661167585576,98.90436553955078,2997208.0,0.0,0.0,0.00797271728515625,0.0,0.00797271728515625,47.500177421988816,93.8699455985956,108.24039715285473,35.03313672466382,-64.96686327533617,0.5972645001053536,1.1665713727720206,-0.05982136045016273,30386197.0,1.0
4397,2020-06-19,IBM,100.50550381678946,101.02328539082714,97.38287725278296,97.5581283569336,8471554.0,0.0,0.0,-1.3462371826171875,1.3462371826171875,0.0,43.01673514501025,93.8699455985956,108.24039715285473,25.665044305757274,-74.33495569424274,0.3940331912362467,1.012063736464866,-0.0978270900382342,21914643.0,-1.0
4398,2020-06-22,IBM,97.27933287255816,97.58203647275144,96.01276079538172,96.4429168701172,4993081.0,0.0,0.0,-1.115211486816392,1.115211486816392,0.0,39.456952741527395,93.8699455985956,108.24039715285473,17.904595842425127,-82.09540415757488,0.14135323586640425,0.8379216363451735,-0.08189882513818736,16921562.0,-1.0
4399,2020-06-23,IBM,97.19170137494746,97.90066485955502,94.9771917206984,95.12057495117188,6937700.0,0.0,0.0,-1.3223419189453267,1.3223419189453267,0.0,35.444007244405526,93.8699455985956,108.24039715285473,8.702783958139483,-91.29721604186052,-0.1637122182664541,0.6375948654228479,-0.08054217406804154,9983862.0,-1.0
4400,2020-06-24,IBM,94.252295029971,94.252295029971,92.30861476627398,92.73877716064452,7061546.0,0.0,0.0,-2.381797790527358,2.381797790527358,0.0,29.25937601572106,92.30861476627398,108.24039715285473,2.70002680135064,-97.29997319864935,-0.5908589109964879,0.39190411013898074,-0.013473553604111399,2922316.0,-1.0
4401,2020-06-25,IBM,93.0096224745042,94.96126832178729,92.48387544592862,94.81787872314452,6412608.0,0.0,0.0,2.0791015625,0.0,2.0791015625,39.833501368018574,92.30861476627398,108.24039715285473,15.750051663924808,-84.24994833607519,-0.7529303101610765,0.16293722607896927,-0.023623990281468,9334924.0,1.0
4402,2020-06-26,IBM,94.2045043579228,94.78601540992976,92.61132618017182,93.35215759277344,11244605.0,0.0,0.0,-1.4657211303710795,1.4657211303710795,0.0,35.51519613598613,92.30861476627398,106.42416002049524,7.3928623209747375,-92.60713767902527,-0.9882525471411725,-0.06730072856505916,-0.03666245378605382,-1909681.0,-1.0
4403,2020-06-29,IBM,93.98147188146947,95.41532986557718,93.4955517178314,95.39143371582033,4350837.0,0.0,0.0,2.039276123046889,0.0,2.039276123046889,45.07422249866104,92.30861476627398,105.33284721052502,23.66987047215302,-76.33012952784698,-0.9986823862740692,-0.25357706010686126,-0.04314806198228194,2441156.0,1.0
4404,2020-06-30,IBM,94.94531325170828,96.54645653923454,94.79396465625022,96.20392608642578,4099797.0,0.0,0.0,0.8124923706054545,0.0,0.8124923706054545,48.57845234118968,92.30861476627398,101.56497238289532,42.08254997794294,-57.91745002205706,-0.9306587106031117,-0.3889933902061114,-0.02722512580088421,6540953.0,1.0
4405,2020-07-01,IBM,95.80563597990312,96.57035708714038,94.29211817104505,94.4275360107422,4869967.0,0.0,0.0,-1.7763900756835795,1.7763900756835795,0.0,41.84380988175119,92.30861476627398,101.56497238289532,22.89152312636827,-77.10847687363173,-1.008464341563851,-0.5128875804776595,-0.04526422574358813,1670986.0,-1.0
4406,2020-07-02,IBM,95.34362000618889,96.72172008995295,95.00108950927088,95.3515853881836,3919362.0,0.0,0.0,0.924049377441392,0.0,0.924049377441392,46.31125161112205,92.30861476627398,101.56497238289532,32.874384806021894,-67.1256151939781,-0.9842173574600963,-0.6071535358741469,-0.022617725513111253,5590348.0,1.0
4407,2020-07-06,IBM,96.58631592511024,97.06426434071123,95.16041699028186,95.74192810058594,4231488.0,0.0,0.0,0.39034271240234375,0.0,0.39034271240234375,48.248927379134436,92.30861476627398,101.56497238289532,37.09140761963292,-62.90859238036708,-0.9228658303785267,-0.6702959947750229,-0.00726843185876791,9821836.0,1.0
4408,2020-07-07,IBM,94.79398075531068,95.20024068191496,93.46367926594468,93.66282653808594,4474893.0,0.0,0.0,-2.0791015625,2.0791015625,0.0,39.48980897090842,92.30861476627398,101.02328539082714,15.539448708440396,-84.46055129155961,-1.0301356608088668,-0.7422639279817917,-0.015325269152696386,5346943.0,-1.0
4409,2020-07-08,IBM,94.04520305902822,94.50722072447908,92.78658984004012,93.76639556884766,5431669.0,0.0,0.0,0.10356903076171875,0.0,0.10356903076171875,40.114686881846225,92.30861476627398,101.02328539082714,16.7278932891216,-83.2721067108784,-1.0941776205347225,-0.812646666492378,0.011080784539816202,10778612.0,1.0
4410,2020-07-09,IBM,93.99739723057732,93.99739723057732,91.76695019339164,92.17321014404295,4982098.0,0.0,0.0,-1.5931854248047017,1.5931854248047017,0.0,33.90082935646906,91.76695019339164,101.02328539082714,4.388993505376443,-95.61100649462355,-1.258975399272643,-0.9019124130484311,-0.027892087596935622,5796514.0,-1.0
4411,2020-07-10,IBM,92.005926607332,94.45145810998532,91.83864720759604,94.27620697021484,4482842.0,0.0,0.0,2.102996826171889,0.0,2.102996826171889,46.5185582175932,91.76695019339164,97.90066485955502,40.909251789384875,-59.09074821061513,-1.2059827395091673,-0.9627264783405785,0.00989853262387741,10279356.0,1.0
4412,2020-07-13,IBM,95.4153091307634,96.37917750827822,94.5231291869405,94.95328521728516,4864632.0,0.0,0.0,0.6770782470703125,0.0,0.6770782470703125,50.06001341831947,91.76695019339164,97.90066485955502,51.94788472099828,-48.052115279001725,-1.0967089409024453,-0.989522970852952,-0.004593163992486549,15143988.0,1.0
4413,2020-07-14,IBM,94.4912710100398,96.29952710634208,93.93365614149306,96.06851196289062,4742982.0,0.0,0.0,1.1152267456054688,0.0,1.1152267456054688,55.64238857799699,91.76695019339164,97.06426434071123,81.20269347581639,-18.797306524183615,-0.9096335014226327,-0.9735450769668883,-0.0014075737762875296,19886970.0,1.0
4414,2020-07-15,IBM,97.5023691009114,98.74505129645188,97.30322819996708,97.9803237915039,4679176.0,0.0,0.0,1.9118118286132812,0.0,1.9118118286132812,63.674232675086216,91.76695019339164,98.74505129645188,89.0410371868559,-10.958962813144105,-0.6001890254573539,-0.8988738666649816,0.037624488902871844,24566146.0,1.0
4415,2020-07-16,IBM,97.72543730660529,99.1592952919707,97.31121194892414,98.78489685058594,4530121.0,0.0,0.0,0.8045730590820312,0.0,0.8045730590820312,66.61006308728679,91.76695019339164,99.1592952919707,94.93532246679445,-5.064677533205557,-0.2867245449827749,-0.7764440023285403,0.03600686290033961,29096267.0,1.0
4416,2020-07-17,IBM,99.08757956722056,100.07535045333957,98.13964194603848,99.66112518310548,4167892.0,0.0,0.0,0.8762283325195455,0.0,0.8762283325195455,69.68845528494403,91.76695019339164,100.07535045333957,95.01437993748414,-4.985620062515863,0.03203335707131316,-0.6147485304485696,0.04093501311569647,33264159.0,1.0
4417,2020-07-20,IBM,100.42584492428377,101.22243392741848,99.68501994846967,100.66482543945312,10384374.0,0.0,0.0,1.003700256347642,0.0,1.003700256347642,72.980868837406,91.76695019339164,101.22243392741848,94.10280316004645,-5.8971968399535575,0.36147465853660776,-0.4195038926515341,0.07475750156354688,43648533.0,1.0
4418,2020-07-21,IBM,104.48049974688956,105.28505429608066,100.21078741082871,100.41790008544922,16063004.0,0.0,0.0,-0.24692535400390625,0.24692535400390625,0.0,70.79795505986196,91.76695019339164,105.28505429608066,63.995289770972654,-36.004710229027346,0.5957668219460146,-0.2164497497320243,0.0709369756216951,27585529.0,-1.0
4419,2020-07-22,IBM,100.29043567847476,103.1342551034708,100.21077549992371,102.49698638916016,8572388.0,0.0,0.0,2.0790863037109375,0.0,2.0790863037109375,77.3731236791374,91.76695019339164,105.28505429608066,79.37530377232484,-20.624696227675155,0.938392731215842,0.01451874645754903,0.11200408696826125,36157917.0,1.0
4420,2020-07-23,IBM,102.83951947496844,103.05459751252248,101.28617456093994,101.42955780029295,4414225.0,0.0,0.0,-1.0674285888672017,1.0674285888672017,0.0,68.26727522120504,91.76695019339164,105.28505429608066,71.47901461255377,-28.520985387446224,1.1109869011191336,0.23381237738986602,0.07587652346193896,31743692.0,-1.0
4421,2020-07-24,IBM,100.75245404563124,101.68446091900304,99.97179578177608,100.20280456542967,3693531.0,0.0,0.0,-1.2267532348632812,1.2267532348632812,0.0,59.05158009087319,91.76695019339164,105.28505429608066,62.4041234477546,-37.5958765522454,1.1356887773093263,0.4141876573737581,0.05528528408608335,28050161.0,-1.0
4422,2020-07-27,IBM,99.46199377837095,100.62500960156896,99.34250667861733,100.53738403320312,3905136.0,0.0,0.0,0.3345794677734517,0.0,0.3345794677734517,60.7202639745959,91.76695019339164,105.28505429608066,64.87917072680978,-35.12082927319022,1.1687898768555556,0.5651081012701177,0.04651755272360969,31955297.0,1.0
4423,2020-07-28,IBM,100.22670391732515,100.64092920763252,98.89640248775372,99.15131378173828,4370397.0,0.0,0.0,-1.3860702514648438,1.3860702514648438,0.0,50.82078846847865,91.76695019339164,105.28505429608066,54.62573399532962,-45.37426600467039,1.070834537330697,0.6662533884822336,0.011951277000534999,27584900.0,-1.0
4424,2020-07-29,IBM,99.22300012881976,100.36212601021263,98.83267734967616,99.82840728759766,2963109.0,0.0,0.0,0.677093505859375,0.0,0.677093505859375,54.95974344966377,91.83864720759604,105.28505429608066,59.419293402502845,-40.580706597497155,1.0358988155227138,0.7401824738903298,0.01056346132131969,30548009.0,1.0
4425,2020-07-30,IBM,98.54591339542544,98.69726202020536,96.89697750262494,97.90067291259766,4171553.0,0.0,0.0,-1.927734375,1.927734375,0.0,43.05587732224022,93.93365614149306,105.28505429608066,34.94738460478853,-65.05261539521146,0.8429430284592314,0.7607345848041102,-0.017664382850117177,26376456.0,-1.0
4426,2020-07-31,IBM,97.7493091512592,97.97235254115915,96.45883474248372,97.93252563476562,5519847.0,0.0,0.0,0.03185272216796875,0.0,0.03185272216796875,43.290057328970434,93.93365614149306,105.28505429608066,35.2279907621463,-64.7720092378537,0.6847016115487179,0.7455279901530318,-0.02714254748627065,31896303.0,1.0
4427,2020-08-03,IBM,98.37863060095134,99.10352493065496,97.30324035904732,99.02386474609376,3688301.0,0.0,0.0,1.0913391113281392,0.0,1.0913391113281392,51.22052976776933,96.45883474248372,105.28505429608066,29.061479697326618,-70.93852030267338,0.6399788167356206,0.7244181554695497,-0.013882339086649043,35584604.0,1.0
4428,2020-08-04,IBM,98.63353507447668,100.25857475572288,98.63353507447668,100.24263763427734,3625541.0,0.0,0.0,1.2187728881835795,0.0,1.2187728881835795,58.6684136624289,96.45883474248372,105.28505429608066,42.87002910834703,-57.12997089165296,0.6948704322017107,0.7185086108159819,-0.021994293045100033,39210145.0,1.0
4429,2020-08-05,IBM,100.95161524545362,100.96754601107162,99.26284602010765,99.93197631835938,3786102.0,0.0,0.0,-0.31066131591796875,0.31066131591796875,0.0,56.14705238048397,96.45883474248372,105.28505429608066,39.350273973869726,-60.64972602613028,0.7051758329956357,0.7158420552519128,-0.014764744265988061,35424043.0,-1.0
4430,2020-08-06,IBM,99.5735181263105,100.57721996204094,99.5735181263105,100.4656982421875,3574287.0,0.0,0.0,0.533721923828125,0.0,0.533721923828125,59.58974389362883,96.45883474248372,105.28505429608066,45.39727881651062,-54.60272118348938,0.7477897810113916,0.7222316004038086,0.0026236159546428883,38998330.0,1.0
4431,2020-08-07,IBM,99.66673594526289,100.93375884100408,99.43270245329737,100.84498596191406,3818946.0,1.558317,0.0,0.3792877197265625,0.0,0.3792877197265625,62.03373086495392,96.45883474248372,105.28505429608066,49.694562805690246,-50.305437194309754,0.8029115266883906,0.7383675856607251,0.0030595776055735158,42817276.0,1.0
4432,2020-08-10,IBM,101.21620394229662,102.68497509112744,101.02251884394558,102.58006286621094,4150842.0,0.0,0.0,1.735076904296875,0.0,1.735076904296875,71.22091016597503,96.45883474248372,103.1342551034708,91.69801739380019,-8.301982606199815,0.9753587838813758,0.7857658253048554,0.03458097481209732,46968118.0,1.0
4433,2020-08-11,IBM,103.91166010448472,105.29166504616444,102.17657649148435,102.28955841064452,5231255.0,0.0,0.0,-0.29050445556642046,0.29050445556642046,0.0,68.04014591152777,96.45883474248372,105.29166504616444,66.01195163605807,-33.98804836394193,1.0761776893990032,0.8438481981236851,0.02465381538099143,41736863.0,-1.0
4434,2020-08-12,IBM,102.98358457470594,103.12885163576432,101.58744678297168,102.24919891357422,3692066.0,0.0,0.0,-0.04035949707029829,0.04035949707029829,0.0,67.55649509279957,96.45883474248372,105.29166504616444,65.55502564877311,-34.44497435122689,1.1396831661562032,0.9030151917301887,0.044417733521186165,38044797.0,-1.0
4435,2020-08-13,IBM,101.65199128884734,101.99901310375644,100.69164192166316,100.9014663696289,3317180.0,0.0,0.0,-1.3477325439453125,1.3477325439453125,0.0,53.0317498202046,96.45883474248372,105.29166504616444,50.29680718867545,-49.70319281132455,1.068938898957171,0.9361999331755854,0.030316186737956663,34727617.0,-1.0
4436,2020-08-14,IBM,100.23163940548828,101.329179641933,99.997599502471,101.09514617919922,3099716.0,0.0,0.0,0.1936798095703125,0.0,0.1936798095703125,54.64856719662019,96.45883474248372,105.29166504616444,52.48953367510647,-47.51046632489353,1.0167810801321195,0.9523161625668922,0.020916992468597462,37827333.0,1.0
4437,2020-08-17,IBM,101.07901349555604,101.35340179290677,100.40111564810056,100.42533111572266,3514665.0,0.0,0.0,-0.6698150634765625,0.6698150634765625,0.0,48.04841272229647,96.45883474248372,105.29166504616444,44.906289794632,-55.093710205368,0.9108969027111442,0.9440323105957427,0.0018225127127224905,34312668.0,-1.0
4438,2020-08-18,IBM,100.87726221301207,101.28077177708684,100.26392819084114,100.8126983642578,3014990.0,0.0,0.0,0.38736724853514204,0.0,0.38736724853514204,51.92302582120128,96.45883474248372,105.29166504616444,49.291829142916804,-50.70817085708319,0.848459713415906,0.9249177911597755,0.008813215532660568,37327658.0,1.0
4439,2020-08-19,IBM,100.74008112194431,101.2807816721282,99.66674325813896,99.94113159179688,3916119.0,0.0,0.0,-0.8715667724609233,0.8715667724609233,0.0,43.50038477402676,96.45883474248372,105.29166504616444,39.42447357855446,-60.57552642144554,0.7203459369521994,0.8840034203182604,-0.005221350765174382,33411539.0,-1.0
4440,2020-08-20,IBM,99.4246245325688,100.10251592348811,99.1098878638669,99.38426971435548,2679015.0,0.0,0.0,-0.556861877441392,0.556861877441392,0.0,38.853965666886396,97.30324035904732,105.29166504616444,26.05055986400202,-73.94944013599797,0.5673407949473983,0.820670895244088,-0.014484768217531863,30732524.0,-1.0
4441,2020-08-21,IBM,99.27129122465092,99.65059175134834,98.70638171282027,99.39234924316406,3540815.0,0.0,0.0,0.00807952880857954,0.0,0.00807952880857954,38.9631107377604,98.63353507447668,105.29166504616444,11.396806189036129,-88.60319381096387,0.44164407009135687,0.7448655302135418,-0.03107537209452116,34273339.0,1.0
4442,2020-08-24,IBM,99.90076011646076,101.73269238055828,99.55374474901666,101.426025390625,4258057.0,0.0,0.0,2.0336761474609375,0.0,2.0336761474609375,59.802296364399595,98.70638171282027,105.29166504616444,41.29881039489952,-58.70118960510048,0.5003613251145111,0.6959646891937358,-0.00844204465672671,38531396.0,1.0
4443,2020-08-25,IBM,101.68429313018468,102.34604528543008,100.46569462062028,100.58674621582033,3114674.0,0.0,0.0,-0.8392791748046733,0.8392791748046733,0.0,51.439398515412705,98.70638171282027,105.29166504616444,28.5540410004676,-71.4459589995324,0.47371170385062555,0.6515140921251138,-0.016258833471732848,35416722.0,-1.0
4444,2020-08-26,IBM,100.83691543246933,100.97410636792894,100.0298962915166,100.20743560791016,3544162.0,0.0,0.0,-0.37931060791017046,0.37931060791017046,0.0,47.94315263098113,98.70638171282027,105.29166504616444,22.794066999203977,-77.20593300079602,0.4171755509034796,0.604646383880787,-0.006878302037517825,31872560.0,-1.0
4445,2020-08-27,IBM,100.55445447670247,100.95796403526718,100.05410236647086,100.59480285644533,3580144.0,0.0,0.0,0.38736724853517046,0.0,0.38736724853517046,51.80326150254358,98.70638171282027,105.29166504616444,28.676384113393443,-71.32361588660655,0.39902779789748877,0.5635226666841273,-0.004949231903448648,35452704.0,1.0
4446,2020-08-28,IBM,100.844988715166,101.11937059589796,100.24779401428084,100.93376159667967,3242182.0,0.0,0.0,0.3389587402343466,0.0,0.3389587402343466,55.1602993683494,98.70638171282027,105.29166504616444,33.82359985304204,-66.17640014695796,0.4073015912260729,0.5322784515925164,0.005062771268049326,38694886.0,1.0
4447,2020-08-31,IBM,101.07902638062151,101.07902638062151,99.2874422041059,99.51341247558594,5049983.0,0.0,0.0,-1.4203491210937358,1.4203491210937358,0.0,41.26383412947689,98.70638171282027,103.12885163576432,18.248417215428372,-81.75158278457162,0.295838090969184,0.48499037946784995,-0.012888117367687801,33644903.0,-1.0
4448,2020-09-01,IBM,99.14217111401364,100.0298934317392,98.57726159566764,99.58602905273438,3300444.0,0.0,0.0,0.0726165771484375,0.0,0.0726165771484375,42.123966054873755,98.57726159566764,102.34604528543008,26.76639308875602,-73.23360691124398,0.2109305389054441,0.43017841135536883,-0.003553117054076349,36945347.0,1.0
4449,2020-09-02,IBM,99.84428704458264,103.86323720568554,99.7313051306835,103.44358825683594,6895650.0,0.0,0.0,3.8575592041015625,0.0,3.8575592041015625,69.50044896815274,98.57726159566764,103.86323720568554,92.06108805999243,-7.938911940007559,0.4497292817592893,0.4340885854361529,0.04084467848028184,43840997.0,1.0
4450,2020-09-03,IBM,103.4516564503587,104.87200969084851,99.7877914368548,100.43341064453124,5979773.0,0.0,0.0,-3.0101776123047017,3.0101776123047017,0.0,48.74150511351829,98.57726159566764,104.87200969084851,29.487264951628912,-70.51273504837108,0.39156906527279034,0.4255846814034804,0.010474260939543845,37861224.0,-1.0
4451,2020-09-04,IBM,100.35268191409244,101.15970088821142,97.84285213174849,98.69829559326172,6295037.0,0.0,0.0,-1.735115051269517,1.735115051269517,0.0,40.66346369687856,97.84285213174849,104.87200969084851,12.169928676670013,-87.83007132332999,0.20312588228011919,0.38109292157880814,-0.02689378576019219,31566187.0,-1.0
4452,2020-09-08,IBM,98.58532763117624,99.15830680431998,97.41514737734671,97.81865692138672,5449974.0,0.0,0.0,-0.879638671875,0.879638671875,0.0,37.06969519057171,97.41514737734671,104.87200969084851,5.411251101007849,-94.58874889899215,-0.01700021932845175,0.3014742933973562,-0.02751942376676897,26116213.0,-1.0
4453,2020-09-09,IBM,98.56111865304274,99.82814153847218,97.88322721142852,98.66603088378906,3944152.0,0.0,0.0,0.8473739624023438,0.0,0.8473739624023438,42.69866804671222,97.41514737734671,104.87200969084851,16.774930981056624,-83.22506901894337,-0.12167317123093824,0.2168448004716973,-0.015382139207236856,30060365.0,1.0
4454,2020-09-10,IBM,98.88394259198633,99.73131020952468,97.03587061148332,97.29411315917967,4161406.0,0.0,0.0,-1.3719177246093892,1.3719177246093892,0.0,36.585345160139404,97.03587061148332,104.87200969084851,3.2955329797091246,-96.70446702029088,-0.3117360355538068,0.11112863326659644,-0.03281173185433772,25898959.0,-1.0
4455,2020-09-11,IBM,97.96392852752746,99.02112049082608,97.43129126757698,98.02041625976562,3711313.0,0.0,0.0,0.7263031005859517,0.0,0.7263031005859517,41.68543455210727,97.03587061148332,104.87200969084851,12.564167612528701,-87.43583238747131,-0.3991544307964432,0.009072020453988486,-0.0288639330470557,29610272.0,1.0
4456,2020-09-14,IBM,98.74673324715924,99.56989173375862,98.26252691877195,98.52883911132812,3809009.0,0.0,0.0,0.5084228515625,0.0,0.5084228515625,45.242461406059796,97.03587061148332,104.87200969084851,19.052348161816337,-80.94765183818366,-0.42253790978443817,-0.07724996559369687,-0.009893876008918556,33419281.0,1.0
4457,2020-09-15,IBM,99.11796156122328,99.58602852533338,98.64988815682908,98.81129455566406,3049299.0,0.0,0.0,0.2824554443359375,0.0,0.2824554443359375,47.30294536208251,97.03587061148332,104.87200969084851,22.656871275497714,-77.3431287245023,-0.4135109942321691,-0.14450217132139134,-0.007779550047728678,36468580.0,1.0
4458,2020-09-16,IBM,99.0291966605256,101.53902063850396,99.0291966605256,100.24779510498048,3962666.0,0.0,0.0,1.4365005493164205,0.0,1.4365005493164205,56.83453786767011,97.03587061148332,104.87200969084851,40.988610091863784,-59.011389908136216,-0.28713361208214394,-0.17302845947354187,-0.03089406705344311,40431246.0,1.0
4459,2020-09-17,IBM,98.95655694562748,101.32112015738068,98.4319958003871,100.8126983642578,3317180.0,0.0,0.0,0.5649032592773153,0.0,0.5649032592773153,60.1085141482949,97.03587061148332,104.87200969084851,48.19755895757327,-51.80244104242673,-0.1397843078104728,-0.16637962914092808,0.003776509403519146,43748426.0,1.0
4460,2020-09-18,IBM,100.28008610625214,100.81271702614896,98.98078429657772,99.0695571899414,5639614.0,0.0,0.0,-1.743141174316392,1.743141174316392,0.0,47.327644357797524,97.03587061148332,104.87200969084851,25.952660587831684,-74.04733941216831,-0.16180070944839997,-0.16546384520242247,0.003761580627589245,38108812.0,-1.0
4461,2020-09-21,IBM,97.2295390476675,97.40708480566175,95.69621039682936,97.04393005371094,5555724.0,0.0,0.0,-2.0256271362304688,2.0256271362304688,0.0,36.82794704092209,95.69621039682936,104.87200969084851,14.687763035096374,-85.31223696490362,-0.33879463374209706,-0.2001300029103574,-0.00792003174096334,32553088.0,-1.0
4462,2020-09-22,IBM,97.10850184637522,98.01236368242596,96.46288900931836,97.25376892089844,3093859.0,0.0,0.0,0.2098388671875,0.0,0.2098388671875,38.4598516276329,95.69621039682936,104.87200969084851,16.974635932635387,-83.02536406736462,-0.45686489688897325,-0.25147698170608057,-0.014313558073031363,35646947.0,1.0
4463,2020-09-23,IBM,97.4877872906832,98.12533035117828,95.57515166891363,95.89796447753906,4120612.0,0.0,0.0,-1.355804443359375,1.355804443359375,0.0,32.249073187494275,95.57515166891363,104.87200969084851,3.4722785683484525,-96.52772143165154,-0.6523189914527592,-0.33164538365541635,-0.014349775503440965,31526335.0,-1.0
4464,2020-09-24,IBM,95.30882803703524,96.4547927612292,94.00145692789748,95.3007583618164,3709325.0,0.0,0.0,-0.5972061157226562,0.5972061157226562,0.0,29.80297882420102,94.00145692789748,101.53902063850396,17.23768426780415,-82.76231573219586,-0.845659080568069,-0.434448123037947,-0.027745830937320304,27817010.0,-1.0
4465,2020-09-25,IBM,94.90531856557554,96.36601994493384,94.37268779943048,95.99478912353516,3089570.0,0.0,0.0,0.69403076171875,0.0,0.69403076171875,36.2835044295947,94.00145692789748,101.53902063850396,26.445311405232452,-73.55468859476755,-0.9321349405575461,-0.533985486541867,-0.025718865772179966,30906580.0,1.0
4466,2020-09-28,IBM,97.30216381528577,98.7225168708148,97.17304256667867,98.2383041381836,3670623.0,0.0,0.0,2.2435150146484375,0.0,2.2435150146484375,52.60394586849999,94.00145692789748,101.53902063850396,56.20976980034329,-43.79023019965671,-0.8102942035909422,-0.589247229951682,-0.005798835245070966,34577203.0,1.0
4467,2020-09-29,IBM,97.9800619252595,98.60953525936462,97.01163645718722,97.60076141357422,2203504.0,0.0,0.0,-0.637542724609375,0.637542724609375,0.0,48.52824046241986,94.00145692789748,101.53902063850396,47.75156302310229,-52.24843697689771,-0.7564589238441783,-0.6226895687301813,-0.02640490684742003,32373699.0,-1.0
4468,2020-09-30,IBM,97.95585452526936,99.1905921873526,97.48778113454772,98.18988800048828,3411111.0,0.0,0.0,0.5891265869140625,0.0,0.5891265869140625,52.45585400959911,94.00145692789748,101.53902063850396,55.56743841112818,-44.43256158887181,-0.6586638182620277,-0.6298844186365506,-0.026016666613691286,35784810.0,1.0
4469,2020-10-01,IBM,98.74673796515398,99.50533907903166,97.13270605960636,97.7218246459961,3359438.0,0.0,0.0,-0.4680633544921875,0.4680633544921875,0.0,49.026335933087566,94.00145692789748,101.53902063850396,49.35769515106721,-50.642304848932795,-0.6118759681698549,-0.6262827285432115,-0.013603901967194298,32425372.0,-1.0
4470,2020-10-02,IBM,96.06743208586605,98.2544495323124,95.88988633293413,97.30216979980467,3059759.0,0.0,0.0,-0.41965484619142046,0.41965484619142046,0.0,45.92048163973497,94.00145692789748,101.53902063850396,43.790182061912105,-56.209817938087895,-0.6017226150226378,-0.6213707058390968,0.0026610602636436553,29365613.0,-1.0
4471,2020-10-05,IBM,98.32708823501456,99.06147387318316,97.68954515442852,98.46427917480467,3190823.0,0.0,0.0,1.162109375,0.0,1.162109375,55.02445092210164,94.00145692789748,101.53902063850396,59.20775489601948,-40.79224510398052,-0.49420658916629634,-0.5959378825045367,0.012446923829664724,32556436.0,1.0
4472,2020-10-06,IBM,98.92428166458332,100.7400747657538,98.12533218484556,98.43199920654295,4050426.0,0.0,0.0,-0.03227996826171875,0.03227996826171875,0.0,54.7291595562263,94.00145692789748,101.32112015738068,60.529318627658945,-39.47068137234105,-0.40691344285339426,-0.5581329945743082,0.02642428066966329,28506010.0,-1.0
4473,2020-10-07,IBM,98.9969215285797,100.38498967126245,98.71446351781653,100.12674713134766,2944908.0,0.0,0.0,1.6947479248047017,0.0,1.6947479248047017,65.8358674065632,94.00145692789748,100.81271702614896,89.92888415790496,-10.071115842095043,-0.19869061977077251,-0.48624451961360105,0.0506395631313763,31450918.0,1.0
4474,2020-10-08,IBM,105.60640053727852,109.35096250074804,104.72674778518808,106.11482238769533,26452189.0,0.0,0.0,5.9880752563476705,0.0,5.9880752563476705,82.91983814321478,94.00145692789748,109.35096250074804,78.91697489737626,-21.083025102623733,0.44439241727917533,-0.30011713223504577,0.10542273551053638,57903107.0,1.0
4475,2020-10-09,IBM,106.5263914208075,106.5263914208075,102.97550848663845,103.12884521484376,8737970.0,0.0,0.0,-2.9859771728515625,2.9859771728515625,0.0,64.39290353455351,94.00145692789748,109.35096250074804,59.46372828510095,-40.53627171489905,0.7049704932899346,-0.09909960713004966,0.04978242570007163,49165137.0,-1.0
4476,2020-10-12,IBM,103.3548038009079,103.50006440529,102.03936292455012,102.6607666015625,4848315.0,0.0,0.0,-0.4680786132812642,0.4680786132812642,0.0,61.89165171359902,94.00145692789748,109.35096250074804,56.414257987444074,-43.585742012555926,0.8637536492954325,0.09347104415504684,0.05184391099724084,44316822.0,-1.0
4477,2020-10-13,IBM,102.1442752202062,102.61234861737492,100.44147058423144,100.9579620361328,5654781.0,0.0,0.0,-1.7028045654297017,1.7028045654297017,0.0,53.21508201935218,94.00145692789748,109.35096250074804,45.32071131033457,-54.67928868966543,0.8424767987891499,0.24327219508186754,0.02819102956539421,38662041.0,-1.0
4478,2020-10-14,IBM,100.98218180766835,102.44288344482578,100.98218180766835,101.6358642578125,3899593.0,0.0,0.0,0.6779022216797017,0.0,0.6779022216797017,56.04561581470706,94.37268779943048,109.35096250074804,48.49140907893161,-51.50859092106839,0.8702836965744609,0.3686744953803863,0.040052870748118696,42561634.0,1.0
4479,2020-10-15,IBM,100.13480030681085,101.05480127918264,99.94918488917476,100.78848266601562,3541024.0,0.0,0.0,-0.847381591796875,0.847381591796875,0.0,51.547506467682744,95.88988633293413,109.35096250074804,36.390822487092684,-63.60917751290732,0.814554572740704,0.45785051085244993,0.035829754602429764,39020610.0,-1.0
4480,2020-10-16,IBM,101.01445830490572,102.03130194307968,100.60287904375365,101.62779235839844,4927078.0,0.0,0.0,0.8393096923828125,0.0,0.8393096923828125,55.618337269047046,95.88988633293413,109.35096250074804,42.62590861185321,-57.37409138814679,0.8285629603232394,0.5319930007466079,0.03212853646120273,43947688.0,1.0
4481,2020-10-19,IBM,102.3298883987164,102.77374631849622,100.94182046981102,101.29690551757812,7822720.0,0.0,0.0,-0.3308868408203125,0.3308868408203125,0.0,53.570943491305265,95.88988633293413,109.35096250074804,40.16780766438603,-59.83219233561397,0.8037003483600955,0.5863344702693055,0.02910543658697451,36124968.0,-1.0
4482,2020-10-20,IBM,96.68077270438484,96.96323070509676,94.29200031389622,94.71971893310548,22490151.0,0.0,0.0,-6.577186584472642,6.577186584472642,0.0,29.0469103223582,94.29200031389622,109.35096250074804,2.8402928030638495,-97.15970719693615,0.25038626275173215,0.5191448287657908,-0.05400183620415788,13634817.0,-1.0
4483,2020-10-21,IBM,94.1467388599947,94.97796706133522,92.6376127510178,92.85550689697266,10204044.0,0.0,0.0,-1.8642120361328267,1.8642120361328267,0.0,25.264441523982924,92.6376127510178,109.35096250074804,1.3037131946477403,-98.69628680535226,-0.33468739994064833,0.3483783830245029,-0.12495252965018555,3430773.0,-1.0
4484,2020-10-22,IBM,92.80709016179487,93.66252740482464,91.17691244184412,93.42041778564452,8217167.0,0.0,0.0,0.5649108886718608,0.0,0.5649108886718608,28.519046558676635,91.17691244184412,109.35096250074804,12.34455356141844,-87.65544643858156,-0.7442002283105325,0.1298626607574958,-0.09413881643854449,11647940.0,1.0
4485,2020-10-23,IBM,94.0175995017307,94.11444204796057,93.23479589668015,93.61408996582033,4072496.0,0.0,0.0,0.19367218017580967,0.0,0.19367218017580967,29.729585392347403,91.17691244184412,109.35096250074804,13.410205848872797,-86.5897941511272,-1.0411130654716487,-0.10433248448833318,-0.08812204443059835,15720436.0,1.0
4486,2020-10-26,IBM,92.3632308423722,92.72639207103532,90.25691632503776,90.56358337402344,7534756.0,0.0,0.0,-3.050506591796889,3.050506591796889,0.0,22.73285666471844,90.25691632503776,109.35096250074804,1.6060872911043207,-98.39391270889568,-1.50521780201791,-0.38450954799424863,-0.10295749292551304,8185680.0,-1.0
4487,2020-10-27,IBM,90.50707851339928,90.56357268640974,88.79620413485648,89.22392272949219,6209161.0,0.0,0.0,-1.33966064453125,1.33966064453125,0.0,20.310702076545667,88.79620413485648,109.35096250074804,2.0808738639587228,-97.91912613604129,-1.958546660676106,-0.6993169705306203,-0.12212167052405654,1976519.0,-1.0
4488,2020-10-28,IBM,87.69058941915294,88.55409630179649,85.47935643625203,86.0684814453125,9860956.0,0.0,0.0,-3.1554412841796875,3.1554412841796875,0.0,15.749919302585013,85.47935643625203,106.5263914208075,2.7990878976196565,-97.20091210238034,-2.5431153371585253,-1.0680766438562015,-0.1460484455300416,-7884437.0,-1.0
4489,2020-10-29,IBM,86.5526916695776,88.48146660545245,85.98777570597596,87.89234161376953,7071169.0,0.0,0.0,1.8238601684570312,0.0,1.8238601684570312,26.723723058021804,85.47935643625203,103.50006440529,13.390068701314817,-86.60993129868518,-2.8266362487460697,-1.4197885648341753,-0.13515447325855268,-813268.0,1.0
4490,2020-10-30,IBM,87.07724849675279,90.22461519984478,86.95619692206215,90.11163330078124,8285889.0,0.0,0.0,2.2192916870117045,0.0,2.2192916870117045,38.052464203061376,85.47935643625203,102.77374631849622,26.784852753233405,-73.21514724676659,-2.839518124687004,-1.703734476804741,-0.11042067040099168,7472621.0,1.0
4491,2020-11-02,IBM,90.91059788139272,91.8628777268649,90.58779148158612,91.12042236328124,5555829.0,0.0,0.0,1.0087890625,0.0,1.0087890625,42.6988521214431,85.47935643625203,102.77374631849622,32.61789496731986,-67.38210503268014,-2.7367783800573875,-1.9103432574552706,-0.03799944309765324,13028450.0,1.0
4492,2020-11-03,IBM,92.00006727673431,93.33164758765164,91.70146993329236,92.12918853759766,4397698.0,0.0,0.0,1.0087661743164205,0.0,1.0087661743164205,47.262856822498186,85.47935643625203,102.77374631849622,38.45080483684987,-61.54919516315013,-2.5446245448031846,-2.037199514924853,-0.007822027832779854,17426148.0,1.0
4493,2020-11-04,IBM,90.652350220565,91.92743639386836,89.70813366508037,90.30532836914062,6066905.0,0.0,0.0,-1.8238601684570312,1.8238601684570312,0.0,40.528551832329114,85.47935643625203,102.77374631849622,27.904840620271447,-72.09515937972854,-2.51057121671964,-2.1318738552838106,-0.0333448457022697,11359243.0,-1.0
4494,2020-11-05,IBM,91.43516299977654,93.04113183086022,91.20112947694938,92.6214828491211,5127701.0,0.0,0.0,2.3161544799804688,0.0,2.3161544799804688,50.800589459269816,85.47935643625203,102.77374631849622,41.297359788342355,-58.702640211657645,-2.27051630068172,-2.1596023443633925,-0.01060318075047939,16486944.0,1.0
4495,2020-11-06,IBM,92.87165421199768,92.88779356637286,91.50779504358788,92.03235626220705,5490663.0,0.0,0.0,-0.5891265869140483,0.5891265869140483,0.0,48.34966157150033,85.47935643625203,96.96323070509676,57.062622530908634,-42.93737746909136,-2.10356011071147,-2.148393897633008,0.016218140155934924,10996281.0,-1.0
4496,2020-11-09,IBM,96.510751482889,98.0335740275697,94.3738944393642,94.58676147460938,9405841.0,1.558317,0.0,2.5544052124023295,0.0,2.5544052124023295,58.39261184118381,85.47935643625203,98.0335740275697,72.54458489436972,-27.455415105630276,-1.7450115676005566,-2.0677174316265177,0.060105390808428805,20402122.0,1.0
4497,2020-11-10,IBM,95.53647375204672,96.74817586714194,95.17623322028491,96.53530883789062,5881449.0,0.0,0.0,1.94854736328125,0.0,1.94854736328125,64.47281415310619,85.47935643625203,98.0335740275697,88.065642651317,-11.934357348683003,-1.2887716194587426,-1.9119282691929627,0.1216104573568979,26283571.0,1.0
4498,2020-11-11,IBM,96.70723890506068,96.89554585495374,95.15166969631414,95.95401763916016,4486922.0,0.0,0.0,-0.5812911987304688,0.5812911987304688,0.0,61.385071958878235,85.47935643625203,98.0335740275697,83.43539632571179,-16.564603674288207,-0.9630026204491031,-1.7221431394441906,0.09172216688476142,21796649.0,-1.0
4499,2020-11-12,IBM,94.6686174924695,95.27447176420102,92.90837457553546,93.74346923828124,6797117.0,0.0,0.0,-2.2105484008789205,2.2105484008789205,0.0,50.72539525921853,85.47935643625203,98.0335740275697,65.82738224757675,-34.17261775242325,-0.8731361532558282,-1.5523417422065182,0.04030374108720669,14999532.0,-1.0
4500,2020-11-13,IBM,94.30838210159423,96.0931915956417,94.16101514778788,95.6674575805664,4898000.0,0.0,0.0,1.9239883422851705,0.0,1.9239883422851705,58.0425273990579,85.47935643625203,98.0335740275697,81.15281633608399,-18.84718366391601,-0.6392971313892701,-1.3697328200430687,0.04990138433683877,19897532.0,1.0
4501,2020-11-16,IBM,96.85459799745706,97.0592783118076,95.8885097885378,96.90372467041016,5536896.0,0.0,0.0,1.23626708984375,0.0,1.23626708984375,62.203778412551166,85.47935643625203,98.0335740275697,91.00024076418006,-8.999759235819937,-0.3501848862198216,-1.1658232332784193,0.051824358909489554,25434428.0,1.0
4502,2020-11-17,IBM,96.28151461410263,97.0511093390447,95.84759383654637,96.36338806152344,4324687.0,0.0,0.0,-0.5403366088867188,0.5403366088867188,0.0,59.2407544323018,85.98777570597596,98.0335740275697,86.13470090187194,-13.865299098128064,-0.1627855075370519,-0.9652156881301458,0.06708418873822497,21109741.0,-1.0
4503,2020-11-18,IBM,96.37975475390786,97.32946969051514,95.58559347629703,95.60196685791016,4818713.0,0.0,0.0,-0.7614212036132812,0.7614212036132812,0.0,54.98232020400193,86.95619692206215,98.0335740275697,78.04889057671808,-21.951109423281927,-0.07484767999649478,-0.7871420865034157,0.032179186913301905,16291028.0,-1.0
4504,2020-11-19,IBM,95.4136716791165,96.15870631915932,94.88150407908591,95.93765258789062,3597822.0,0.0,0.0,0.33568572998046875,0.0,0.33568572998046875,56.57039538582136,89.70813366508037,98.0335740275697,74.82509815189658,-25.174901848103413,0.02168079217756258,-0.62537751076722,0.04243394914889609,19888850.0,1.0
4505,2020-11-20,IBM,96.28151181513144,96.64174582616953,95.53647718597264,95.74115753173828,5255418.0,0.0,0.0,-0.19649505615234375,0.19649505615234375,0.0,55.25390532369915,89.70813366508037,98.0335740275697,72.46492202190277,-27.535077978097227,0.08138661869291752,-0.4840246848751925,0.012204626092825688,14633432.0,-1.0
4506,2020-11-23,IBM,96.1423387159588,98.67218327441029,96.01133858063643,98.32012939453124,5910318.0,0.0,0.0,2.5789718627929545,0.0,2.5789718627929545,66.91426685966388,89.70813366508037,98.67218327441029,96.07260228108701,-3.92739771891298,0.33296715423466594,-0.3206263170532208,0.01848878486148342,20543750.0,1.0
4507,2020-11-24,IBM,98.95053599559944,102.11898799428664,98.90960254011038,101.86518096923828,8109115.0,0.0,0.0,3.5450515747070455,0.0,3.5450515747070455,76.58997275181922,91.20112947694938,102.11898799428664,97.67530395594225,-2.3246960440577356,0.8090760509550279,-0.09468584345157102,0.061604125345822824,28652865.0,1.0
4508,2020-11-25,IBM,100.64528357593122,101.7914921026526,99.97392922723456,101.68505859375,4326151.0,0.0,0.0,-0.18012237548828125,0.18012237548828125,0.0,75.29897941421915,91.50779504358788,102.11898799428664,95.91064451892692,-4.089355481073089,1.1585068654296862,0.1559526983246805,0.08471618791152791,24326714.0,-1.0
4509,2020-11-27,IBM,101.685069683813,102.5938446869641,101.44763603523394,101.80787658691406,2187395.0,0.0,0.0,0.1228179931640625,0.0,0.1228179931640625,75.62226598004418,92.90837457553546,102.5938446869641,91.88508052776275,-8.114919472237247,1.4288725358781278,0.41053666583537,0.06418503388340291,26514109.0,1.0
4510,2020-11-30,IBM,101.60317947175072,102.34002730244272,100.77627151799942,101.1283187866211,6263448.0,0.0,0.0,-0.6795578002929688,0.6795578002929688,0.0,69.79073181428254,92.90837457553546,102.5938446869641,84.8688201658511,-15.131179834148906,1.5702043046006366,0.6424701935884235,0.04359578675205378,20250661.0,-1.0
4511,2020-12-01,IBM,101.43943538733848,103.0195645950031,100.76808759146198,100.83358764648438,5553319.0,0.0,0.0,-0.29473114013671875,0.29473114013671875,0.0,67.19754345387452,92.90837457553546,103.0195645950031,78.38061648223459,-21.61938351776541,1.6395289406589342,0.8418819430025258,0.04638898314894169,14697342.0,-1.0
4512,2020-12-02,IBM,100.57979482849352,102.04530404670837,100.21956080926812,102.0289306640625,3860472.0,0.0,0.0,1.195343017578125,0.0,1.195343017578125,72.05639067740776,92.90837457553546,103.0195645950031,90.2025980222577,-9.797401977742288,1.7705140222702909,1.027608358856079,0.06722627177435081,18557814.0,1.0
4513,2020-12-03,IBM,101.65229755150436,102.22540503802404,100.94001633875052,101.2020034790039,4757417.0,0.0,0.0,-0.8269271850585938,0.8269271850585938,0.0,64.4375558056833,94.16101514778788,103.0195645950031,79.48240705965054,-20.517592940349463,1.7869951623626008,1.1794857195573833,0.05487262559703021,13800397.0,-1.0
4514,2020-12-04,IBM,101.4967556468037,104.288593593167,101.22657525186337,104.14122009277344,5776849.0,0.0,0.0,2.9392166137695312,0.0,2.9392166137695312,75.19428157924362,94.88150407908591,104.288593593167,98.43337835604777,-1.5666216439522411,2.0140105414551357,1.346390683936934,0.08773721540028934,19577246.0,1.0
4515,2020-12-07,IBM,103.55993047084009,103.95291121939958,101.98798787558712,102.09442138671876,8701151.0,0.0,0.0,-2.0467987060546733,2.0467987060546733,0.0,60.492186582702374,94.88150407908591,104.288593593167,76.6753340322332,-23.324665967766805,2.0056425167118306,1.4782410504919135,0.03838778503883322,10876095.0,-1.0
4516,2020-12-08,IBM,102.6020327471965,103.4289408484278,102.04530506333006,102.92133331298828,5643170.0,0.0,0.0,0.826911926269517,0.0,0.826911926269517,63.792289632745046,94.88150407908591,104.288593593167,85.46563973764556,-14.534360262354445,2.042194531139998,1.5910317466215307,0.01036813888416832,16519265.0,1.0
4517,2020-12-09,IBM,102.99501494349796,104.54239754702066,102.91314149985544,103.80554962158205,6813121.0,0.0,0.0,0.8842163085937642,0.0,0.8842163085937642,67.17522314117342,94.88150407908591,104.54239754702066,92.37288012869341,-7.627119871306581,2.118095051036903,1.6964444075046052,0.020853516309645714,23332386.0,1.0
4518,2020-12-10,IBM,103.4453109916361,103.92016518292228,102.2909092086014,102.30728912353516,5024147.0,0.0,0.0,-1.4982604980468892,1.4982604980468892,0.0,56.79959590523669,95.53647718597264,104.54239754702066,75.18178782534336,-24.818212174656644,2.0339040790203313,1.7639363418077507,0.004905441046054504,18308239.0,-1.0
4519,2020-12-11,IBM,101.58680932850385,102.7575778982341,101.20200875417343,101.74236297607422,4687544.0,0.0,0.0,-0.5649261474609375,0.5649261474609375,0.0,53.22310053267855,96.01133858063643,104.54239754702066,67.17834700264422,-32.82165299735579,1.8996987634945697,1.7910888261451148,0.0060719311546031385,13620695.0,-1.0
4520,2020-12-14,IBM,102.60202183327428,103.35524963174332,101.08739261314572,101.13651275634766,5282300.0,0.0,0.0,-0.6058502197265625,0.6058502197265625,0.0,49.37586612305549,98.90960254011038,104.54239754702066,39.53472855847434,-60.46527144152566,1.7245732279506854,1.7777857065062292,0.0030042083886305804,8338395.0,-1.0
4521,2020-12-15,IBM,101.8406041741874,103.10143280029295,101.06282291189892,103.10143280029295,4556585.0,0.0,0.0,1.9649200439452983,0.0,1.9649200439452983,60.154335090761116,99.97392922723456,104.54239754702066,68.45847128923134,-31.541528710768667,1.7244591141162005,1.7671203880282234,0.010511745337817402,12894980.0,1.0
4522,2020-12-16,IBM,103.10145047386722,103.62543137627269,102.57746957146176,102.79033660888672,4738485.0,0.0,0.0,-0.3110961914062358,0.3110961914062358,0.0,57.90221090383579,100.21956080926812,104.54239754702066,59.469648186509104,-40.5303518134909,1.6799009627762445,1.7496765029778276,0.01569468069090485,8156495.0,-1.0
4523,1.0,1.0,1.0,1.0,1.0,1.0,1.0,1.0,1.0,1.0,1.0,1.0,1.0,1.0,1.0,1.0,1.0,1.0,1.0,1.0,1.0,1.0
4524,2020-12-18,IBM,102.82307507092617,103.48623616098492,102.31546762407687,103.03594207763672,7900229.0,0.0,0.0,0.24560546875,0.0,0.24560546875,59.49611164748004,100.21956080926812,104.54239754702066,65.1512291401699,-34.848770859830104,1.5845605370739406,1.6968405188772329,0.00922205815096988,16056724.0,1.0
4525,2020-12-21,IBM,101.49676476476728,101.66869181910916,99.65464158006291,101.02190399169922,6397022.0,0.0,0.0,-2.0140380859375,2.0140380859375,0.0,43.80368292308258,99.65464158006291,104.54239754702066,27.97321349263927,-72.02678650736073,1.3734922613341212,1.6321708673686106,-0.018455156575875376,9659702.0,-1.0
4526,2020-12-22,IBM,100.95638971830748,101.70142422384626,100.21954190254718,101.2020034790039,4535561.0,0.0,0.0,0.1800994873046875,0.0,0.1800994873046875,45.29249937624347,99.65464158006291,104.54239754702066,31.65792051406583,-68.34207948593416,1.2068399558376512,1.5471046850624188,-0.02508099183588197,14195263.0,1.0
4527,2020-12-23,IBM,101.42307211363612,102.51197388498956,101.3084519061787,101.43944549560548,2817819.0,0.0,0.0,0.2374420166015767,0.0,0.2374420166015767,47.41190342435441,99.65464158006291,104.54239754702066,36.515814774882756,-63.48418522511725,1.0814599918204664,1.4539757464140286,-0.008482715507022731,17013082.0,1.0
4528,2020-12-24,IBM,102.34003442394292,102.42190786275512,101.6932466713024,102.0862274169922,1842111.0,0.0,0.0,0.6467819213867188,0.0,0.6467819213867188,53.12013337319397,99.65464158006291,104.54239754702066,49.74851145121236,-50.25148854878765,1.0224986349168148,1.367680324114586,0.0033797567783917515,18855193.0,1.0
4529,2020-12-28,IBM,102.42191314304746,103.64998865385697,101.897932254776,102.1926727294922,3781499.0,0.0,0.0,0.1064453125,0.0,0.1064453125,54.066928622123314,99.65464158006291,104.54239754702066,51.92630660341702,-48.073693396582975,0.9731427974861333,1.2887728187888956,0.010442914674040571,22636692.0,1.0
4530,2020-12-29,IBM,102.62659764287578,102.73303116303065,100.89909471292188,101.35758209228516,3647402.0,0.0,0.0,-0.8350906372070455,0.8350906372070455,0.0,45.710175517610864,99.65464158006291,104.54239754702066,34.8409479469613,-65.1590520530387,0.8567668307477305,1.2023716211806628,-0.016913932819785593,18989290.0,-1.0
4531,2020-12-30,IBM,101.35758278042516,102.21723763876848,101.21839596058152,101.79969024658205,3535794.0,0.0,0.0,0.4421081542968892,0.0,0.4421081542968892,50.393825441709,99.65464158006291,103.92016518292228,50.28805057088921,-49.71194942911079,0.7910932414151404,1.1201159452275584,-0.009637543712635588,22525084.0,1.0
4532,2020-12-31,IBM,101.70142563877371,103.1833079806896,101.51311870390684,103.0605010986328,3738822.0,0.0,0.0,1.2608108520507528,0.0,1.2608108520507528,61.362306741405945,99.65464158006291,103.64998865385697,85.24564839208375,-14.754351607916247,0.8312017708319388,1.0623331103484346,0.0026283063044538757,26263906.0,1.0
4533,2021-01-04,IBM,103.03596995868868,103.09327680402556,100.73536571221833,101.4722137451172,5417443.0,0.0,0.0,-1.5882873535155966,1.5882873535155966,0.0,46.43755400915982,99.65464158006291,103.64998865385697,45.49222211446799,-54.50777788553201,0.7264524620223938,0.9951569806832264,-0.01517653258647611,20846463.0,-1.0
4534,2021-01-05,IBM,102.34822162905871,103.71548388951238,102.02073440583484,103.27337646484376,6395872.0,0.0,0.0,1.8011627197265625,0.0,1.8011627197265625,59.368721423825235,99.65464158006291,103.71548388951238,89.11291325841813,-10.887086741581872,0.7797877508589721,0.9520831347183757,0.022286973262051646,27242335.0,1.0
4535,2021-01-06,IBM,103.89560512676348,107.97283187482692,103.74823162803932,105.85234832763672,8322708.0,0.0,0.0,2.5789718627929545,0.0,2.5789718627929545,70.95397608904452,99.65464158006291,107.97283187482692,74.50787404412989,-25.492125955870115,1.0184181371405145,0.9653501352028035,0.045951114491499245,35565043.0,1.0
4536,2021-01-07,IBM,106.4663900740403,106.81025723879726,105.0090675704357,105.6067352294922,4714740.0,0.0,0.0,-0.24561309814451704,0.24561309814451704,0.0,68.79833790253771,99.65464158006291,107.97283187482692,71.55515128303699,-28.444848716963005,1.174180293638571,1.007116166889957,0.041081550806261635,30850303.0,-1.0
4537,2021-01-08,IBM,105.26285692772818,105.87689786608864,103.96108830897612,105.23011016845705,4891305.0,0.0,0.0,-0.37662506103515625,0.37662506103515625,0.0,65.28885000839381,99.65464158006291,107.97283187482692,67.02742292279224,-32.97257707720775,1.2527910348164255,1.0562511404752508,0.03079634570707568,25958998.0,-1.0
4538,2021-01-11,IBM,104.75527052784196,106.17165962215633,104.5178434081034,105.27106475830078,5859587.0,0.0,0.0,0.04095458984373579,0.0,0.04095458984373579,65.50960232852233,99.65464158006291,107.97283187482692,67.51977268148333,-32.48022731851667,1.3033708587488206,1.1056750841299647,0.030123412438357366,31818585.0,1.0
4539,2021-01-12,IBM,105.68861077505098,106.31083852004704,104.7470824662021,105.78685760498048,3921663.0,0.0,0.0,0.5157928466797017,0.0,0.5157928466797017,68.42747435134629,100.21954190254718,107.97283187482692,71.80584916000909,-28.1941508399909,1.3692915648839943,1.1583983802807707,0.04369949856008315,35740248.0,1.0
4540,2021-01-13,IBM,105.73773054265924,106.22896469053892,103.53537336903436,103.9119873046875,8030874.0,0.0,0.0,-1.874870300292983,1.874870300292983,0.0,50.50657568239874,100.73536571221833,107.97283187482692,43.89134983291205,-56.108650167087944,1.2557720763353615,1.177873119491689,0.0207495430780682,27709374.0,-1.0
4541,2021-01-14,IBM,104.81258114470432,106.56463761021256,104.42778052142955,105.59036254882812,7848347.0,0.0,0.0,1.678375244140625,0.0,1.678375244140625,61.044666609108326,100.73536571221833,107.97283187482692,67.0814443553808,-32.91855564461921,1.286408997075327,1.1995802950084167,0.0245473428056997,35557721.0,1.0
4542,2021-01-15,IBM,105.0254336494941,105.81140163609062,104.52601288421322,105.11549377441406,5131153.0,0.0,0.0,-0.4748687744140625,0.4748687744140625,0.0,57.07723183220748,100.73536571221833,107.97283187482692,60.520187090132225,-39.47981290986777,1.257871081210908,1.211238452248915,0.03590421352635742,30426568.0,-1.0
4543,2021-01-19,IBM,105.84415364193693,106.09796064904786,104.86987866710416,105.63128662109376,5646308.0,0.0,0.0,0.5157928466797017,0.0,0.5157928466797017,60.31012538511253,100.73536571221833,107.97283187482692,67.6468918662385,-32.3531081337615,1.2623234701552803,1.2214554558301882,0.022831732988343623,36072876.0,1.0
4544,2021-01-20,IBM,106.18801642104434,107.3014716226854,105.25467493710704,106.49913024902344,5856240.0,0.0,0.0,0.8678436279296733,0.0,0.8678436279296733,65.37336054468805,100.73536571221833,107.97283187482692,79.6378788833975,-20.362121116602495,1.3206560475373692,1.2412955741716245,0.006110227421547432,41929116.0,1.0
4545,2021-01-21,IBM,106.53187342095814,108.2675627537576,106.4745665916056,107.78451538085938,13116003.0,0.0,0.0,1.2853851318359375,0.0,1.2853851318359375,71.57127354759788,100.73536571221833,108.2675627537576,93.58689941016848,-6.413100589831511,1.4538458432106722,1.283805627979434,0.020621602842230358,55045119.0,1.0
4546,2021-01-22,IBM,98.81953657352004,98.81953657352004,96.0850120327277,97.10841369628906,39814421.0,0.0,0.0,-10.676101684570312,10.676101684570312,0.0,26.357656134839843,96.0850120327277,108.2675627537576,8.400553274896124,-91.59944672510387,0.6899739436931469,1.1650392911221767,-0.07718034751808589,15230698.0,-1.0
4547,2021-01-25,IBM,97.23122928260084,97.86983040967908,96.15870737945704,97.0838623046875,14315974.0,0.0,0.0,-0.0245513916015625,0.0245513916015625,0.0,26.313547741918654,96.0850120327277,108.2675627537576,8.19902411927208,-91.80097588072792,0.08167734224886658,0.9483669013475147,-0.07777258140601939,914724.0,-1.0
4548,2021-01-26,IBM,97.57507744433,100.3669152457533,96.9528497795026,100.28504180908205,11186656.0,0.0,0.0,3.2011795043945455,0.0,3.2011795043945455,41.13398192963854,96.0850120327277,108.2675627537576,34.47578321265775,-65.52421678734225,-0.1404743632870975,0.7305986484205922,-0.05200850011485181,12101380.0,1.0
4549,2021-01-27,IBM,99.94937620857448,102.16810667128048,99.57276228880411,100.2686767578125,12705239.0,0.0,0.0,-0.01636505126954546,0.01636505126954546,0.0,41.08523869525247,96.0850120327277,108.2675627537576,34.341451317438995,-65.658548682561,-0.31422947156285375,0.521633024423903,-0.035061503887825696,-603859.0,-1.0
4550,2021-01-28,IBM,100.53884355193064,100.86633074781903,98.30373347614376,98.31192016601562,8455969.0,0.0,0.0,-1.956756591796875,1.956756591796875,0.0,35.3121858345732,96.0850120327277,108.2675627537576,18.2794899383736,-81.7205100616264,-0.602875971448583,0.29673122524940576,-0.0689309346716821,-9059828.0,-1.0
4551,2021-01-29,IBM,98.42653603570918,99.31075730608326,97.3458276833672,97.51776123046876,12369473.0,0.0,0.0,-0.7941589355468608,0.7941589355468608,0.0,33.13203585893429,96.0850120327277,108.2675627537576,11.760666797535297,-88.23933320246469,-0.8855048426112546,0.06028401167727362,-0.07227985400754167,-21429301.0,-1.0
4552,2021-02-01,IBM,98.16454916969712,99.0242038401903,97.20664769111862,98.68852996826172,6538023.0,0.0,0.0,1.1707687377929545,0.0,1.1707687377929545,39.487118466166336,96.0850120327277,108.2675627537576,21.370877044983207,-78.6291229550168,-1.0034518384547795,-0.15246315834913707,-0.06572632858043437,-14891278.0,1.0
4553,2021-02-02,IBM,97.72246270750456,99.0651650161558,97.65696264354392,97.78795623779295,6633627.0,0.0,0.0,-0.9005737304687642,0.9005737304687642,0.0,36.41538147882208,96.0850120327277,108.2675627537576,13.978552144466555,-86.02144785553344,-1.1562657443131172,-0.3532236755419332,-0.08179572913751909,-21524905.0,-1.0
4554,2021-02-03,IBM,97.46047039407698,98.08269814284418,96.70724904916727,97.52597045898438,7024308.0,0.0,0.0,-0.26198577880857954,0.26198577880857954,0.0,35.488711349784694,96.0850120327277,108.2675627537576,11.828051934717118,-88.17194806528288,-1.2837140717787463,-0.539321754789296,-0.09517642571965157,-28549213.0,-1.0
4555,2021-02-04,IBM,98.17275383161454,99.1470288676216,97.32128569477852,99.08153533935548,4771957.0,0.0,0.0,1.555564880371108,0.0,1.555564880371108,45.06594864538786,96.0850120327277,108.2675627537576,24.596846549180274,-75.40315345081973,-1.2448468840737235,-0.6804267806461816,0.02031875064129296,-23777256.0,1.0
4556,2021-02-05,IBM,99.065164399865,99.7283255919429,98.67217708589048,99.71195220947266,4775722.0,0.0,0.0,0.6304168701171733,0.0,0.6304168701171733,48.631978487381495,96.0850120327277,108.2675627537576,29.771599230726085,-70.22840076927392,-1.1499194296052053,-0.7743253104379864,0.027070306458731208,-19001534.0,1.0
4557,2021-02-08,IBM,100.39146892156629,101.5049306018207,100.21134867909768,101.2020034790039,6158848.0,0.0,0.0,1.49005126953125,0.0,1.49005126953125,56.35820204853817,96.0850120327277,108.2675627537576,42.00262788516934,-57.99737211483066,-0.9435770841803048,-0.8081756651864501,0.009143553748200306,-12842686.0,1.0
4558,2021-02-09,IBM,101.13564631958268,101.71640560712316,100.43043246523038,101.30157470703124,4933982.0,1.558317,0.0,0.09957122802732954,0.0,0.09957122802732954,56.85852449162206,96.0850120327277,108.2675627537576,42.819954488665,-57.180045511334995,-0.7632168342847621,-0.7991838990061126,0.010301302287189618,-7908704.0,1.0
4559,2021-02-10,IBM,102.07314762147,102.38842543188537,100.56316699558631,101.41771697998048,5090673.0,0.0,0.0,0.11614227294924717,0.0,0.11614227294924717,57.51406107782198,96.0850120327277,102.38842543188537,84.60027305150886,-15.399726948491132,-0.6039464077862107,-0.7601364007621323,0.03159125372305027,-2818031.0,1.0
4560,2021-02-11,IBM,101.21859651917391,101.3928275975361,100.08196632903476,100.31427001953124,5629154.0,0.0,0.0,-1.1034469604492472,1.1034469604492472,0.0,49.30162142229177,96.15870737945704,102.38842543188537,66.70546893296991,-33.29453106703009,-0.5603035644082297,-0.7201698334913519,0.02867691745356349,-8447185.0,-1.0
4561,2021-02-12,IBM,100.38894219433028,100.68761458669016,99.63394526298048,100.22300720214844,4049275.0,0.0,0.0,-0.09126281738279829,0.09126281738279829,0.0,48.6388379598132,96.70724904916727,102.38842543188537,61.88433373897626,-38.11566626102374,-0.527005452442836,-0.6815369572816488,0.015548688731914506,-12496460.0,-1.0
4562,2021-02-16,IBM,99.68373830373136,100.05708214172952,99.02830759941573,99.61736297607422,6945231.0,0.0,0.0,-0.6056442260742188,0.6056442260742188,0.0,44.09927989886061,96.70724904916727,102.38842543188537,51.223791180984854,-48.776208819015146,-0.5432249274565777,-0.6538745513166346,0.01870789418926666,-19441691.0,-1.0
4563,2021-02-17,IBM,98.9536350373635,100.0238966299351,98.74621958944,99.5344009399414,4141219.0,0.0,0.0,-0.0829620361328125,0.0829620361328125,0.0,43.458200455376726,96.70724904916727,102.38842543188537,49.76349439482664,-50.23650560517336,-0.5563599500510747,-0.6343716310635227,0.020593801543371537,-23582910.0,-1.0
4564,2021-02-18,IBM,99.9741232239433,100.33917098078392,99.31038979726326,100.1649398803711,5646413.0,0.0,0.0,0.6305389404296875,0.0,0.6305389404296875,49.85141728427038,96.70724904916727,102.38842543188537,60.862233422675885,-39.137766577324115,-0.5100112351828443,-0.609499551887387,0.010934474696066676,-17936497.0,1.0
4565,2021-02-19,IBM,100.18153292075476,100.18982900877566,98.21523426117498,98.72132873535156,6881320.0,0.0,0.0,-1.4436111450195312,1.4436111450195312,0.0,38.385613326200215,96.70724904916727,102.38842543188537,35.45180699390072,-64.54819300609927,-0.5830459090604876,-0.6042088233220072,-0.009934851862492988,-24817817.0,-1.0
4566,2021-02-22,IBM,98.3147930682164,100.49680323898716,98.26501654053143,100.27278900146484,6149643.0,0.0,0.0,1.5514602661132812,0.0,1.5514602661132812,52.05891017548921,96.70724904916727,102.38842543188537,62.760592386178985,-37.239407613821015,-0.5098591974620064,-0.5853388981500071,-0.009181779466765683,-18668174.0,1.0
4567,2021-02-23,IBM,100.32256940195568,100.67932103686526,99.39334798847094,100.1483383178711,4739740.0,0.0,0.0,-0.12445068359375,0.12445068359375,0.0,51.011152657980055,96.70724904916727,102.38842543188537,60.57001291442866,-39.429987085571334,-0.45663650988707616,-0.5595984204974209,-0.011384190151982887,-23407914.0,-1.0
4568,2021-02-24,IBM,100.22302050786084,102.45480738522112,99.99071678474908,102.22250366210938,6087720.0,0.0,0.0,2.0741653442382812,0.0,2.0741653442382812,64.68110078912711,97.32128569477852,102.45480738522112,95.47476884057515,-4.525231159424843,-0.2442735048690423,-0.4965334373717452,0.007935365793017679,-17320194.0,1.0
4569,2021-02-25,IBM,102.35525301554718,103.1683227096364,101.50070287624156,101.60855865478516,5953623.0,0.0,0.0,-0.6139450073242188,0.6139450073242188,0.0,59.05319226124119,98.21523426117498,103.1683227096364,68.50926303696929,-31.490736963030706,-0.12408415958596208,-0.4220435818145886,0.012902338171846495,-23273817.0,-1.0
4570,2021-02-26,IBM,101.4260203421431,101.4260203421431,98.63006649536312,98.67154693603516,9467346.0,0.0,0.0,-2.93701171875,2.93701171875,0.0,39.89328086384126,98.21523426117498,103.1683227096364,9.21268981178636,-90.78731018821364,-0.26279618674782057,-0.390194102801235,-0.015480080965680987,-32741163.0,-1.0
4571,2021-03-01,IBM,99.84965812260909,101.48409331994894,99.4431299661595,100.17322540283205,5977367.0,0.0,0.0,1.5016784667968892,0.0,1.5016784667968892,49.550016199739844,98.21523426117498,103.1683227096364,39.53071224208149,-60.4692877579185,-0.24868685812162994,-0.36189265386531405,0.005579975319075059,-26763796.0,1.0
4572,2021-03-02,IBM,100.17323596839668,101.13564844393112,99.77500385756709,99.83307647705078,4732418.0,0.0,0.0,-0.3401489257812642,0.3401489257812642,0.0,47.55324845448705,98.21523426117498,103.1683227096364,32.663301548316774,-67.33669845168322,-0.26193288979455076,-0.34190070105116144,0.003000726726527292,-31496214.0,-1.0
4573,2021-03-03,IBM,99.974123056295,101.74129583903128,99.5426999712157,101.5172882080078,7744898.0,0.0,0.0,1.684211730957017,0.0,1.684211730957017,57.36828731070332,98.21523426117498,103.1683227096364,66.6665653398242,-33.3334346601758,-0.13497277208536218,-0.3005151152580016,0.013501214389504357,-23751316.0,1.0
4574,2021-03-04,IBM,101.21859643289513,102.23078531045508,98.5304985776221,99.65054321289062,8439651.0,0.0,0.0,-1.8667449951171733,1.8667449951171733,0.0,46.28950188387375,98.21523426117498,103.1683227096364,28.97806018710392,-71.02193981289608,-0.1828785738087504,-0.2769878069681514,0.009412499704395838,-32190967.0,-1.0
4575,2021-03-05,IBM,100.09027070433643,102.67051301775416,99.7667034041424,101.9072265625,7268968.0,0.0,0.0,2.256683349609375,0.0,2.256683349609375,57.6873740339236,98.21523426117498,103.1683227096364,74.53919589245099,-25.460804107549006,-0.038307198850446866,-0.2292516853446105,0.016299911245226006,-24921999.0,1.0
4576,2021-03-08,IBM,102.03997645442416,105.24246528776465,101.94871285872038,103.54995727539062,7572203.0,0.0,0.0,1.642730712890625,0.0,1.642730712890625,64.08831776830283,98.21523426117498,105.24246528776465,75.91500825901551,-24.084991740984503,0.20644156716058149,-0.14211303484357207,0.03396580527100501,-17349796.0,1.0
4577,2021-03-09,IBM,104.03945644565728,104.894006514478,103.01067527933668,103.02726745605467,5867014.0,0.0,0.0,-0.5226898193359517,0.5226898193359517,0.0,60.716189325521874,98.21523426117498,105.24246528776465,68.47694599297934,-31.523054007020672,0.35414763394972226,-0.042860901084913174,0.007872667613438633,-23216810.0,-1.0
4578,2021-03-10,IBM,103.74907951434425,106.3956973790528,103.38403174241029,106.0887222290039,7581199.0,0.0,0.0,3.061454772949233,0.0,3.061454772949233,71.02100573240831,98.21523426117498,106.3956973790528,96.24746000775889,-3.752539992241108,0.7100545042454343,0.10772217998115635,0.044092383885102615,-15635611.0,1.0
4579,2021-03-11,IBM,106.27124512839912,106.72756310109132,105.18439132440402,105.48307037353516,5383657.0,0.0,0.0,-0.60565185546875,0.60565185546875,0.0,67.0086395538888,98.26501654053143,106.72756310109132,85.29411071891548,-14.70588928108453,0.9324930209440367,0.2726763481737325,0.06903229602669181,-21019268.0,-1.0
4580,2021-03-12,IBM,105.5245455359058,105.93108033624404,105.04334594275612,105.8730010986328,4194565.0,0.0,0.0,0.38993072509764204,0.0,0.38993072509764204,68.33747616400436,98.5304985776221,106.72756310109132,89.57478009338826,-10.425219906611737,1.1272470959043517,0.4435904977198564,0.05689919310154923,-16824703.0,1.0
4581,2021-03-15,IBM,106.00576483661584,106.81882791668616,105.81494154502452,106.67778778076172,3577948.0,0.0,0.0,0.8047866821289205,0.0,0.8047866821289205,71.10874697845176,98.5304985776221,106.81882791668616,98.29832852732216,-1.7016714726778501,1.331185584024226,0.6211095149807304,0.06856155840578926,-13246755.0,1.0
4582,2021-03-16,IBM,106.4288666287476,106.6279859622377,105.64898146908158,106.39567565917967,4867247.0,0.0,0.0,-0.28211212158204546,0.28211212158204546,0.0,68.67745831492888,98.5304985776221,106.81882791668616,94.89460130991525,-5.1053986900847566,1.4532915740315673,0.7875459267908979,0.04805474552448752,-18114002.0,-1.0
4583,2021-03-17,IBM,106.57822204455404,107.4327721427009,105.77344847826944,107.05113220214844,4488804.0,0.0,0.0,0.6554565429687642,0.0,0.6554565429687642,71.30744075647317,98.5304985776221,107.4327721427009,95.71300592188572,-4.286994078114273,1.584684064513084,0.9469735543353351,0.07426541542726373,-13625198.0,1.0
4584,2021-03-18,IBM,106.97645631728278,108.68555644222438,106.02234657426334,107.90567779541016,6104142.0,0.0,0.0,0.8545455932617188,0.0,0.8545455932617188,74.52514956016603,98.5304985776221,108.68555644222438,92.32029342213139,-7.679706577868611,1.737736700512201,1.1051261835707085,0.0588618828639329,-7521056.0,1.0
4585,2021-03-19,IBM,107.87249803479548,108.22096026342922,106.6363079192007,106.94328308105467,10297870.0,0.0,0.0,-0.962394714355483,0.962394714355483,0.0,65.04610348271967,98.5304985776221,108.68555644222438,82.8432945986178,-17.1567054013822,1.7610742392465681,1.2363157947058805,0.032769939215324895,-17818926.0,-1.0
4586,2021-03-22,IBM,106.61141349160393,108.45326447068992,106.105325566747,108.31221771240234,4356485.0,0.0,0.0,1.3689346313476705,0.0,1.3689346313476705,71.08275471256665,98.5304985776221,108.68555644222438,96.32361789760554,-3.6763821023944447,1.8684921762058195,1.3627510710058683,0.051296616777708026,-13462441.0,1.0
4587,2021-03-23,IBM,108.22094902213443,109.15016387935437,107.68996626616008,108.23754119873048,4556794.0,0.0,0.0,-0.07467651367186079,0.07467651367186079,0.0,70.3183586442872,98.5304985776221,109.15016387935437,91.40629525795867,-8.593704742041327,1.9254010695851917,1.4752810707217332,0.020254923658031387,-18019235.0,-1.0
4588,2021-03-24,IBM,108.64408345912376,109.60648935650948,108.32881221923978,108.37029266357422,4189230.0,0.0,0.0,0.1327514648437358,0.0,0.1327514648437358,70.95893359068714,99.7667034041424,109.60648935650948,87.43675219237991,-12.563247807620085,1.9586357773248295,1.5719520120423527,0.027371428228386563,-13830005.0,1.0
4589,2021-03-25,IBM,108.12967936542218,110.5439932072842,107.6650653418898,110.40294647216795,5809484.0,0.0,0.0,2.032653808593736,0.0,2.032653808593736,78.97538400940076,101.94871285872038,110.5439932072842,98.35902112093626,-1.6409788790637356,2.124502752138852,1.682462160061653,0.04278659645545502,-8020521.0,1.0
4590,2021-03-26,IBM,110.58546016386344,113.23207738432598,110.44442006692276,113.14911651611328,5823710.0,0.0,0.0,2.7461700439453267,0.0,2.7461700439453267,85.30065817259936,103.01067527933668,113.23207738432598,99.18836117236597,-0.811638827634024,2.4493123484231063,1.8358321977339436,0.06066238220697895,-2196811.0,1.0
4591,2021-03-29,IBM,112.8172654608782,113.72159866472153,112.42732945201092,112.71771240234376,4835344.0,0.0,0.0,-0.43140411376951704,0.43140411376951704,0.0,80.88954270972027,103.38403174241029,113.72159866472153,90.28895029244158,-9.711049707558422,2.641466406539706,1.9969590394950962,0.05942005353126989,-7032155.0,-1.0
4592,2021-03-30,IBM,112.71771666394356,113.05787615640426,111.1911304396816,111.77189636230467,5010758.0,0.0,0.0,-0.9458160400390909,0.9458160400390909,0.0,71.53190676772063,105.04334594275612,113.72159866472153,77.5334694104726,-22.4665305895274,2.6864625639038735,2.1348597443768518,0.044098217954779306,-12042913.0,-1.0
4593,2021-03-31,IBM,111.62255925526696,111.76361263036976,110.10428228357418,110.56060028076172,5172575.0,0.0,0.0,-1.2112960815429545,1.2112960815429545,0.0,61.08885780977109,105.04334594275612,113.72159866472153,63.575635727235195,-36.424364272764805,2.594473397910477,2.226782475083577,0.024604103691237666,-17215488.0,-1.0
4594,2021-04-01,IBM,110.97541606689212,111.116449559805,109.73921953019106,110.5356903076172,4261404.0,0.0,0.0,-0.02490997314451704,0.02490997314451704,0.0,60.87796658749762,105.64898146908158,113.72159866472153,60.53438085946842,-39.46561914053159,2.49084834523849,2.2795956491145595,0.03359170508950782,-21476892.0,-1.0
4595,2021-04-05,IBM,110.87586294476466,113.40632216146378,110.67674358339536,112.7757797241211,5722980.0,0.0,0.0,2.240089416503892,0.0,2.240089416503892,71.19586658299727,105.64898146908158,113.72159866472153,88.28361462362822,-11.716385376371774,2.559971481410443,2.3356708155737365,0.041210143287534695,-15753912.0,1.0
4596,2021-04-06,IBM,112.48538981406983,112.53517958280352,111.24919990173916,111.3570556640625,3787566.0,0.0,0.0,-1.4187240600585938,1.4187240600585938,0.0,59.69149640884288,105.77344847826944,113.72159866472153,70.25039858092418,-29.749601419075816,2.471779751609887,2.3628926027809665,0.02882100268338883,-19541478.0,-1.0
4597,2021-04-07,IBM,111.04179459574937,111.95442392535334,110.99201806443412,111.94612121582033,3112896.0,0.0,0.0,0.5890655517578267,0.0,0.5890655517578267,62.587743243087026,106.02234657426334,113.72159866472153,76.93961143184832,-23.06038856815168,2.421506220976326,2.3746153264200385,0.032996391025231775,-16428582.0,1.0
4598,2021-04-08,IBM,111.64744941714758,112.52688777653265,111.30728992162888,112.10376739501952,4275211.0,0.0,0.0,0.15764617919919033,0.0,0.15764617919919033,63.39980676925398,106.105325566747,113.72159866472153,78.75822926921757,-21.241770730782424,2.3670983782681816,2.3731119367896674,0.015405575459712217,-12153371.0,1.0
4599,2021-04-09,IBM,111.89633152302376,112.61813748905796,111.76359412179592,112.60984802246094,3162999.0,0.0,0.0,0.5060806274414205,0.0,0.5060806274414205,66.12350354958718,106.105325566747,113.72159866472153,85.402957221213,-14.597042778787012,2.3378667751643576,2.3660629044646053,-0.004765998270746974,-8990372.0,1.0
4600,2021-04-12,IBM,112.0207989319695,112.31118191057624,111.05009692792152,111.66404724121094,3926684.0,0.0,0.0,-0.94580078125,0.94580078125,0.0,56.979763267784946,107.6650653418898,113.72159866472153,66.02757198158066,-33.97242801841933,2.212873670237812,2.3354250576192466,-0.009347822437806297,-12917056.0,-1.0
4601,2021-04-13,IBM,110.34487965250706,110.85927023005092,108.1711654855934,108.83489227294922,8403041.0,0.0,0.0,-2.8291549682617188,2.8291549682617188,0.0,38.57073354654712,107.6650653418898,113.72159866472153,19.315124159384087,-80.68487584061592,1.8640390900467168,2.241147864104741,-0.026276767102843657,-21320097.0,-1.0
4602,2021-04-14,IBM,108.9427463666516,110.1623507751248,108.2873156776401,110.03790283203124,6137928.0,0.0,0.0,1.203010559082017,0.0,1.203010559082017,46.97586416398021,107.6650653418898,113.72159866472153,39.178146369580574,-60.82185363041942,1.6654596876010288,2.1260102288039984,-0.004727700893474962,-15182169.0,1.0
4603,2021-04-15,IBM,110.57718007194111,111.06668237009764,109.69774177384367,109.99641418457033,4062664.0,0.0,0.0,-0.04148864746090908,0.04148864746090908,0.0,46.72147801834726,108.1711654855934,113.72159866472153,32.88479727745568,-67.11520272254432,1.4875883014133393,1.9983258433258666,-0.004878751121434988,-19244833.0,-1.0
4604,2021-04-16,IBM,110.3448853863218,111.25751473209392,110.30339832184364,110.83438110351562,5535223.0,0.0,0.0,0.8379669189452983,0.0,0.8379669189452983,52.691834807795146,108.1711654855934,113.72159866472153,47.982121970893914,-52.01787802910609,1.3981241684309964,1.8782855083468928,-0.01721467699318624,-13709610.0,1.0
4605,2021-04-19,IBM,110.84266720426304,111.0251943811662,109.996413265323,110.4444351196289,8575736.0,0.0,0.0,-0.38994598388671875,0.38994598388671875,0.0,49.7013487891215,108.1711654855934,113.40632216146378,43.42314423011147,-56.57685576988853,1.2809913456597855,1.7588266758094715,-0.008195444275994057,-22285346.0,-1.0
4606,2021-04-20,IBM,113.72159002162633,115.96166608800525,113.41461491820186,114.62592315673828,16192708.0,0.0,0.0,4.181488037109375,0.0,4.181488037109375,70.45113347520598,108.1711654855934,115.96166608800525,82.85420925513523,-17.145790744864776,1.508188420857337,1.7086990248190446,0.023938318825281746,-6092638.0,1.0
4607,2021-04-21,IBM,114.54294182332195,119.24712112931635,114.2525589133516,119.0977783203125,12456814.0,0.0,0.0,4.471855163574219,0.0,4.471855163574219,80.41891917424348,108.1711654855934,119.24712112931635,98.65164854566304,-1.348351454336959,2.0257336817575577,1.7721059562067474,0.06238872330354628,6364176.0,1.0
4608,2021-04-22,IBM,119.22225794799812,120.08510419930003,116.9821814271036,117.21448516845705,7428064.0,0.0,0.0,-1.8832931518554545,1.8832931518554545,0.0,69.09307700782054,108.1711654855934,120.08510419930003,75.90537353074993,-24.094626469250066,2.2578983648589173,1.8692644379371812,0.040890181692436744,-1063888.0,-1.0
4609,2021-04-23,IBM,117.23932831118285,119.14754739285333,116.94065595380847,118.1685562133789,4765576.0,0.0,0.0,0.9540710449218608,0.0,0.9540710449218608,71.4439096668956,108.1711654855934,120.08510419930003,83.91339730733887,-16.08660269266113,2.4901709678539277,1.9934457439205306,0.05825070049733427,3701688.0,1.0
4610,2021-04-26,IBM,118.1602690321788,119.1641684661208,117.38039706913102,117.4550552368164,4927497.0,0.0,0.0,-0.7135009765625,0.7135009765625,0.0,67.0435829407167,108.1711654855934,120.08510419930003,77.92460557600623,-22.075394423993767,2.5868554539179343,2.1121276859200115,0.07920403818886057,-1225809.0,-1.0
4611,2021-04-27,IBM,117.5546260793663,118.27643207791952,116.77474084417962,117.8201141357422,4062664.0,0.0,0.0,0.36505889892579546,0.0,0.36505889892579546,68.19986798636118,108.1711654855934,120.08510419930003,80.988738334267,-19.011261665733002,2.6622470807608067,2.2221515648881707,0.0707230063770865,2836855.0,1.0
4612,2021-04-28,IBM,118.57510517563202,118.9733438834917,117.89478623385511,118.64148712158205,3941433.0,0.0,0.0,0.8213729858398438,0.0,0.8213729858398438,70.85459795055044,108.1711654855934,120.08510419930003,87.88295699341519,-12.117043006584801,2.75649822794675,2.3290208974998867,0.07859413419155259,6778288.0,1.0
4613,2021-04-29,IBM,119.57900160101164,123.40374347057868,118.62489181104142,119.6702651977539,4554179.0,0.0,0.0,1.0287780761718608,0.0,1.0287780761718608,73.99237005755454,108.1711654855934,123.40374347057868,75.49017456858023,-24.50982543141977,2.8809964008731157,2.4394159981745327,0.07972150885189544,11332467.0,1.0
4614,2021-04-30,IBM,119.22225352783884,119.33010930525282,116.60881998205303,117.71227264404295,9280321.0,0.0,0.0,-1.9579925537109517,1.9579925537109517,0.0,59.84392640347473,108.1711654855934,123.40374347057868,62.63619439765353,-37.36380560234647,2.7895126984439287,2.5094353382284122,0.06580537549530519,2052146.0,-1.0
4615,2021-05-03,IBM,119.31351374024317,120.92306088778528,119.09780219153886,120.09339904785156,5997241.0,0.0,0.0,2.381126403808608,0.0,2.381126403808608,68.33897740459615,108.2873156776401,123.40374347057868,78.10101388984577,-21.898986110154226,2.875995519939181,2.582747374570566,0.047698424060996336,8049387.0,1.0
4616,2021-05-04,IBM,119.81131548837756,121.61996871538956,119.74493353847816,120.92305755615234,6642623.0,0.0,0.0,0.8296585083007812,0.0,0.8296585083007812,70.82070637520175,109.69774177384367,123.40374347057868,81.90073247242285,-18.09926752757715,2.9771614232550263,2.6616301843074583,0.015325888203647109,14692010.0,1.0
4617,2021-05-05,IBM,121.08067252597873,121.08067252597873,120.27590571056206,120.48331451416016,5229895.0,0.0,0.0,-0.4397430419921875,0.4397430419921875,0.0,67.58102927192712,109.996413265323,123.40374347057868,78.21766965004181,-21.78233034995819,2.9874154760842515,2.7267872426628172,0.02788758864576546,9462115.0,-1.0
4618,2021-05-06,IBM,120.51651614851116,123.21292367573275,120.45014744055425,123.13825225830078,7848661.0,0.0,0.0,2.654937744140625,0.0,2.654937744140625,75.41545160292827,109.996413265323,123.40374347057868,98.01980552269966,-1.9801944773003448,3.1731945628638414,2.8160687067030223,0.042055993609230624,17310776.0,1.0
4619,2021-05-07,IBM,122.41675636361948,122.60132294304296,121.28419723801171,122.03084564208984,7325661.0,1.567878,0.0,-1.1074066162109375,1.1074066162109375,0.0,67.55794318548772,113.41461491820186,123.40374347057868,86.25608008456189,-13.743919915438111,3.1942460881032275,2.8917041829830636,0.03895779876010952,9985115.0,-1.0
4620,2021-05-10,IBM,122.3160903345048,124.4805434350111,122.3160903345048,122.62649536132812,7304636.0,0.0,0.0,0.5956497192382812,0.0,0.5956497192382812,69.52833433365875,114.2525589133516,124.4805434350111,81.87279155774323,-18.127208442256766,3.2218540004311222,2.9577341464726756,0.04079423331782239,17289751.0,1.0
4621,2021-05-11,IBM,121.63656843799887,121.80435747626412,119.88319909846372,120.99058532714844,7454214.0,0.0,0.0,-1.6359100341796875,1.6359100341796875,0.0,58.30620598572657,116.60881998205303,124.4805434350111,55.66462505042408,-44.335374949575915,3.0762679005206337,2.9814408972822677,0.019799972695546897,9835537.0,-1.0
4622,2021-05-12,IBM,120.67180112766944,120.93186008386648,118.40668253102496,118.5409164428711,6233742.0,0.0,0.0,-2.4496688842773438,2.4496688842773438,0.0,45.591801225333256,116.60881998205303,124.4805434350111,24.544770562182396,-75.45522943781761,2.7317323511268086,2.931499188051176,-0.009437170988269905,3601795.0,-1.0
4623,2021-05-13,IBM,118.66675046830392,121.56106112875244,118.52413447409404,120.94864654541016,4807207.0,0.0,0.0,2.4077301025390625,0.0,2.4077301025390625,56.37932877816223,116.60881998205303,124.4805434350111,55.13184741933846,-44.868152580661544,2.622735876435314,2.869746525728004,0.02749393779146425,8409002.0,1.0
4624,2021-05-14,IBM,121.73724074003243,122.22383031762486,120.77247045261667,121.37650299072266,2873780.0,0.0,0.0,0.4278564453125,0.0,0.4278564453125,58.08337759761095,116.60881998205303,124.4805434350111,60.56720662459253,-39.43279337540746,2.5415820485801675,2.804113630298437,0.01068421705975564,11282782.0,1.0
4625,2021-05-17,IBM,121.17515411605036,122.31609549498562,121.08287081283564,121.73723602294922,4471755.0,0.0,0.0,0.3607330322265625,0.0,0.3607330322265625,59.6180398974697,116.60881998205303,124.4805434350111,65.14985023983546,-34.85014976016455,2.4778125159529765,2.738853407429345,0.006733029111662958,15754537.0,1.0
4626,2021-05-18,IBM,121.46037967535034,121.89663651555207,120.16004480157385,120.73052215576172,4000009.0,0.0,0.0,-1.0067138671875,1.0067138671875,0.0,53.330636098664954,116.60881998205303,124.4805434350111,52.36086097714492,-47.63913902285508,2.3193057928260856,2.6549438845086937,0.0020517998081179822,11754528.0,-1.0
4627,2021-05-19,IBM,119.39661683422348,120.13486981896448,118.22210701633028,120.1264877319336,4498532.0,0.0,0.0,-0.604034423828125,0.604034423828125,0.0,49.701784662386196,116.60881998205303,124.4805434350111,44.687389882309404,-55.312610117690596,2.120503696249486,2.5480558468568524,-0.02445839916624415,7255996.0,-1.0
4628,2021-05-20,IBM,120.0677499744537,121.56944225484946,119.26237340820602,120.70533752441406,4301675.0,0.0,0.0,0.5788497924804688,0.0,0.5788497924804688,53.22137393965323,118.22210701633028,124.4805434350111,39.6781295192451,-60.3218704807549,1.9867578354115807,2.4357962445677983,-0.010862074344411443,11557671.0,1.0
4629,2021-05-21,IBM,121.04093670843896,122.23221081342956,121.04093670843896,121.42683410644533,4219041.0,0.0,0.0,0.7214965820312642,0.0,0.7214965820312642,57.49857087082976,118.22210701633028,124.4805434350111,51.20651350789869,-48.793486492101316,1.9168853602685658,2.3320140677079517,-0.009783050973999563,15776712.0,1.0
4630,2021-05-24,IBM,121.69527952165956,121.97211599752085,120.957013212925,121.4100341796875,3449290.0,0.0,0.0,-0.01679992675782671,0.01679992675782671,0.0,57.357666561144455,118.22210701633028,124.4805434350111,50.93807702258615,-49.06192297741385,1.8389569555545506,2.2334026452772715,0.003466789183678376,12327422.0,-1.0
4631,2021-05-25,IBM,121.5778373102744,121.64494756798244,120.13487304014112,120.62984466552734,4118311.0,0.0,0.0,-0.7801895141601562,0.7801895141601562,0.0,50.70008438425775,118.22210701633028,124.4805434350111,38.47187201599109,-61.528127984008904,1.6947078230330135,2.12566368082842,0.017622001628973205,8209111.0,-1.0
4632,2021-05-26,IBM,120.38657508761668,120.79764554124846,120.00066428813388,120.28589630126952,3225655.0,0.0,0.0,-0.3439483642578267,0.3439483642578267,0.0,47.87350410994996,118.22210701633028,124.4805434350111,32.976116506976496,-67.0238834930235,1.5349417348997605,2.007519291642688,-0.0054796003351043066,4983456.0,-1.0
4633,2021-05-27,IBM,120.6550064086914,121.45198750904832,120.49561286660293,120.6550064086914,5889294.0,0.0,0.0,0.3691101074218892,0.0,0.3691101074218892,51.23962910143766,118.22210701633028,124.4805434350111,38.87391721515549,-61.12608278484451,1.4217213412575092,1.8903597015656521,-0.005944285460970922,10872750.0,1.0
4634,2021-05-28,IBM,120.9821968525938,121.08286223628878,120.37816438067776,120.587890625,2651192.0,0.0,0.0,-0.06711578369140625,0.06711578369140625,0.0,50.554693370947255,118.22210701633028,122.31609549498562,57.78676762292099,-42.21323237707901,1.3114599863856853,1.7745797585296588,-0.00944119839990909,8221558.0,-1.0
4635,2021-06-01,IBM,121.64495609509584,122.34127193233256,120.5962979902775,120.9654312133789,2528705.0,0.0,0.0,0.37754058837890625,0.0,0.37754058837890625,54.502185476564556,118.22210701633028,122.34127193233256,66.5990377416369,-33.400962258363094,1.2402446699734782,1.6677127408184225,0.001945730486563324,10750263.0,1.0
4636,2021-06-02,IBM,121.32615807607058,122.27415070223785,120.8982967167781,122.2489776611328,2915097.0,0.0,0.0,1.283546447753892,0.0,1.283546447753892,65.35291132501,118.22210701633028,122.34127193233256,97.75939363725851,-2.240606362741488,1.272706521380485,1.588711496930835,0.017668792031409586,13665360.0,1.0
4637,2021-06-03,IBM,121.5694601552756,122.38321892770622,120.83958920838349,122.10636901855467,4320608.0,0.0,0.0,-0.142608642578125,0.142608642578125,0.0,63.41409695087718,118.22210701633028,122.38321892770622,93.34673243479276,-6.6532675652072495,1.272259629811316,1.5254211235069313,0.011607038453102625,9344752.0,-1.0
4638,2021-06-04,IBM,122.4838985565996,123.78424703806265,122.28255436198546,123.67518615722656,3261323.0,0.0,0.0,1.5688171386718892,0.0,1.5688171386718892,73.42241659359063,118.22210701633028,123.78424703806265,98.03922805952456,-1.96077194047544,1.3825586217829482,1.4968486231621347,0.018516105334758892,12606075.0,1.0
4639,2021-06-07,IBM,123.78421974942496,124.78254502392372,123.46541926576738,124.1785125732422,3621984.0,0.0,0.0,0.5033264160156392,0.0,0.5033264160156392,75.86638237598994,118.22210701633028,124.78254502392372,90.79280301128716,-9.207196988712841,1.4933709521348106,1.49615308895667,0.022802714884812003,16228059.0,1.0
4640,2021-06-08,IBM,124.26241371258624,126.00738742033256,124.26241371258624,125.05939483642578,5313785.0,0.0,0.0,0.8808822631835795,0.0,0.8808822631835795,79.64598226922301,118.22210701633028,126.00738742033256,87.82326987966374,-12.176730120336257,1.633441067255518,1.52361068461644,0.03672018465397464,21541844.0,1.0
4641,2021-06-09,IBM,125.0258319148488,126.73725038919426,124.84964742578316,126.40167236328124,5547252.0,0.0,0.0,1.3422775268554545,0.0,1.3422775268554545,84.04053031605902,119.26237340820602,126.73725038919426,95.5105879766779,-4.489412023322108,1.8316441673726729,1.5852173811676866,0.05084366704716636,27089096.0,1.0
4642,2021-06-10,IBM,127.07282902504922,128.22216581404194,125.6382602555457,126.2926254272461,4977391.0,0.0,0.0,-0.10904693603514204,0.10904693603514204,0.0,82.37339786762831,120.00066428813388,128.22216581404194,76.53055976800135,-23.469440231998636,1.9573591578391785,1.659645736501985,0.04672511474126928,22111705.0,-1.0
4643,2021-06-11,IBM,126.20034354048296,127.39163094813476,126.1500108474622,126.91343688964844,3596462.0,0.0,0.0,0.6208114624023438,0.0,0.6208114624023438,84.40550583570774,120.00066428813388,128.22216581404194,84.08163131431206,-15.918368685687941,2.083071142722943,1.744330817746177,0.05245589944283369,25708167.0,1.0
4644,2021-06-14,IBM,126.4352329045455,126.70368730282844,124.71543227032636,125.8647689819336,3498661.0,0.0,0.0,-1.0486679077148438,1.0486679077148438,0.0,68.91929520466229,120.00066428813388,128.22216581404194,71.32644414551788,-28.673555854482125,2.0741703161021974,1.810298717417381,0.0405019658873651,22209506.0,-1.0
4645,2021-06-15,IBM,125.71377241617807,125.76410511120928,124.66510095848908,125.3026885986328,2628912.0,0.0,0.0,-0.5620803833007955,0.5620803833007955,0.0,61.89593604454531,120.00066428813388,128.22216581404194,64.48973212242166,-35.510267877578336,1.998721144257388,1.8479832027853824,0.024979439467908815,19580594.0,-1.0
4646,2021-06-16,IBM,125.63824682532002,125.63824682532002,123.50736250655972,124.01911163330078,4057329.0,0.0,0.0,-1.283576965332017,1.283576965332017,0.0,48.79384802974391,120.37816438067776,128.22216581404194,46.41696312211751,-53.58303687788249,1.8144374922242008,1.8412740606731461,0.01566456058041865,15523265.0,-1.0
4647,2021-06-17,IBM,123.78422066428264,124.21206861798068,121.87984000472927,122.14830780029295,4568300.0,0.0,0.0,-1.8708038330078267,1.8708038330078267,0.0,35.98404174193085,120.37816438067776,128.22216581404194,22.56684212328101,-77.43315787671898,1.500140450622382,1.7730473386629935,-0.01234587474153881,10954965.0,-1.0
4648,2021-06-18,IBM,121.20870562709388,121.37649466337564,120.00065402368024,120.06776428222656,9577699.0,0.0,0.0,-2.080543518066392,2.080543518066392,0.0,26.916453511872888,120.00065402368024,128.22216581404194,0.8162763766269463,-99.18372362337306,1.0708314285458727,1.6326041566395693,-0.03310353945970368,1377266.0,-1.0
4649,2021-06-21,IBM,120.89829787405984,123.3815380633478,120.85636065837066,123.02918243408205,4482633.0,0.0,0.0,2.961418151855483,0.0,2.961418151855483,48.30917887852619,120.00065402368024,128.22216581404194,36.836636468152115,-63.163363531847885,0.9585134840066445,1.4977860221129844,-0.01623398549944366,5859899.0,1.0
4650,2021-06-22,IBM,122.92013208560968,123.16342687304612,121.93858423789209,122.7859115600586,2549102.0,0.0,0.0,-0.2432708740234517,0.2432708740234517,0.0,47.00502429650599,120.00065402368024,128.22216581404194,33.877680983728375,-66.12231901627162,0.8401856402545889,1.3662659457413053,-0.028605324088045836,3310797.0,-1.0
4651,2021-06-23,IBM,122.84462409116828,122.90335226497774,121.28421678084896,121.3177719116211,3349920.0,0.0,0.0,-1.4681396484375,1.4681396484375,0.0,39.56699848998218,120.00065402368024,128.22216581404194,16.020385563211686,-83.97961443678831,0.6207873218811244,1.2171702209692692,-0.0393914806885608,-39123.0,-1.0
4652,2021-06-24,IBM,122.31608577129376,122.64328174025594,121.3848841154796,122.01407623291016,3775746.0,0.0,0.0,0.6963043212890625,0.0,0.6963043212890625,44.383142613172005,120.00065402368024,128.22216581404194,24.48968341309568,-75.51031658690432,0.49736519696907067,1.0732092161692295,-0.03860395539519024,3736623.0,1.0
4653,2021-06-25,IBM,121.9637635639592,123.26409861675988,121.60302579808332,123.18860626220705,3759533.0,0.0,0.0,1.1745300292968892,0.0,1.1745300292968892,51.851439270376765,120.00065402368024,128.22216581404194,38.77574246459302,-61.22425753540698,0.4886936746944741,0.9563061078742784,-0.02126220658388278,7496156.0,1.0
4654,2021-06-28,IBM,123.331201206457,123.57448257495317,121.56944989944256,121.88823699951172,4067789.0,0.0,0.0,-1.3003692626953267,1.3003692626953267,0.0,44.259210958885284,120.00065402368024,128.22216581404194,22.95907399955738,-77.04092600044262,0.3725974277435995,0.8395643718481426,-0.027249627580284264,3428367.0,-1.0
4655,2021-06-29,IBM,121.86307423961856,123.10469439708636,121.72885371875692,122.10636901855467,2540211.0,0.0,0.0,0.21813201904295454,0.0,0.21813201904295454,45.795401911364564,120.00065402368024,128.22216581404194,25.612260233489152,-74.38773976651085,0.29479354999641316,0.7306102074777967,-0.015422966586002507,5968578.0,1.0
4656,2021-06-30,IBM,121.75400877226708,123.26408330433212,121.40166652839856,122.97885131835938,3394375.0,0.0,0.0,0.8724822998047017,0.0,0.8724822998047017,51.911799759949474,120.00065402368024,127.39163094813476,40.29504252442157,-59.70495747557843,0.3000763528854833,0.6445034365593341,0.006799468064873526,9362953.0,1.0
4657,2021-07-01,IBM,123.2892716615558,123.74229273846008,122.96208902879616,123.18860626220705,2809661.0,0.0,0.0,0.20975494384767046,0.0,0.20975494384767046,53.37133982911433,120.00065402368024,126.70368730282844,47.55984500992839,-52.44015499007162,0.31752821559400957,0.5791083923662692,0.025992338565118622,12172614.0,1.0
4658,2021-07-02,IBM,123.24732092772942,123.28088945072976,116.99729577839116,117.46709442138672,17584515.0,0.0,0.0,-5.721511840820327,5.721511840820327,0.0,27.296213925404217,116.99729577839116,125.76410511120928,5.358832674013891,-94.6411673259861,-0.12883412674359818,0.4375198885442957,-0.04520950153981107,-5411901.0,-1.0
4659,2021-07-06,IBM,117.44191418650072,117.80265192993278,115.01740198564548,116.42681121826172,8466010.0,0.0,0.0,-1.040283203125,1.040283203125,0.0,24.758560064526492,115.01740198564548,125.63824682532002,13.270217707647348,-86.72978229235265,-0.5600655721093233,0.23800279641357183,-0.05179014645085267,-13877911.0,-1.0
4660,2021-07-07,IBM,116.41002144996622,117.72714723922674,116.41002144996622,117.29928588867188,4246446.0,0.0,0.0,0.8724746704101562,0.0,0.8724746704101562,30.96901203313523,115.01740198564548,124.21206861798068,24.817472935904146,-75.18252706409585,-0.8219433339772877,0.02601357033539987,-0.03312363852079847,-9631465.0,1.0
4661,2021-07-08,IBM,115.5878658721759,118.54928660317026,115.48720049085664,118.07110595703124,5739820.0,0.0,0.0,0.7718200683593608,0.0,0.7718200683593608,36.33304381543119,115.01740198564548,123.74229273846008,34.99991069115278,-65.00008930884722,-0.9561816509679204,-0.17042547392526425,-0.03231569993901573,-3891645.0,1.0
4662,2021-07-09,IBM,118.66675095461537,119.11138989360106,118.15500175688317,118.72547912597656,4083689.0,0.0,0.0,0.6543731689453267,0.0,0.6543731689453267,40.830842015684006,115.01740198564548,123.74229273846008,42.49998361452124,-57.50001638547876,-0.9982567559197122,-0.3359917303241539,-0.03623003191326568,192044.0,1.0
4663,2021-07-12,IBM,118.6499912605192,119.09461687655669,117.55098696347926,118.22212982177734,3496360.0,0.0,0.0,-0.5033493041992188,0.5033493041992188,0.0,38.42174202389481,115.01740198564548,123.74229273846008,36.73086491195364,-63.26913508804637,-1.0599986572178608,-0.48079311570289535,-0.030077612639102025,-3304316.0,-1.0
4664,2021-07-13,IBM,118.22210473961154,118.22210473961154,117.139891629307,117.68519592285156,3309858.0,0.0,0.0,-0.5369338989257812,0.5369338989257812,0.0,35.820407135280206,115.01740198564548,123.74229273846008,30.57681766783692,-69.42318233216308,-1.139124518750748,-0.6124593963124659,-0.03620755519338459,-6614174.0,-1.0
4665,2021-07-14,IBM,118.05432981733304,118.07948946800876,116.55263743684613,117.29928588867188,4606061.0,0.0,0.0,-0.3859100341796875,0.3859100341796875,0.0,33.916094684107364,115.01740198564548,123.74229273846008,26.1537246445209,-73.84627535547911,-1.218921085142668,-0.7337517340785065,-0.046183269471143595,-11220235.0,-1.0
4666,2021-07-15,IBM,116.87983472747476,117.83622293150546,116.44359123508654,117.82782745361328,3807126.0,0.0,0.0,0.5285415649414062,0.0,0.5285415649414062,39.037742510374464,115.01740198564548,123.74229273846008,32.21158347525642,-67.78841652474358,-1.225386064056778,-0.8320786000741609,-0.04351683951341523,-7413109.0,1.0
4667,2021-07-16,IBM,118.28921505592874,118.28921505592874,116.26739165923011,116.52745056152344,4298328.0,0.0,0.0,-1.3003768920898438,1.3003768920898438,0.0,31.99775983609645,115.01740198564548,123.74229273846008,17.30736370986452,-82.69263629013548,-1.32022047409572,-0.9297069748784729,-0.007999209178465971,-11711437.0,-1.0
4668,2021-07-19,IBM,114.47209940554538,116.1835182338562,114.27075522633724,115.70533752441406,8977086.0,0.0,0.0,-0.822113037109375,0.822113037109375,0.0,28.27776622790148,114.27075522633724,123.74229273846008,15.146245224079665,-84.85375477592034,-1.4450573570113505,-1.0327770513050485,-0.006196800258448487,-20688523.0,-1.0
4669,2021-07-20,IBM,119.96708562796624,121.5778253843677,116.35968200145116,117.42511749267578,14237838.0,0.0,0.0,1.7197799682617188,0.0,1.7197799682617188,43.99394214575139,114.27075522633724,123.74229273846008,33.30359260364221,-66.6964073963578,-1.3892057167333576,-1.1040627843907103,0.0010727397277023876,-6450685.0,1.0
4670,2021-07-21,IBM,117.42513470979009,118.61642218141476,117.15668027601424,118.5409164428711,5024984.0,0.0,0.0,1.1157989501953125,0.0,1.1157989501953125,51.886550272823825,114.27075522633724,123.74229273846008,45.0841398354636,-54.91586016453639,-1.240606302064279,-1.131371487925424,0.003979047049926354,-1425701.0,1.0
4671,2021-07-22,IBM,118.84292542361918,118.96876385726864,117.79426734656826,118.0459442138672,3466653.0,0.0,0.0,-0.49497222900389204,0.49497222900389204,0.0,48.39567090235166,114.27075522633724,123.28088945072976,41.89936457671906,-58.10063542328094,-1.1495292598131641,-1.135003042302972,-0.005723581131126254,-4892354.0,-1.0
4672,2021-07-23,IBM,118.255675784469,118.87647243276834,117.7271490432816,118.574462890625,4680013.0,0.0,0.0,0.5285186767577983,0.0,0.5285186767577983,52.3457777508893,114.27075522633724,121.5778253843677,58.8978560655804,-41.102143934419594,-1.0229115201905756,-1.1125847378804927,0.002980263250025983,-212341.0,1.0
4673,2021-07-26,IBM,118.61644313672676,119.9671244117186,118.3983213601402,119.77416229248048,4441630.0,0.0,0.0,1.199699401855483,0.0,1.199699401855483,60.30420455211251,114.27075522633724,121.5778253843677,75.31619304482804,-24.683806955171956,-0.8163499597092851,-1.0533377822462513,0.01775046005785086,4229289.0,1.0
4674,2021-07-27,IBM,119.57278052473222,120.50399552224938,118.79257698354613,119.7573471069336,3281302.0,0.0,0.0,-0.01681518554688921,0.01681518554688921,0.0,60.14176971700121,114.27075522633724,121.5778253843677,75.0860709140256,-24.913929085974402,-0.6465522281540785,-0.9719806714278167,0.020955466179006788,947987.0,-1.0
4675,2021-07-28,IBM,119.9754794964148,120.0509852313026,118.82614268850055,118.9352035522461,2660815.0,0.0,0.0,-0.8221435546875,0.8221435546875,0.0,52.20827047854209,114.27075522633724,121.5778253843677,63.834727531425585,-36.165272468574415,-0.5717358020599335,-0.8919316975542401,0.009398256104389047,-1712828.0,-1.0
4676,2021-07-29,IBM,119.40500744242904,119.93353422021548,118.79259283877028,119.06944274902344,2793761.0,0.0,0.0,0.13423919677734375,0.0,0.13423919677734375,53.36720688249791,114.27075522633724,121.5778253843677,65.67184136602884,-34.32815863397116,-0.49589489637929773,-0.8127243373192516,0.021814535332667306,1080933.0,1.0
4677,2021-07-30,IBM,118.72548250334776,119.00233241342669,118.11305451015812,118.25568389892578,3698238.0,0.0,0.0,-0.8137588500976562,0.8137588500976562,0.0,45.627906742734716,114.27075522633724,121.5778253843677,54.53524581543957,-45.46475418456043,-0.49573939539651235,-0.7493273489347039,0.022041734885165365,-2617305.0,-1.0
4678,2021-08-02,IBM,118.66675171646597,120.01743271686516,118.31439607595256,118.6415786743164,3064257.0,0.0,0.0,0.385894775390625,0.0,0.385894775390625,49.625162655264745,114.27075522633724,121.5778253843677,59.816360777316966,-40.18363922268303,-0.4591844835367169,-0.6912987758551066,0.010359463184837825,446952.0,1.0
4679,2021-08-03,IBM,119.04425899247803,121.39326519457522,118.83453275171416,120.86473846435548,4272596.0,0.0,0.0,2.2231597900390767,0.0,2.2231597900390767,66.16168843262449,114.27075522633724,121.5778253843677,90.24113762985381,-9.758862370146195,-0.24796564360315188,-0.6026321494047157,0.019603543579860272,4719548.0,1.0
4680,2021-08-04,IBM,120.63824162026076,120.9570287381942,119.52245992766188,119.76575469970705,2960285.0,0.0,0.0,-1.0989837646484375,1.0989837646484375,0.0,55.727297531947606,114.27075522633724,121.5778253843677,75.20113197942692,-24.798868020573085,-0.16732319874279256,-0.5155703592723311,0.014568992584141682,1759263.0,-1.0
4681,2021-08-05,IBM,119.99228406906704,120.31108464480369,119.31274569204014,119.77416229248048,2884240.0,0.0,0.0,0.0084075927734375,0.0,0.0084075927734375,55.78884648462972,114.27075522633724,121.5778253843677,75.31619304482804,-24.683806955171956,-0.1015642878333125,-0.43276914498452734,0.01011768784449063,4643503.0,1.0
4682,2021-08-06,IBM,119.96710656584526,121.1332076372772,119.87482325948493,120.88153076171876,4002833.0,0.0,0.0,1.1073684692382812,0.0,1.1073684692382812,63.500389076501875,116.35968200145116,121.5778253843677,86.65627654217964,-13.343723457820364,0.03945074005874005,-0.33832516797587386,0.009245470375607079,8646336.0,1.0
4683,2021-08-09,IBM,120.66939227178388,120.9239802211605,119.62563179241164,119.8632354736328,5129689.0,1.567878,0.0,-1.018295288085966,1.018295288085966,0.0,53.583605493754845,117.15668027601424,121.39326519457522,63.88530501916338,-36.11469498083662,0.06825148548230686,-0.2570098372842377,0.0008841909849977014,3516647.0,-1.0
4684,2021-08-10,IBM,119.82929096610964,120.33843976371683,119.09101708313534,119.97354888916016,5543695.0,0.0,0.0,0.11031341552735796,0.0,0.11031341552735796,54.47234048188455,117.7271490432816,121.39326519457522,61.27465015220248,-38.725349847797524,0.0988383079447459,-0.18584020823844097,0.008730344808784318,9060342.0,1.0
4685,2021-08-11,IBM,120.31297740380748,121.1530755375756,120.07537375441778,120.6099853515625,4455960.0,0.0,0.0,0.6364364624023438,0.0,0.6364364624023438,59.61928522559584,117.7271490432816,121.39326519457522,78.6346146524481,-21.365385347551904,0.17244584040246025,-0.11418299851026072,0.012938186044812783,13516302.0,1.0
4686,2021-08-12,IBM,120.7202981068936,121.47554260841888,120.56754807123843,121.40764617919922,2184780.0,0.0,0.0,0.7976608276367188,0.0,0.7976608276367188,65.29339161977578,118.11305451015812,121.47554260841888,97.98076819201896,-2.0192318079810487,0.29178142797537987,-0.032990113213132576,0.02665379097521825,15701082.0,1.0
4687,2021-08-13,IBM,121.0427552587608,121.84043333490249,120.8730345019541,121.50099182128906,1997965.0,0.0,0.0,0.09334564208984375,0.0,0.09334564208984375,65.93963551466496,118.11305451015812,121.84043333490249,90.89329178563698,-9.106708214363021,0.38939920247442217,0.051487749924378406,0.024101273591630612,17699047.0,1.0
4688,2021-08-16,IBM,121.54342856513856,121.97620228500324,120.69483830305354,121.84891510009766,2913319.0,0.0,0.0,0.34792327880859375,0.0,0.34792327880859375,68.4649482706895,118.11305451015812,121.97620228500324,96.7050914869368,-3.2949085130631968,0.4891973306339281,0.1390296660662884,0.008142793739899679,20612366.0,1.0
4689,2021-08-17,IBM,121.3482783735696,121.4840441695396,119.7274726036245,120.85608673095705,3215195.0,0.0,0.0,-0.9928283691406108,0.9928283691406108,0.0,55.030795822844645,118.11305451015812,121.97620228500324,71.0051072511431,-28.99489274885691,0.48261186506522336,0.2077461058660754,0.009103871419537501,17397171.0,-1.0
4690,2021-08-18,IBM,120.21963108396191,120.43177187758342,118.28484691045588,118.35272979736328,3672192.0,0.0,0.0,-2.503356933593764,2.503356933593764,0.0,35.03201234983892,118.11305451015812,121.97620228500324,6.204144940191123,-93.79585505980887,0.2722544729504648,0.22064777928295332,-0.011867605399285996,13724979.0,-1.0
4691,2021-08-19,IBM,117.69083700248702,118.33576509311754,116.43492226640562,117.12228393554688,4351465.0,0.0,0.0,-1.2304458618164062,1.2304458618164062,0.0,29.04560972403965,116.43492226640562,121.97620228500324,12.404384308938253,-87.59561569106175,0.0061867098330310455,0.17775556539296886,-0.031098603752645282,9373514.0,-1.0
4692,2021-08-20,IBM,116.88467230045563,118.27635272230464,116.48584003069747,118.0472412109375,2780059.0,0.0,0.0,0.924957275390625,0.0,0.924957275390625,38.20490226654729,116.43492226640562,121.97620228500324,29.096507289301776,-70.90349271069823,-0.12855567759056896,0.11649331679626129,-0.015150552673799389,12153573.0,1.0
4693,2021-08-23,IBM,118.48001098632812,118.92976894950752,117.7841707985272,118.48001098632812,3179422.0,0.0,0.0,0.432769775390625,0.0,0.432769775390625,42.23079504907924,116.43492226640562,121.97620228500324,36.90643160170189,-63.09356839829812,-0.1981351081324192,0.05356763181052518,-0.012448893249059956,15332995.0,1.0
4694,2021-08-24,IBM,118.61579010798508,118.99765164301196,118.2254364405023,118.6667022705078,2474418.0,0.0,0.0,0.1866912841796733,0.0,0.1866912841796733,44.045306567983644,116.43492226640562,121.97620228500324,40.27553194590216,-59.724468054097834,-0.2354982050254364,-0.004245535556667153,-0.016112124343521717,17807413.0,1.0
4695,2021-08-25,IBM,118.73458983787104,119.48135576061416,118.3442496990605,118.68367767333984,2105389.0,0.0,0.0,0.01697540283204546,0.0,0.01697540283204546,44.2290936548587,116.43492226640562,121.97620228500324,40.581876378507495,-59.418123621492505,-0.260733383219673,-0.05554310508926834,-0.022436548204210816,19912802.0,1.0
4696,2021-08-26,IBM,118.77703085552152,119.48136324658208,117.70780761301847,117.7672119140625,2613640.0,0.0,0.0,-0.9164657592773438,0.9164657592773438,0.0,36.71658743895395,116.43492226640562,121.97620228500324,24.04299445589204,-75.95700554410796,-0.35064159327752975,-0.11456280272692065,-0.030730447968016827,17299162.0,-1.0
4697,2021-08-27,IBM,117.70781053998424,118.45457652808447,117.44475756151496,118.30182647705078,2572637.0,0.0,0.0,0.5346145629882812,0.0,0.5346145629882812,43.209303992816395,116.43492226640562,121.97620228500324,33.69084768103154,-66.30915231896846,-0.3744392674346102,-0.1665380956684586,-0.02911054743600283,19871799.0,1.0
4698,2021-08-30,IBM,118.37818661289852,118.70064385333018,117.8011414714087,117.92842864990234,2087293.0,0.0,0.0,-0.3733978271484375,0.3733978271484375,0.0,39.90947470283685,116.43492226640562,121.97620228500324,26.95237162684837,-73.04762837315162,-0.41860377593492615,-0.21695123172175215,-0.02422433292559012,17784506.0,-1.0
4699,2021-08-31,IBM,118.412126331795,119.60014449514097,117.91145621349996,119.09099578857422,4429915.0,0.0,0.0,1.162567138671875,0.0,1.162567138671875,52.84621651221596,116.43492226640562,121.97620228500324,47.93249056633658,-52.06750943366342,-0.35569478690652545,-0.24469994275870682,0.006237845062593506,22214421.0,1.0
4700,2021-09-01,IBM,118.78552604955132,118.86190107513691,118.11513508636436,118.20848083496094,2588327.0,0.0,0.0,-0.8825149536132812,0.8825149536132812,0.0,44.46204294095885,116.43492226640562,121.97620228500324,32.00629750893128,-67.99370249106872,-0.37275366887445216,-0.2703106879818559,0.009274041308926284,19626094.0,-1.0
4701,2021-09-02,IBM,118.5648918679688,118.84491556676114,117.97935452595236,118.81097412109376,2840413.0,0.0,0.0,0.6024932861328267,0.0,0.6024932861328267,50.63184591193786,116.43492226640562,121.97620228500324,42.87911541581816,-57.120884584181844,-0.33380884224754936,-0.2830103188349946,0.006469722649354859,22466507.0,1.0
4702,2021-09-03,IBM,118.5309578618098,119.20133531599802,118.20848701958484,118.4460906982422,2009575.0,0.0,0.0,-0.3648834228515625,0.3648834228515625,0.0,46.98443080029509,116.43492226640562,121.4840441695396,39.83204348043671,-60.16795651956329,-0.3285999338386034,-0.2921282418357164,-0.0002862954502075299,20456932.0,-1.0
4703,2021-09-07,IBM,118.50547989685413,118.62427494900211,116.9016451123188,117.15621948242188,3436110.0,0.0,0.0,-1.2898712158203267,1.2898712158203267,0.0,36.314119775840794,116.43492226640562,120.43177187758342,18.04664388670109,-81.95335611329891,-0.4236698611752132,-0.3184365657036158,-0.012728783721002834,17020822.0,-1.0
4704,2021-09-08,IBM,117.2241006629572,118.0302708819772,116.7658640946278,117.67385864257812,3122728.0,0.0,0.0,0.51763916015625,0.0,0.51763916015625,42.374078566778735,116.43492226640562,119.60014449514097,39.142160854453394,-60.85783914554661,-0.4520335480370079,-0.34515596217029426,-0.008508491231128734,20143550.0,1.0
4705,2021-09-09,IBM,116.97802744907956,117.91996351263586,116.73193165241524,116.88468170166016,3669682.0,0.0,0.0,-0.7891769409179688,0.7891769409179688,0.0,36.29822769709764,116.48584003069747,119.60014449514097,12.806765539988799,-87.1932344600112,-0.5320587162437107,-0.3825365129849776,-0.007493853323506938,16473868.0,-1.0
4706,2021-09-10,IBM,117.8011490543376,118.26787776823846,116.25671854806605,116.27368927001952,4157955.0,0.0,0.0,-0.6109924316406392,0.6109924316406392,0.0,32.17670448195108,116.25671854806605,119.60014449514097,0.5075848014016076,-99.4924151985984,-0.6374332874055568,-0.4335158678690935,-0.01714375227693299,12315913.0,-1.0
4707,2021-09-13,IBM,117.44475169402996,117.9454083134988,116.68949361012793,117.23259735107422,4334729.0,0.0,0.0,0.9589080810547017,0.0,0.9589080810547017,43.743964709352795,116.25671854806605,119.60014449514097,29.187989160099203,-70.8120108399008,-0.6362334231615421,-0.47405937892758326,-0.00590045425682606,16650642.0,1.0
4708,2021-09-14,IBM,117.44474092700372,117.58899882407104,114.8480446035092,115.59481048583984,4659198.0,0.0,0.0,-1.637786865234375,1.637786865234375,0.0,32.739821437770686,114.8480446035092,119.60014449514097,15.71443991835419,-84.28556008164581,-0.7586924997051625,-0.5309860030830992,-0.029357259796040758,11991444.0,-1.0
4709,2021-09-15,IBM,115.5948026899358,116.93557079070408,115.12807404495612,116.42642211914062,3403579.0,0.0,0.0,0.8316116333007812,0.0,0.8316116333007812,41.37951917692085,114.8480446035092,119.60014449514097,33.214316862549126,-66.78568313745087,-0.7796507627201379,-0.580718955010507,-0.015075557212416713,15395023.0,1.0
4710,2021-09-16,IBM,116.49432863984764,117.06288171690188,115.16203885637547,115.77302551269533,2765624.0,0.0,0.0,-0.6533966064452983,0.6533966064452983,0.0,37.06343038105826,114.8480446035092,119.60014449514097,19.464677306446795,-80.5353226935532,-0.8393089514913754,-0.6324369543066807,-0.025569595997943062,12629399.0,-1.0
4711,2021-09-17,IBM,115.1959807991727,115.34023869945004,114.60196493302264,114.75471496582033,5890340.0,0.0,0.0,-1.018310546875,1.018310546875,0.0,31.209551497101927,114.60196493302264,119.60014449514097,3.0561133488558676,-96.94388665114413,-0.9577176734817527,-0.6974930981416951,-0.03116502799426424,6739059.0,-1.0
4712,2021-09-20,IBM,113.62608655981558,114.7122804129626,112.67566524530308,113.97400665283205,4990152.0,0.0,0.0,-0.7807083129882812,0.7807083129882812,0.0,27.383556165646468,112.67566524530308,119.60014449514097,18.75002235813418,-81.24997764186583,-1.1018526040147947,-0.7783649993163151,-0.027162133121471088,1748907.0,-1.0
4713,2021-09-21,IBM,114.65289664041828,115.11113327285432,112.81145797670617,112.8369140625,4261927.0,0.0,0.0,-1.1370925903320455,1.1370925903320455,0.0,22.70570114245372,112.67566524530308,119.20133531599802,2.470992487362274,-97.52900751263772,-1.2929303476325487,-0.881278068979562,-0.04110466535111956,-2513020.0,-1.0
4714,2021-09-22,IBM,113.47334443678336,114.87351703888132,113.26119686761592,114.2455596923828,3767901.0,0.0,0.0,1.4086456298827983,0.0,1.4086456298827983,37.87532662390324,112.67566524530308,119.20133531599802,24.057214509352825,-75.94278549064717,-1.3155302919847571,-0.968128513580601,-0.022578852685021022,1254881.0,1.0
4715,2021-09-23,IBM,114.7716792594546,116.61311750614053,114.5849877951726,116.02758026123048,3151807.0,0.0,0.0,1.7820205688476847,0.0,1.7820205688476847,51.7093700480846,112.67566524530308,119.20133531599802,51.36507024742127,-48.63492975257872,-1.1760895159197702,-1.009720714048435,-0.00211663541712781,4406688.0,1.0
4716,2021-09-24,IBM,116.28218334302052,117.51263519757272,116.0445796876356,116.67252349853516,3100762.0,0.0,0.0,0.6449432373046733,0.0,0.6449432373046733,55.81791385257698,112.67566524530308,118.62427494900211,67.18978807345023,-32.810211926549776,-1.0019898517428913,-1.0081745415873262,-0.004777458362214881,7507450.0,1.0
4717,2021-09-27,IBM,117.07135667091114,118.0132926015054,116.66403229313684,117.58050537109376,3459017.0,0.0,0.0,0.907981872558608,0.0,0.907981872558608,61.18271684261097,112.67566524530308,118.26787776823846,87.70839995215537,-12.291600047844634,-0.781736690810547,-0.9628869714319703,0.017178062552359652,10966467.0,1.0
4718,2021-09-28,IBM,118.0981542364393,118.53942008503088,116.43491517140734,116.65554809570312,4513072.0,0.0,0.0,-0.9249572753906392,0.9249572753906392,0.0,53.54106931343061,112.67566524530308,118.53942008503088,67.87259971095231,-32.12740028904769,-0.6740507583071462,-0.9051197288070056,0.001967989502658085,6453395.0,-1.0
4719,2021-09-29,IBM,116.87617835555491,118.74307958076692,115.781505891845,118.1066436767578,3947499.0,0.0,0.0,1.4510955810546733,0.0,1.4510955810546733,62.108044613654954,112.67566524530308,118.74307958076692,89.51059102245299,-10.489408977547022,-0.4662430353977385,-0.8173443901251524,0.02015683838034077,10400894.0,1.0
4720,2021-09-30,IBM,118.80249535096976,119.28618126710312,117.52960987594368,117.89450073242188,6090230.0,0.0,0.0,-0.2121429443359233,0.2121429443359233,0.0,60.23441609142991,112.67566524530308,119.28618126710312,78.94747505199618,-21.052524948003818,-0.3150404898129153,-0.7168836100627051,0.027360843234517596,4310664.0,-1.0
4721,2021-10-01,IBM,119.65107875371864,122.17138670188888,119.1164671559812,121.61980438232422,6907889.0,0.0,0.0,3.7253036499023438,0.0,3.7253036499023438,75.31999258005192,112.67566524530308,122.17138670188888,94.19125421816047,-5.808745781839533,0.10418846800001802,-0.5526691944501605,0.06708369701156047,11218553.0,1.0
4722,2021-10-04,IBM,121.12761506189048,123.8940188439311,120.79666566401843,122.2901840209961,7689251.0,0.0,0.0,0.670379638671875,0.0,0.670379638671875,77.1220887440178,112.67566524530308,123.8940188439311,85.70347414320096,-14.296525856799036,0.484934449223303,-0.34514846571546776,0.0837781681379548,18907804.0,1.0
4723,2021-10-05,IBM,122.83327138650608,123.04541215703289,121.04274531463984,121.47553253173828,7297524.0,0.0,0.0,-0.8146514892578125,0.8146514892578125,0.0,69.95937575346214,112.67566524530308,123.8940188439311,78.4417001039387,-21.558299896061296,0.7127269430702654,-0.13357338395832108,0.06328449752290499,11610280.0,-1.0
4724,2021-10-06,IBM,120.90696958595817,121.66221404716175,119.55772282327676,120.80514526367188,5573506.0,0.0,0.0,-0.6703872680664062,0.6703872680664062,0.0,64.2898949306003,112.67566524530308,123.8940188439311,72.46589213735443,-27.53410786264557,0.8295964146650903,0.059060575766361256,0.041176115124394785,6036774.0,-1.0
4725,2021-10-07,IBM,121.11915508558263,121.68770822488231,120.1008438802311,120.33844757080078,3999695.0,0.0,0.0,-0.46669769287109375,0.46669769287109375,0.0,60.36065021721705,112.67566524530308,123.8940188439311,68.30576570910412,-31.694234290895878,0.8744772797064684,0.22214391655438276,0.03142062897363873,2037079.0,-1.0
4726,2021-10-08,IBM,120.33843219259644,121.89984702262493,119.69350410230231,121.53494262695312,3902940.0,0.0,0.0,1.1964950561523438,0.0,1.1964950561523438,66.42998457856112,112.81145797670617,123.8940188439311,78.7136182219888,-21.28638177801121,0.9951216966290275,0.3767394725693118,0.03363174229757582,5940019.0,1.0
4727,2021-10-11,IBM,121.77254989117664,122.26472789399412,120.8390925050576,120.86455535888672,2921792.0,0.0,0.0,-0.6703872680664062,0.6703872680664062,0.0,60.446571700701185,113.26119686761592,123.8940188439311,71.50837762738279,-28.491622372617226,1.0248250708778244,0.5063565922310144,0.03608064367183439,3018227.0,-1.0
4728,2021-10-12,IBM,120.67787211616708,120.75424713879475,119.05706655084812,119.20132446289062,3293436.0,0.0,0.0,-1.6632308959960938,1.6632308959960938,0.0,48.055641916459734,114.5849877951726,123.8940188439311,49.589872925965686,-50.41012707403431,0.9037386393878535,0.5858330016623822,0.009268579243762343,-275209.0,-1.0
4729,2021-10-13,IBM,119.24374838766668,119.99899287551926,118.5139532092484,119.4474105834961,3013003.0,0.0,0.0,0.24608612060546875,0.0,0.24608612060546875,49.81200597808507,115.781505891845,123.8940188439311,45.18827536304178,-54.81172463695822,0.8182021384182292,0.6323068290135516,0.013172029580911238,2737794.0,1.0
4730,2021-10-14,IBM,119.68502589915386,122.12895894349435,119.6595630431641,121.67921447753906,4410668.0,0.0,0.0,2.2318038940429688,0.0,2.2318038940429688,62.92884287537913,115.781505891845,123.8940188439311,72.69891118235435,-27.301088817645642,0.9198977586828363,0.6898250149474087,0.0004884903039974464,7148462.0,1.0
4731,2021-10-15,IBM,121.67920932582544,122.91813974614082,121.17004703609378,122.7144775390625,3371049.0,0.0,0.0,1.0352630615234375,0.0,1.0352630615234375,67.47816709520433,115.781505891845,123.8940188439311,85.46022284543436,-14.53977715456565,1.0716757366335372,0.7661951592846344,0.0034695631661945114,10519511.0,1.0
4732,2021-10-18,IBM,122.19683928225594,122.99451740576691,120.2960100341699,120.7712173461914,6437189.0,0.0,0.0,-1.9432601928710938,1.9432601928710938,0.0,53.30912620678976,115.781505891845,123.8940188439311,61.50636040665213,-38.49363959334788,1.0233593707917095,0.8176280015860494,-0.005798000394547365,4082322.0,-1.0
4733,2021-10-19,IBM,119.71896746691912,121.29733948216312,119.24376014448784,120.48270416259766,4539117.0,0.0,0.0,-0.28851318359375,0.28851318359375,0.0,51.458096006495985,117.52960987594368,123.8940188439311,46.400133956002215,-53.59986604399779,0.9508271564603916,0.8442678325609179,-0.002669100727212048,-456795.0,-1.0
4734,2021-10-20,IBM,120.22811868360496,120.66938456971826,119.39649908037464,120.41481018066406,6474008.0,0.0,0.0,-0.06789398193359375,0.06789398193359375,0.0,50.97747386372308,118.5139532092484,123.8940188439311,35.33148293139313,-64.66851706860687,0.8777482417563931,0.8509639144000128,0.0006345653563326614,-6930803.0,-1.0
4735,2021-10-21,IBM,113.29513106004003,113.4733303910988,108.70426012768272,108.8994369506836,32913959.0,0.0,0.0,-11.515373229980469,11.515373229980469,0.0,18.026825565154,108.70426012768272,123.8940188439311,1.2849237874469912,-98.71507621255302,-0.10811541907001754,0.6591480477060068,-0.10396603152275086,-39844762.0,-1.0
4736,2021-10-22,IBM,108.66185807993084,110.52875281955818,107.43989147588854,108.51759338378906,12114981.0,0.0,0.0,-0.38184356689453125,0.38184356689453125,0.0,17.591764301456237,107.43989147588854,123.04541215703289,6.905901635199342,-93.09409836480066,-0.9097440940672641,0.3453696193513525,-0.10215535843767809,-51959743.0,-1.0
4737,2021-10-25,IBM,108.22057333084884,109.17099464497085,107.71990320654328,108.3139190673828,6667204.0,0.0,0.0,-0.2036743164062642,0.2036743164062642,0.0,17.334288816487515,107.43989147588854,122.99451740576691,5.619084608234541,-94.38091539176547,-1.5436808180198085,-0.03244046812287978,-0.09133627872479944,-58626947.0,-1.0
4738,2021-10-26,IBM,108.2120910440534,108.87398980696489,107.56716300244186,107.88114166259766,8912861.0,0.0,0.0,-0.43277740478514204,0.43277740478514204,0.0,16.733810203725923,107.43989147588854,122.99451740576691,2.8367778736583396,-97.16322212634167,-2.0572866389567395,-0.4374097022896519,-0.09683147474187725,-67539808.0,-1.0
4739,2021-10-27,IBM,108.14420191072364,108.51757809723804,106.08213059411412,106.21790313720705,7294176.0,0.0,0.0,-1.6632385253906108,1.6632385253906108,0.0,14.505560334676261,106.08213059411412,122.99451740576691,0.8027994191770604,-99.19720058082294,-2.5689194962580757,-0.8637116610833369,-0.12706616661456216,-74833984.0,-1.0
4740,2021-10-28,IBM,106.21790782489252,107.18529993469,105.75118587814288,106.78646087646484,6802138.0,0.0,0.0,0.5685577392577983,0.0,0.5685577392577983,18.771786722519835,105.75118587814288,122.99451740576691,6.00391517534441,-93.9960848246556,-2.8951409807982884,-1.2699975250263273,-0.12979737176917405,-68031846.0,1.0
4741,2021-10-29,IBM,106.43853110523004,107.19377557583393,105.99726528168937,106.15850067138672,6188973.0,0.0,0.0,-0.627960205078125,0.627960205078125,0.0,17.649402656843918,105.75118587814288,122.99451740576691,2.36215833692763,-97.63784166307236,-3.1678282459480016,-1.6495636692106623,-0.12099502676136198,-74220819.0,-1.0
4742,2021-11-01,IBM,106.1160763173618,107.18529952792429,105.08928668400202,107.15984344482422,6177153.0,0.0,0.0,1.0013427734375,0.0,1.0013427734375,25.81097944032615,105.08928668400202,122.99451740576691,11.56397699084275,-88.43602300915725,-3.265492312261756,-1.9727493978208812,-0.11057903132547175,-68043666.0,1.0
4743,2021-11-02,IBM,107.1768127925836,107.91508659727056,105.99727313167652,107.07498168945312,4722062.0,0.0,0.0,-0.08486175537109375,0.08486175537109375,0.0,25.56323705533069,105.08928668400202,122.99451740576691,11.090027469109199,-88.9099725308908,-3.3115657542493153,-2.240512669106568,-0.11078229057701916,-72765728.0,-1.0
4744,2021-11-03,IBM,107.1174117998509,108.0169142050328,106.65068310392437,107.88114166259766,5670784.0,0.0,0.0,0.8061599731445312,0.0,0.8061599731445312,32.649153320029185,105.08928668400202,122.99451740576691,15.592398791052538,-84.40760120894745,-3.245615481547105,-2.4415332315946756,-0.009350785611013657,-67094944.0,1.0
4745,2021-11-04,IBM,109.22216365072023,109.47956871671023,106.4261459861384,107.2693862915039,7208700.0,0.0,1.046,-0.61175537109375,0.61175537109375,0.0,30.13717683026786,105.08928668400202,122.99451740576691,12.175769423913895,-87.82423057608611,-3.205758967220433,-2.5943783787198273,-0.011502347714906325,-74303644.0,-1.0
4746,2021-11-05,IBM,107.78420957650836,109.86124700595418,107.78420957650836,109.71923065185548,6790500.0,0.0,0.0,2.4498443603515767,0.0,2.4498443603515767,48.46013324483089,105.08928668400202,121.29733948216312,28.56570141712987,-71.43429858287014,-2.942570307965255,-2.6640167645689132,0.012974432063513675,-67513144.0,1.0
4747,2021-11-08,IBM,110.05652747059705,110.75775143188028,109.6482211334009,110.5447235107422,5625300.0,0.0,0.0,0.8254928588867188,0.0,0.8254928588867188,53.229334998026545,105.08928668400202,120.66938456971826,35.0154207422644,-64.9845792577356,-2.636983519999845,-2.6586101156550996,0.024689967190697715,-61887844.0,1.0
4748,2021-11-09,IBM,110.23889652474872,110.5447194923906,108.17012235353444,108.7008056640625,7236600.0,1.64,0.0,-1.8439178466797017,1.8439178466797017,0.0,42.97906089346673,105.08928668400202,113.4733303910988,43.076099150144756,-56.92390084985524,-2.5146057391922767,-2.6298092403625355,0.02337555584813389,-69124444.0,-1.0
4749,2021-11-10,IBM,108.835724579241,110.12196523512812,107.87329323968925,108.13414001464844,6270300.0,0.0,0.0,-0.5666656494140625,0.5666656494140625,0.0,40.23187565044078,105.08928668400202,110.75775143188028,53.71566140172478,-46.28433859827523,-2.435273333222895,-2.5909020589346077,0.01262031841042699,-75394744.0,-1.0
4750,2021-11-11,IBM,108.74578506140932,109.5463117868848,108.00822088077786,108.17911529541016,4643300.0,0.0,0.0,0.04497528076171875,0.0,0.04497528076171875,40.579700624632174,105.08928668400202,110.75775143188028,54.50909106499565,-45.49090893500435,-2.3417781399584925,-2.5410772751393846,0.019033940864314314,-70751444.0,1.0
4751,2021-11-12,IBM,107.93628018913152,108.5119398011479,106.83892690922404,107.0008316040039,5418300.0,0.0,0.0,-1.17828369140625,1.17828369140625,0.0,34.50889797020841,105.08928668400202,110.75775143188028,33.722445230296074,-66.27755476970391,-2.3358341304195704,-2.500028646195422,-0.0014838752624921625,-76169744.0,-1.0
4752,2021-11-15,IBM,107.52251864557265,108.08019186264733,106.41616882235768,106.9198760986328,5046300.0,0.0,0.0,-0.08095550537110796,0.08095550537110796,0.0,34.104422300906506,105.08928668400202,110.75775143188028,32.29427183640826,-67.70572816359174,-2.3110159395520498,-2.4622261048667475,-0.001448569856123627,-81216044.0,-1.0
4753,2021-11-16,IBM,106.9648413015556,107.84632385422492,106.51510684583523,106.55108642578124,4750800.0,0.0,0.0,-0.3687896728515625,0.3687896728515625,0.0,32.12523071156279,105.08928668400202,110.75775143188028,25.788283191253452,-74.21171680874656,-2.2946542432360246,-2.428711732540603,-0.012328894710590066,-85966844.0,-1.0
4754,2021-11-17,IBM,106.47912922092624,107.33362881992612,105.93944923663352,106.19129943847656,4043300.0,0.0,0.0,-0.3597869873046733,0.3597869873046733,0.0,30.15528105574269,105.08928668400202,110.75775143188028,19.441115072419446,-80.55888492758055,-2.284386300742227,-2.399846646180928,-0.010050275202448278,-90010144.0,-1.0
4755,2021-11-18,IBM,106.46113936525242,106.46113936525242,104.61722537854284,104.93204498291016,5046900.0,0.0,0.0,-1.2592544555664062,1.2592544555664062,0.0,24.169813041580696,104.61722537854284,110.75775143188028,5.126915864092908,-94.87308413590709,-2.350762071018849,-2.3900297311485126,-0.04363123620630649,-95057044.0,-1.0
4756,2021-11-19,IBM,104.77913875693233,104.84210131055436,103.68178551174492,104.38337707519533,5380200.0,0.0,0.0,-0.5486679077148295,0.5486679077148295,0.0,21.976791072738862,103.68178551174492,110.75775143188028,9.9151348574752,-90.08486514252479,-2.419744948392122,-2.395972774597235,-0.05573623271985606,-100437244.0,-1.0
4757,2021-11-22,IBM,104.3383874550667,106.86589274831104,103.60981987656486,104.76113891601562,6416200.0,0.0,0.0,0.3777618408202983,0.0,0.3777618408202983,27.22271485343572,103.60981987656486,110.75775143188028,16.107023836771525,-83.89297616322847,-2.4160810735804574,-2.3999944343938795,-0.036243215714723664,-94021044.0,1.0
4758,2021-11-23,IBM,105.0489730834961,106.0833636853543,104.37437141216289,105.0489730834961,4912800.0,0.0,0.0,0.28783416748046875,0.0,0.28783416748046875,31.284571517205393,103.60981987656486,110.75775143188028,20.1338414588069,-79.8661585411931,-2.362715698774238,-2.3925386872699512,-0.028530924005447433,-89108244.0,1.0
4759,2021-11-24,IBM,104.48231336448607,105.48071755536478,104.41035420368662,104.99501037597656,3220800.0,0.0,0.0,-0.05396270751953125,0.05396270751953125,0.0,30.911367547312082,103.60981987656486,110.75775143188028,19.378899877428676,-80.62110012257132,-2.2982844023176625,-2.3736878302794935,-0.029433638006177043,-92329044.0,-1.0
4760,2021-11-26,IBM,103.43892050620023,104.64420550336256,103.04315200568584,104.16748809814452,3322000.0,0.0,0.0,-0.8275222778320455,0.8275222778320455,0.0,25.52377421122972,103.04315200568584,110.75775143188028,14.5741344474875,-85.4258655525125,-2.287625939766272,-2.3564754521768494,-0.02647964004938974,-95651044.0,-1.0
4761,2021-11-29,IBM,106.69499775376084,107.58546999626094,105.71457313608872,106.5870590209961,8949800.0,0.0,0.0,2.4195709228515767,0.0,2.4195709228515767,53.10084664691197,103.04315200568584,110.5447194923906,47.24221999723686,-52.75778000276314,-2.060191276516875,-2.2972186170448547,-0.0031127708877036753,-86701244.0,1.0
4762,2021-11-30,IBM,105.68758583476163,107.25265965245904,104.74314083340492,105.32779693603516,9252700.0,0.0,0.0,-1.2592620849609375,1.2592620849609375,0.0,43.44125912237898,103.04315200568584,110.12196523512812,32.27440612286529,-67.7255938771347,-1.9589777177683203,-2.229570437189548,-0.011480779134037,-95953944.0,-1.0
4763,2021-12-01,IBM,106.36218874099195,106.97382781755044,105.10293101132424,105.1658935546875,5958300.0,0.0,0.0,-0.16190338134765625,0.16190338134765625,0.0,42.29974168495104,103.04315200568584,109.5463117868848,32.64169450577914,-67.35830549422086,-1.870270182585429,-2.1577103862687244,-0.009656213731362717,-101912244.0,-1.0
4764,2021-12-02,IBM,105.57066253382229,106.1193390872334,104.84208809102884,105.14791107177734,5267100.0,0.0,0.0,-0.01798248291015625,0.01798248291015625,0.0,42.15777075494379,103.04315200568584,108.5119398011479,38.486756934288216,-61.51324306571178,-1.7808908567046728,-2.082346480355914,0.0020571989128996826,-107179344.0,-1.0
4765,2021-12-03,IBM,105.561665605979,107.36060331996993,105.561665605979,106.89287567138672,6630100.0,0.0,0.0,1.744964599609375,0.0,1.744964599609375,57.95711582800764,103.04315200568584,108.08019186264733,76.42829469336706,-23.571705306632936,-1.551369811596146,-1.9761511466039603,0.02404117079277479,-100549244.0,1.0
4766,2021-12-06,IBM,107.39660030799226,108.97067106290972,107.39660030799226,107.85533142089844,4785600.0,0.0,0.0,0.9624557495117188,0.0,0.9624557495117188,64.18329664961212,103.04315200568584,108.97067106290972,81.18370213163612,-18.816297868363876,-1.2770891060760334,-1.8363387384983751,0.0295356898263901,-95763644.0,1.0
4767,2021-12-07,IBM,108.36801509596413,109.80716395026316,107.9992295563984,109.35742950439452,5194000.0,0.0,0.0,1.5020980834960795,0.0,1.5020980834960795,71.72401058931175,103.04315200568584,109.80716395026316,93.35106960848594,-6.648930391514063,-0.9278176052776672,-1.6546345118542336,0.041013789039840765,-90569644.0,1.0
4768,2021-12-08,IBM,109.73520133397194,110.97646589498956,109.30345326008596,110.65265655517578,5483900.0,0.0,0.0,1.2952270507812642,0.0,1.2952270507812642,76.62117847075481,103.04315200568584,110.97646589498956,95.91835966240588,-4.0816403375941235,-0.5402754669228784,-1.4317627028679627,0.053884905186825094,-85085744.0,1.0
4769,2021-12-09,IBM,109.87012522033056,111.4891650891854,109.546315874079,111.14736938476562,4601100.0,0.0,0.0,0.49471282958984375,0.0,0.49471282958984375,78.27908652590057,103.04315200568584,111.4891650891854,95.95317102826273,-4.046828971737268,-0.19102432976112027,-1.1836150282465943,0.06700633195690386,-80484644.0,1.0
4770,2021-12-10,IBM,111.80399920380091,112.73045117381795,110.95849614965545,111.61510467529295,4966900.0,0.0,0.0,0.46773529052732954,0.0,0.46773529052732954,79.83881417395166,103.04315200568584,112.73045117381795,88.48650713509389,-11.513492864906109,0.12209461090354523,-0.9224731004165664,0.047173134341819134,-75517744.0,1.0
4771,2021-12-13,IBM,111.31826282286156,111.85794274111176,108.64683933576012,110.25688934326172,6847500.0,0.0,0.0,-1.3582153320312358,1.3582153320312358,0.0,64.35524640349479,103.04315200568584,112.73045117381795,74.46592917566328,-25.534070824336712,0.25767666487018914,-0.6864431473592153,0.046797640799607354,-82365244.0,-1.0
4772,2021-12-14,IBM,110.0500134381368,112.46059025282462,110.00504411266444,111.31826782226562,5716100.0,0.0,0.0,1.0613784790039062,0.0,1.0613784790039062,69.66059137324595,103.04315200568584,112.73045117381795,85.42232125752938,-14.57767874247063,0.445633803313072,-0.4600277572247578,0.05850161168819268,-76649144.0,1.0
4773,2021-12-15,IBM,111.35424777079548,112.27170298983864,109.89710574506508,110.73361206054688,4990000.0,0.0,0.0,-0.58465576171875,0.58465576171875,0.0,63.640165986349146,103.04315200568584,112.73045117381795,79.38703988992108,-20.612960110078916,0.5411760156504499,-0.2597870026497162,0.05312232009018758,-81639144.0,-1.0
4774,2021-12-16,IBM,111.0933906594491,113.908725463293,111.0664076941014,113.27010345458984,7280500.0,0.0,0.0,2.5364913940429688,0.0,2.5364913940429688,74.6202987788532,104.74314083340492,113.908725463293,93.03239199144299,-6.96760800855701,0.8122049711016643,-0.045388607899440034,0.059659988966974664,-74358644.0,1.0
4775,2021-12-17,IBM,113.21615978881816,115.70768577366536,112.62250698481353,114.59234619140624,10379000.0,0.0,0.0,1.322242736816392,0.0,1.322242736816392,78.52162924314858,104.74314083340492,115.70768577366536,89.82776222509939,-10.172237774900603,1.120771750291226,0.18784346373869326,0.062463437659998844,-63979644.0,1.0
4776,2021-12-20,IBM,113.08122927080628,114.41243937707932,112.16376716556124,114.28651428222656,4941400.0,0.0,0.0,-0.3058319091796733,0.3058319091796733,0.0,75.4272467059322,104.84208809102884,115.70768577366536,86.92044806969189,-13.079551930308112,1.325357174276789,0.4153462058463125,0.045073158725205564,-68921044.0,-1.0
4777,2021-12-21,IBM,114.8262068701206,116.33730808424974,114.8262068701206,116.00450897216795,4856000.0,0.0,0.0,1.717994689941392,0.0,1.717994689941392,80.4268207138557,104.84208809102884,116.33730808424974,97.1048913176255,-2.8951086823744943,1.6075891236137778,0.6537947893998057,0.04836623524102679,-64065044.0,1.0
4778,2021-12-22,IBM,116.0854419035898,116.74205028900862,114.77221827034978,116.7060775756836,3923200.0,0.0,0.0,0.7015686035156392,0.0,0.7015686035156392,82.13911493804173,105.561665605979,116.74205028900862,99.6782515598088,-0.32174844019119586,1.866356503874897,0.8963071322948242,0.05001205356174521,-60141844.0,1.0
4779,2021-12-23,IBM,116.93095745714736,117.79445364343798,116.4992162264052,117.49762725830078,3649000.0,0.0,0.0,0.7915496826171875,0.0,0.7915496826171875,83.96525851711928,107.39660030799226,117.79445364343798,97.14531090638363,-2.854689093616366,2.1109690243010846,1.1392395106960762,0.052703642577060394,-56492844.0,1.0
4780,2021-12-27,IBM,117.49763418729287,118.41508264112238,116.8859881599328,118.38809967041016,4293900.0,0.0,0.0,0.890472412109375,0.0,0.890472412109375,85.84398346635203,107.9992295563984,118.41508264112238,99.74094324782865,-0.2590567521713523,2.349595219626039,1.3813106524820689,0.07374786623839547,-52198944.0,1.0
4781,2021-12-28,IBM,118.37011034447896,119.82724554117615,118.3611068717844,119.29656219482422,3445200.0,0.0,0.0,0.9084625244140625,0.0,0.9084625244140625,87.559772949511,108.64683933576012,119.82724554117615,95.25345200700436,-4.746547992995645,2.5822469960347405,1.6214979211926035,0.07167102514833412,-48753744.0,1.0
4782,2021-12-29,IBM,119.08965418932247,120.7177041170958,118.99971555133511,119.94416046142578,4239900.0,0.0,0.0,0.6475982666015625,0.0,0.6475982666015625,88.68755691410142,108.64683933576012,120.7177041170958,93.59164674873917,-6.408353251260839,2.7867569732230493,1.8545497315986927,0.08317753055723287,-44513844.0,1.0
4783,2021-12-30,IBM,120.30396528810748,120.86163161376672,119.92618999735708,120.44788360595705,3158100.0,0.0,0.0,0.5037231445312642,0.0,0.5037231445312642,89.53872686762587,108.64683933576012,120.86163161376672,96.61272989017874,-3.38727010982126,2.9554107164730823,2.074721928573571,0.06336870835687702,-41355744.0,1.0
4784,2021-12-31,IBM,120.52884625703034,121.41932550986007,120.17805389527456,120.22303009033205,3362100.0,0.0,0.0,-0.224853515625,0.224853515625,0.0,86.1982089725154,108.64683933576012,121.41932550986007,90.6338092426056,-9.366190757394401,3.0359299133117474,2.2669635255212066,0.04913664905264037,-44717844.0,-1.0
4785,2022-01-03,IBM,120.59180548582864,122.58861387454608,120.19603696245534,122.3637466430664,4605900.0,0.0,0.0,2.140716552734361,0.0,2.140716552734361,90.21035821964877,109.89710574506508,122.58861387454608,98.22820716666969,-1.771792833330307,3.2351866738643054,2.4606081551898265,0.07067528843248638,-40111944.0,1.0
4786,2022-01-04,IBM,122.41772801125126,125.88067518935112,122.23782324371834,124.14470672607422,7300000.0,0.0,0.0,1.7809600830078125,0.0,1.7809600830078125,92.34617150668343,109.89710574506508,125.88067518935112,89.13904388298263,-10.860956117017368,3.4965021860600842,2.6677869613638783,0.07017139097463243,-32811944.0,1.0
4787,2022-01-05,IBM,124.40554149746602,127.90447497325478,124.01877645795504,124.32459259033205,8956900.0,0.0,0.0,0.1798858642578267,0.0,0.1798858642578267,92.53595630162094,111.0664076941014,127.90447497325478,78.73935099811092,-21.26064900188907,3.675740252466966,2.869377619584496,0.0652795053428803,-23855044.0,1.0
4788,2022-01-06,IBM,124.3066205325054,124.49551507278346,119.18863941867215,121.73413848876952,9908100.0,0.0,0.0,-2.5904541015625284,2.5904541015625284,0.0,65.53484070507528,112.16376716556124,127.90447497325478,60.80013326040265,-39.19986673959734,3.5676342479321335,3.009028945254024,0.036056142828785775,-33763144.0,-1.0
4789,2022-01-07,IBM,121.3383463096426,122.02195144168492,120.08808511659336,121.275390625,5238100.0,0.0,0.0,-0.45874786376951704,0.45874786376951704,0.0,61.84729060509105,112.16376716556124,127.90447497325478,57.88572896947684,-42.11427103052316,3.4056837396006614,3.088359904123352,0.02438835459499722,-39001244.0,-1.0
4790,2022-01-10,IBM,120.95158373207435,122.5076610816398,119.97116592785608,121.45528411865234,5432800.0,0.0,0.0,0.17989349365234375,0.0,0.17989349365234375,62.79453432364134,114.77221827034978,127.90447497325478,50.89046002903823,-49.10953997096176,3.254338705619759,3.1215556644226337,0.018095424412169603,-33568444.0,1.0
4791,2022-01-11,IBM,117.3986771103086,119.8542232062223,115.10502881806148,119.51242065429688,11105300.0,0.0,0.0,-1.9428634643554688,1.9428634643554688,0.0,47.956964714063176,114.77221827034978,127.90447497325478,36.095870581775245,-63.904129418224755,2.943690796305873,3.085982690799282,-0.00359950668267639,-44673744.0,-1.0
4792,2022-01-12,IBM,119.85422569039198,120.95157879844982,118.16321984030832,120.16004180908205,5352000.0,0.0,0.0,0.6476211547851705,0.0,0.6476211547851705,52.29260534279859,115.10502881806148,127.90447497325478,39.49399786309911,-60.50600213690088,2.718421434731596,3.012470439585745,-0.00238976217977116,-39321744.0,1.0
4793,2022-01-13,IBM,120.43888900193258,122.37275551282504,120.13307284758734,121.21243286132812,4868300.0,0.0,0.0,1.0523910522460795,0.0,1.0523910522460795,58.73794155137781,115.10502881806148,127.90447497325478,47.716158724482,-52.28384127551801,2.594900606500957,2.928956472968788,0.00822972745116024,-34453444.0,1.0
4794,2022-01-14,IBM,121.0235437945808,121.55422715405928,119.89920766442826,120.7177276611328,5310300.0,0.0,0.0,-0.4947052001953267,0.4947052001953267,0.0,54.72758147648743,115.10502881806148,127.90447497325478,43.85110711055257,-56.14889288944743,2.429089849250545,2.8289831482251397,-0.013451851770565848,-39763744.0,-1.0
4795,2022-01-18,IBM,119.58438342452044,120.4298863576034,118.53200649445093,119.5753936767578,5246700.0,0.0,0.0,-1.142333984375,1.142333984375,0.0,46.30431340198458,115.10502881806148,127.90447497325478,34.926236686284206,-65.07376331371579,2.180372842973128,2.6992610871747376,-0.0368063461569782,-45010444.0,-1.0
4796,2022-01-19,IBM,119.53941896219932,120.43888791970213,118.28016791161824,118.35212707519533,4103700.0,0.0,0.0,-1.2232666015624716,1.2232666015624716,0.0,38.90551115234793,115.10502881806148,127.90447497325478,25.369052830589496,-74.6309471694105,1.8630790169277418,2.5320246731253384,-0.04803929287600306,-49114144.0,-1.0
4797,2022-01-20,IBM,118.0642881299794,119.52143714572838,117.4436660901829,117.66853332519533,5278200.0,0.0,0.0,-0.68359375,0.68359375,0.0,35.27148091113412,115.10502881806148,127.90447497325478,20.02824556665459,-79.97175443334541,1.538723623109533,2.3333644631221775,-0.03339741188499279,-54392344.0,-1.0
4798,2022-01-21,IBM,118.41507330429005,118.61295755711484,116.27434668934023,116.34630584716795,5907000.0,0.0,0.0,-1.3222274780273722,1.3222274780273722,0.0,29.18700767144587,115.10502881806148,127.90447497325478,9.697896409391355,-90.30210359060864,1.161586879014905,2.099008946300723,-0.040643734499058004,-60299344.0,-1.0
4799,2022-01-24,IBM,115.12302305984748,116.16640341966048,111.70504534332564,115.86959075927734,13484000.0,0.0,0.0,-0.4767150878906108,0.4767150878906108,0.0,27.232709732764803,111.70504534332564,127.90447497325478,25.70797559598969,-74.2920244040103,0.814843361627382,1.8421758293660548,-0.04598971053345202,-73783344.0,-1.0
4800,2022-01-25,IBM,116.15740045443292,123.53304188035696,115.401849955271,122.41770935058594,19715700.0,0.0,0.0,6.548118591308594,0.0,6.548118591308594,64.69703558517773,111.70504534332564,127.90447497325478,66.12988390324678,-33.87011609675322,1.0562492870648725,1.6849905209058185,0.024309512604492767,-54067644.0,1.0
4801,2022-01-26,IBM,122.75051995991016,123.29020678138644,119.74629717488044,120.76268768310548,8336000.0,0.0,0.0,-1.6550216674804545,1.6550216674804545,0.0,56.25109951823686,111.70504534332564,124.49551507278346,70.81555667122313,-29.184443328776865,1.1013234342375284,1.5682571035721604,0.005015360056057183,-62403644.0,-1.0
4802,2022-01-27,IBM,120.22302591350731,121.20344379758224,118.8018632928742,119.1976318359375,5497300.0,0.0,0.0,-1.565055847167983,1.565055847167983,0.0,49.2376060147829,111.70504534332564,123.53304188035696,63.34620127046813,-36.65379872953187,0.9992394827128095,1.4544535794002904,-0.016622065722380452,-67900944.0,-1.0
4803,2022-01-28,IBM,119.80026694843858,121.005552000219,118.54100223293712,120.97856903076172,5471500.0,0.0,0.0,1.7809371948242188,0.0,1.7809371948242188,56.37875524853413,111.70504534332564,123.53304188035696,78.40316539155512,-21.596834608444876,1.0499408982539222,1.373551043171017,0.002160754469808568,-62429444.0,1.0
4804,2022-01-31,IBM,120.60978089934932,120.60978089934932,118.99973761537632,120.1420669555664,5859000.0,0.0,0.0,-0.8365020751953125,0.8365020751953125,0.0,52.384847557182155,111.70504534332564,123.53304188035696,71.33094422057003,-28.669055779429964,1.010969580804712,1.301034750697756,0.004739045897188987,-68288444.0,-1.0
4805,2022-02-01,IBM,120.31294277612888,122.29178513289804,119.17961701936504,121.9050064086914,6206400.0,0.0,0.0,1.762939453125,0.0,1.762939453125,59.381972794790435,111.70504534332564,123.53304188035696,86.23574612514918,-13.764253874850821,1.1095488231572546,1.2627375651896557,0.0300195646778596,-62082044.0,1.0
4806,2022-02-02,IBM,122.05792316480732,123.73093581543677,121.66215466522527,123.4521026611328,5357200.0,0.0,0.0,1.547096252441392,0.0,1.547096252441392,64.64307563789782,111.70504534332564,123.73093581543677,97.68139286690993,-2.318607133090068,1.2975539269255592,1.2697008375368366,0.04915136759590322,-56724844.0,1.0
4807,2022-02-03,IBM,123.22724072628203,124.8103010676748,122.17486374807814,123.92882537841795,6100800.0,0.0,0.0,0.47672271728515625,0.0,0.47672271728515625,66.19966956493846,111.70504534332564,124.8103010676748,93.27387646759848,-6.7261235324015125,1.4680935961921477,1.3093793892678989,0.0651719835540836,-50624044.0,1.0
4808,2022-02-04,IBM,124.000781046935,124.8642772155321,122.52565262438635,123.36215209960938,4142000.0,0.0,0.0,-0.5666732788085795,0.5666732788085795,0.0,62.429953365476315,111.70504534332564,124.8642772155321,88.58500913647282,-11.414990863527173,1.5397721798300523,1.3554579473803297,0.06466374215386717,-54766044.0,-1.0
4809,2022-02-07,IBM,123.63200365619156,123.9648164984704,122.57063688976376,123.44312286376952,3759000.0,0.0,0.0,0.08097076416014204,0.0,0.08097076416014204,62.77939900534878,111.70504534332564,124.8642772155321,89.20032441434373,-10.799675585656281,1.5848425592533602,1.401334869754936,0.00837634945649035,-51007044.0,1.0
4810,2022-02-08,IBM,123.43409712798456,123.6949507606911,122.12987013886509,123.2452163696289,4181800.0,0.0,0.0,-0.1979064941406108,0.1979064941406108,0.0,61.17471486646373,111.70504534332564,124.8642772155321,87.69638789234499,-12.303612107655017,1.5863058135794716,1.4383290585198432,0.0205570837661202,-55188844.0,-1.0
4811,2022-02-09,IBM,123.9827737304888,124.4415115936038,123.07431520076628,123.93779754638672,5393500.0,0.0,0.0,0.6925811767578125,0.0,0.6925811767578125,64.80705540118998,111.70504534332564,124.8642772155321,92.95946998926136,-7.040530010738635,1.6246233196608983,1.4755879107480543,0.03976728092193582,-49795344.0,1.0
4812,2022-02-10,IBM,123.31881306104052,124.3110405167011,121.22511228726214,121.5437240600586,5978600.0,1.64,0.0,-2.394073486328125,2.394073486328125,0.0,47.19581063588557,111.70504534332564,124.8642772155321,74.76636031859256,-25.23363968140744,1.4451497107621947,1.4695002707508826,0.004671530121613365,-55773944.0,-1.0
4813,2022-02-11,IBM,121.88962928292916,122.62698676258329,120.50597800708356,120.78816986083984,4176200.0,0.0,0.0,-0.75555419921875,0.75555419921875,0.0,42.94602708701198,115.401849955271,124.8642772155321,56.9232371084057,-43.076762891594306,1.2277954119920764,1.4211592989991215,0.005377824118111718,-59950144.0,-1.0
4814,2022-02-14,IBM,120.6971407426406,120.75175673158256,117.49288234359057,118.47599792480467,5345300.0,0.0,0.0,-2.3121719360351705,2.3121719360351705,0.0,32.58534960619269,117.49288234359057,124.8642772155321,13.33690025148751,-86.6630997485125,0.8590648478361231,1.308740408766522,-0.028128528802097263,-65295444.0,-1.0
4815,2022-02-15,IBM,118.92203779968676,119.86874724137944,117.98442639171486,118.28482818603516,4394000.0,0.0,0.0,-0.19116973876951704,0.19116973876951704,0.0,31.852267790046213,117.49288234359057,124.8642772155321,10.743500466364273,-89.25649953363572,0.5451334597455855,1.1560190189623347,-0.04185651247497535,-69689444.0,-1.0
4816,2022-02-16,IBM,117.83878051420172,118.7399859430706,116.75551717074796,117.5929946899414,4875600.0,0.0,0.0,-0.69183349609375,0.69183349609375,0.0,29.116958647250627,116.75551717074796,124.8642772155321,10.328058970398803,-89.6719410296012,0.23777447554473952,0.9723701102788157,-0.05112475381841164,-74565044.0,-1.0
4817,2022-02-17,IBM,116.56434851517376,116.97398225086734,113.6513735839117,113.76061248779295,6797000.0,0.0,0.0,-3.8323822021484517,3.8323822021484517,0.0,18.79866008541849,113.6513735839117,124.8642772155321,0.9742249418178778,-99.02577505818212,-0.31146062479022874,0.7156039632650067,-0.07783213447884418,-81362044.0,-1.0
4818,2022-02-18,IBM,113.733325983681,114.18847775157464,112.5226206142684,113.1962432861328,4609200.0,0.0,0.0,-0.5643692016601562,0.5643692016601562,0.0,17.730989098913923,112.5226206142684,124.8642772155321,5.458121981739627,-94.54187801826038,-0.7832445214837946,0.41583426631524645,-0.08300891406437494,-85971244.0,-1.0
4819,2022-02-22,IBM,113.05969344253016,113.78793903035024,111.67603515974952,112.8048095703125,5349700.0,0.0,0.0,-0.3914337158202983,0.3914337158202983,0.0,16.960117179167142,111.67603515974952,124.8642772155321,8.558945201252618,-91.44105479874737,-1.1751753976882355,0.09763233351455,-0.08471247085164124,-91320944.0,-1.0
4820,2022-02-23,IBM,113.22354156260856,113.5148383912548,110.93868488434671,111.12074279785156,4086400.0,0.0,0.0,-1.6840667724609375,1.6840667724609375,0.0,13.949492289475273,110.93868488434671,124.8642772155321,1.307362079652031,-98.69263792034798,-1.6031929446807567,-0.24253272212451144,-0.10341522120189417,-95407344.0,-1.0
4821,2022-02-24,IBM,109.23641001993388,111.14804580626996,108.15314673148242,111.02970886230467,6563200.0,0.0,0.0,-0.09103393554688921,0.09103393554688921,0.0,13.796737053780177,108.15314673148242,124.8642772155321,17.213450242446804,-82.78654975755319,-1.927526288952933,-0.5795314354901959,-0.08650397442617941,-101970544.0,-1.0
4822,2022-02-25,IBM,111.10255219568104,113.1143222284184,110.55636450402402,113.04149627685548,4460900.0,0.0,0.0,2.0117874145508097,0.0,2.0117874145508097,32.61324141098051,108.15314673148242,124.4415115936038,30.01129693957755,-69.98870306042245,-1.9991830322908584,-0.8634617548503285,-0.06413437336544892,-97509644.0,1.0
4823,2022-02-28,IBM,111.24817695570708,112.32233523851048,110.1831236514622,111.52127075195312,6757300.0,0.0,0.0,-1.520225524902358,1.520225524902358,0.0,27.398670578072768,108.15314673148242,124.4415115936038,20.67809782615614,-79.32190217384387,-2.153813194644229,-1.1215320428091087,-0.05870157073726978,-104266944.0,-1.0
4824,2022-03-01,IBM,111.66691698887466,112.32233655147556,109.87361817038712,110.46531677246094,4873300.0,0.0,0.0,-1.0559539794921875,1.0559539794921875,0.0,24.286429981078584,108.15314673148242,124.4415115936038,14.195224999873805,-85.8047750001262,-2.3346529476196736,-1.3641562237712217,-0.0661074757725979,-109140244.0,-1.0
4825,2022-03-02,IBM,111.59410141427196,113.4602263452727,110.87496776941636,112.75019073486328,4891400.0,0.0,0.0,2.2848739624023438,0.0,2.2848739624023438,41.01474799644044,108.15314673148242,124.3110405167011,28.45076260859109,-71.54923739140891,-2.2674616351709744,-1.5448173060511725,-0.04118275895470813,-104248844.0,1.0
4826,2022-03-03,IBM,113.75152596698364,115.30814413828676,113.096106327474,114.634521484375,5206600.0,0.0,0.0,1.8843307495117188,0.0,1.8843307495117188,51.26164190180045,108.15314673148242,122.62698676258329,44.77992529256669,-55.22007470743331,-2.0386618675059935,-1.643586218342137,0.007681999749041601,-99042244.0,1.0
4827,2022-03-04,IBM,113.24175935042334,115.9271519581383,113.06879945909051,115.26263427734376,4402400.0,0.0,0.0,0.6281127929687642,0.0,0.6281127929687642,54.3141638065666,108.15314673148242,120.75175673158256,56.43072962656065,-43.569270373439345,-1.786064312574311,-1.672081837188572,0.018254943196194473,-94639844.0,1.0
4828,2022-03-07,IBM,115.12608568256782,116.43692495553609,114.35232909035471,114.761962890625,5047400.0,0.0,0.0,-0.5006713867187642,0.5006713867187642,0.0,51.35587179566105,108.15314673148242,119.86874724137944,56.4103918835371,-43.5896081164629,-1.6077458338609745,-1.6592146365230525,0.017349910236695854,-99687244.0,-1.0
4829,2022-03-08,IBM,115.26263178819885,116.83745990063912,113.62408270849588,114.40694427490234,4887600.0,0.0,0.0,-0.35501861572265625,0.35501861572265625,0.0,49.164935850722955,108.15314673148242,118.7399859430706,59.07143216621844,-40.92856783378156,-1.478036307532264,-1.622978970724895,0.029573249730961315,-104574844.0,-1.0
4830,2022-03-09,IBM,115.98176182503428,116.60987340589654,114.61630669798691,114.89849853515624,4403500.0,0.0,0.0,0.49155426025389204,0.0,0.49155426025389204,52.40860293197578,108.15314673148242,116.97398225086734,76.47066753313833,-23.529332466861675,-1.3203560105019676,-1.5624543786803096,0.03484463494045098,-100171344.0,1.0
4831,2022-03-10,IBM,114.47066962524794,114.725553504058,112.085671861262,113.1962432861328,5326800.0,0.0,0.0,-1.7022552490234375,1.7022552490234375,0.0,41.761135496556044,108.15314673148242,116.83745990063912,58.07133455943867,-41.92866544056133,-1.317562965622514,-1.5134760960687506,0.001368939852833373,-105498144.0,-1.0
4832,2022-03-11,IBM,113.78792578758144,115.39915976090548,112.79569840834436,112.8412094116211,4119600.0,0.0,0.0,-0.35503387451170454,0.35503387451170454,0.0,39.81452828035897,108.15314673148242,116.83745990063912,53.98311402206046,-46.016885977939545,-1.3286815105854544,-1.4765171789720914,0.011835756988492374,-109617744.0,-1.0
4833,2022-03-14,IBM,113.28727073163834,113.93359234503788,111.68514153058226,112.8230209350586,3289200.0,0.0,0.0,-0.0181884765625,0.0181884765625,0.0,39.70512583069607,108.15314673148242,116.83745990063912,53.77367343409205,-46.22632656590795,-1.3237018842783783,-1.445954120033349,0.021343388418050724,-112906944.0,-1.0
4834,2022-03-15,IBM,112.87762448683456,114.64361535042002,112.16758892788567,114.37052154541016,4021200.0,0.0,0.0,1.5475006103515625,0.0,1.5475006103515625,52.514522910907964,108.15314673148242,116.83745990063912,71.59316681495818,-28.406833185041826,-1.1812682037615616,-1.3930169367789917,0.014370980660752597,-108885744.0,1.0
4835,2022-03-16,IBM,115.1533861713742,115.86342174960008,113.52394216605536,115.64495086669922,4292800.0,0.0,0.0,1.2744293212890625,0.0,1.2744293212890625,60.49048111244201,109.87361817038712,116.83745990063912,82.8757016581888,-17.124298341811194,-0.9545492409317404,-1.3053233976095415,0.008814355128284213,-104592944.0,1.0
4836,2022-03-17,IBM,115.69957555402172,116.78283201597422,115.18070282743776,116.48243713378906,3671900.0,0.0,0.0,0.8374862670898438,0.0,0.8374862670898438,64.95393608950303,109.87361817038712,116.83745990063912,94.90191218292941,-5.0980878170705966,-0.6992343485658097,-1.1841055878007951,0.010582812583566525,-100921044.0,1.0
4837,2022-03-18,IBM,115.95444662796044,117.365412755699,115.03504517826148,117.21066284179688,7466000.0,0.0,0.0,0.7282257080078125,0.0,0.7282257080078125,68.5218534663356,109.87361817038712,117.365412755699,97.9344079427175,-2.065592057282501,-0.43314075136036934,-1.03391262051271,0.02133720868390543,-93455044.0,1.0
4838,2022-03-21,IBM,117.42914609628735,118.10277565573556,115.972661952323,116.60987854003906,3384600.0,0.0,0.0,-0.6007843017578125,0.6007843017578125,0.0,62.467978222980264,110.87496776941636,118.10277565573556,79.3450913585812,-20.6549086414188,-0.26765259811899966,-0.880660616033968,0.019255249575090616,-96839644.0,-1.0
4839,2022-03-22,IBM,116.97399692317732,117.70224248360418,116.38229827346356,117.4837646484375,2690200.0,0.0,0.0,0.8738861083984375,0.0,0.8738861083984375,67.31463115948836,111.68514153058226,118.10277565573556,90.3545294850652,-9.645470514934809,-0.06523475319306726,-0.7175754434657878,0.022500434263640345,-94149444.0,1.0
4840,2022-03-23,IBM,117.5019667062307,117.72044452670664,116.74641320347862,116.79193115234376,2924500.0,0.0,0.0,-0.6918334960937358,0.6918334960937358,0.0,60.21202327843872,111.68514153058226,118.10277565573556,79.57433412643356,-20.42566587356644,0.038909145601181194,-0.566278525652394,0.03176508125911859,-97073944.0,-1.0
4841,2022-03-24,IBM,116.8192455002577,117.76595499357876,116.33678577431591,117.65672302246094,2971100.0,0.0,0.0,0.8647918701171733,0.0,0.8647918701171733,65.46731296835102,111.68514153058226,118.10277565573556,93.04957832472316,-6.9504216752768455,0.1890462052857913,-0.4152135794647569,0.04267513292306058,-94102844.0,1.0
4842,2022-03-25,IBM,117.8842849756173,119.61385580144818,117.71132511500883,119.56835174560548,3530200.0,0.0,0.0,1.9116287231445455,0.0,1.9116287231445455,74.16933605187819,111.68514153058226,119.61385580144818,99.42608531108374,-0.5739146889162524,0.4570151820384183,-0.24076782716412184,0.05978683033518073,-90572644.0,1.0
4843,2022-03-28,IBM,119.08591294438456,119.70491266963464,117.97534154072588,119.67760467529295,2483500.0,0.0,0.0,0.10925292968747158,0.0,0.10925292968747158,74.5915623415317,111.68514153058226,119.70491266963464,99.65949160059311,-0.34050839940689265,0.6704695692465776,-0.058520347881981905,0.04640254375141284,-88089144.0,1.0
4844,2022-03-29,IBM,120.19646024244834,120.92470577330104,118.73087114677875,120.10543823242188,5791000.0,0.0,0.0,0.42783355712892046,0.0,0.42783355712892046,76.33911528365677,111.68514153058226,120.92470577330104,91.13305000801539,-8.86694999198462,0.8641944062974858,0.1260226029539117,0.03857053275818445,-82298144.0,1.0
4845,2022-03-30,IBM,120.16915837206344,121.14318977085009,119.60477465471276,120.27840423583984,2622900.0,0.0,0.0,0.17296600341796875,0.0,0.17296600341796875,77.0746483442959,111.68514153058226,121.14318977085009,90.85661742209771,-9.14338257790228,1.0199226133046437,0.3048026050240582,0.03258832142815504,-79675244.0,1.0
4846,2022-03-31,IBM,118.99487569328652,120.05083109634232,118.33945605622633,118.357666015625,4274000.0,0.0,0.0,-1.9207382202148438,1.9207382202148438,0.0,55.11966462113555,111.68514153058226,121.14318977085009,70.54864085630625,-29.451359143693757,0.9770875600503359,0.4392595960293138,0.009785826186959445,-83949244.0,-1.0
4847,2022-04-01,IBM,118.02995808835908,118.58524379281803,116.57346689596945,118.47599792480467,4012400.0,0.0,0.0,0.11833190917967329,0.0,0.11833190917967329,56.01040900233718,112.16758892788567,121.14318977085009,70.28397437998694,-29.716025620013053,0.9418320146711068,0.5397740797576724,0.016003098606477417,-79936844.0,1.0
4848,2022-04-04,IBM,118.57611604261471,118.74907591126716,117.36541085217536,118.5852279663086,2809800.0,0.0,0.0,0.10923004150392046,0.0,0.10923004150392046,56.921056247481,113.52394216605536,121.14318977085009,66.4276325272355,-33.572367472764505,0.9121905278452971,0.6142573693751974,0.009375451332932272,-77127044.0,1.0
4849,2022-04-05,IBM,118.20291511141107,119.45912449697732,117.11965172325397,117.32901763916016,3107200.0,0.0,0.0,-1.2562103271484375,1.2562103271484375,0.0,44.65425630895293,115.03504517826148,121.14318977085009,37.55596198037116,-62.444038019628834,0.778361296652605,0.647078154830679,0.004598660896494744,-80234244.0,-1.0
4850,2022-04-06,IBM,116.31857529883617,117.89339639934332,115.83611557503842,117.78416442871094,3958100.0,0.0,0.0,0.45514678955078125,0.0,0.45514678955078125,49.2284619288799,115.03504517826148,121.14318977085009,45.00743570781107,-54.99256429218893,0.7009471266891296,0.6578519492023692,0.0010831629759540107,-76276144.0,1.0
4851,2022-04-07,IBM,117.31079058731082,117.65671031198556,115.3627488804928,117.01950073242188,3538300.0,0.0,0.0,-0.7646636962890625,0.7646636962890625,0.0,42.43053005963024,115.3627488804928,121.14318977085009,28.661340602804273,-71.33865939719573,0.5713081844019285,0.6405431962422812,-0.021317104200002324,-79814444.0,-1.0
4852,2022-04-08,IBM,116.52794821756244,117.22888581492978,115.854325559561,116.2730712890625,3143300.0,0.0,0.0,-0.746429443359375,0.746429443359375,0.0,36.71939700390803,115.3627488804928,121.14318977085009,15.748321379572689,-84.25167862042731,0.4036843488445214,0.5931714267627293,-0.0284475394997048,-82957744.0,-1.0
4853,2022-04-11,IBM,116.4733236107496,116.68268951494406,114.86208956061353,115.03504943847656,3202500.0,0.0,0.0,-1.2380218505859375,1.2380218505859375,0.0,29.198194624772498,114.86208956061353,121.14318977085009,2.7536557621092643,-97.24634423789074,0.1689951636876259,0.5083361741477086,-0.042216146650523534,-86160244.0,-1.0
4854,2022-04-12,IBM,115.0805672711332,115.91804482772312,114.3159156616549,114.68003845214844,2691000.0,0.0,0.0,-0.355010986328125,0.355010986328125,0.0,27.344959957030213,114.3159156616549,121.14318977085009,5.333355372433738,-94.66664462756627,-0.04512396505906224,0.3976441463063544,-0.04654506201058528,-88851244.0,-1.0
4855,2022-04-13,IBM,114.37052424198365,115.30813567885932,113.70600661655672,114.82567596435548,3064900.0,0.0,0.0,0.14563751220704546,0.0,0.14563751220704546,29.464120541094644,113.70600661655672,121.14318977085009,15.055019145957099,-84.9449808540429,-0.20074907674938913,0.27796550169520573,-0.02984166695888746,-85786344.0,1.0
4856,2022-04-14,IBM,117.36541487307088,118.86742387062051,115.0441452874695,115.20800018310548,6384200.0,0.0,0.0,0.38232421875,0.0,0.38232421875,35.190053379376025,113.70600661655672,121.14318977085009,20.195731843469336,-79.80426815653067,-0.28989104621616946,0.16439419211293066,-0.027583627054767246,-79402144.0,1.0
4857,2022-04-18,IBM,115.24441997367911,115.96356056124584,114.2703955211651,114.85298919677734,4884200.0,0.0,0.0,-0.3550109863281392,0.3550109863281392,0.0,32.37430103158036,113.70600661655672,121.14318977085009,15.422271529759069,-84.57772847024093,-0.3847479836397838,0.054565756962387746,-0.0314730496667901,-84286344.0,-1.0
4858,2022-04-19,IBM,114.77106462140392,117.79326495730308,114.69823867606398,117.56568908691406,7971400.0,0.0,0.0,2.7126998901367188,0.0,2.7126998901367188,60.34790910067486,113.70600661655672,121.14318977085009,51.89710123152218,-48.10289876847782,-0.2382837925660226,-0.004004152943294344,0.0020171603966017138,-76314944.0,1.0
4859,2022-04-20,IBM,122.89095597985204,127.0419371594178,121.41626895293452,125.91316986083984,17859200.0,0.0,0.0,8.347480773925781,0.0,8.347480773925781,83.93818285402774,113.70600661655672,127.0419371594178,91.53589398992332,-8.464106010076671,0.5450787412957254,0.10581242590450965,0.06901611495532567,-58455744.0,1.0
4860,2022-04-21,IBM,125.83122265440088,129.1538380700383,125.0301651868718,127.30592346191406,9922300.0,0.0,0.0,1.3927536010742188,0.0,1.3927536010742188,85.5887572045288,113.70600661655672,129.1538380700383,88.03770863445204,-11.96229136554796,1.263715444078855,0.33739302953937883,0.08790349185485957,-48533444.0,1.0
4861,2022-04-22,IBM,127.16936322453198,127.8429926404524,125.03015888784128,125.84942626953124,6508600.0,0.0,0.0,-1.4564971923828267,1.4564971923828267,0.0,76.14654249701044,113.70600661655672,129.1538380700383,78.60921896735015,-21.39078103264986,1.6961607720056975,0.6091465780326427,0.08236090157678277,-55042044.0,-1.0
4862,2022-04-25,IBM,125.24864763041528,127.12387050419316,123.063924919051,126.62321472167967,5748300.0,0.0,0.0,0.7737884521484375,0.0,0.7737884521484375,77.65749076975733,113.70600661655672,129.1538380700383,83.61826152765101,-16.38173847234898,2.0773684607578957,0.9027909545776935,0.10073595256201218,-49293744.0,1.0
4863,2022-04-26,IBM,126.53220171359143,127.32416140897136,123.95604083203142,123.97425079345705,4956200.0,0.0,0.0,-2.648963928222628,2.648963928222628,0.0,62.115691657563396,113.70600661655672,129.1538380700383,66.47045708532838,-33.52954291467163,2.141048376921944,1.1504424390465438,0.08104472641231908,-54249944.0,-1.0
4864,2022-04-27,IBM,123.60099144219332,124.82079463398304,122.55414811448804,122.94557189941406,4369100.0,0.0,0.0,-1.028678894042983,1.028678894042983,0.0,57.003888618548096,113.70600661655672,129.1538380700383,59.811406608627685,-40.188593391372315,2.084480782631985,1.337250107763632,0.07071498483996885,-58619044.0,-1.0
4865,2022-04-28,IBM,124.57502779955166,124.702469721945,122.7180010559596,123.56459045410156,4474300.0,0.0,0.0,0.6190185546875,0.0,0.6190185546875,59.32791456257333,113.70600661655672,129.1538380700383,63.818561635866075,-36.181438364133925,2.065787073147618,1.4829575008404294,0.07253480884760233,-54144744.0,1.0
4866,2022-04-29,IBM,123.00931124851104,123.39163703568468,120.16005696798956,120.35122680664062,5078700.0,0.0,0.0,-3.2133636474609375,3.2133636474609375,0.0,44.81791101167565,113.70600661655672,129.1538380700383,43.01717176352433,-56.98282823647567,1.771262570214006,1.540618514715145,0.04787195917420273,-59223444.0,-1.0
4867,2022-05-02,IBM,121.07036734756608,121.77130494249872,119.1496263776499,121.10677337646484,4213500.0,0.0,0.0,0.7555465698242188,0.0,0.7555465698242188,48.25155310794766,113.70600661655672,129.1538380700383,47.90812731349531,-52.09187268650469,1.5805959473293143,1.548614001237979,0.030120048774884722,-55009944.0,1.0
4868,2022-05-03,IBM,121.07035698219114,121.61654459981618,120.15095551232136,120.63341522216795,3688600.0,0.0,0.0,-0.4733581542968892,0.4733581542968892,0.0,46.17455483201368,113.70600661655672,129.1538380700383,44.84389039634403,-55.15610960365597,1.375440011708477,1.5139792033320787,-0.04193171091242576,-58698544.0,-1.0
4869,2022-05-04,IBM,120.95201761521538,125.50353496525892,120.28749997134506,125.07569122314452,5932600.0,0.0,0.0,4.4422760009765625,0.0,4.4422760009765625,63.28689856494905,114.2703955211651,129.1538380700383,72.59943837924429,-27.40056162075571,1.553400369784768,1.5218634366226167,-0.017518683955320857,-52765944.0,1.0
4870,2022-05-05,IBM,124.22000329722206,124.94823487710676,122.6724764646495,123.72843170166016,5957400.0,0.0,0.0,-1.3472595214843608,1.3472595214843608,0.0,56.95088665297854,114.2703955211651,129.1538380700383,63.5473691616535,-36.45263083834651,1.5676517384180215,1.5310210969816977,-0.01685343056970756,-58723344.0,-1.0
4871,2022-05-06,IBM,123.31882240493005,125.61279122854428,123.31882240493005,125.3214874267578,7306400.0,0.0,0.0,1.593055725097642,0.0,1.593055725097642,62.124439117650304,114.69823867606398,129.1538380700383,73.48881537988682,-26.51118462011318,1.688033731931469,1.5624236239716522,-0.010280321012091642,-51416944.0,1.0
4872,2022-05-09,IBM,123.83811391970416,125.62552733237932,122.83385019687078,123.86575317382812,7647900.0,1.65,0.0,-1.4557342529296733,1.4557342529296733,0.0,55.13773133355599,119.1496263776499,129.1538380700383,47.14141344856235,-52.85858655143765,1.646986308018171,1.5793361607809562,-0.0008751625352403369,-59064844.0,-1.0
4873,2022-05-10,IBM,124.38171597029022,124.7594712224922,118.32846571159612,118.97341918945312,8642400.0,0.0,0.0,-4.892333984375,4.892333984375,0.0,38.39391635875662,118.32846571159612,129.1538380700383,5.957794859167447,-94.04220514083256,1.2057859137995734,1.5046261113846797,-0.03230822101678199,-67707244.0,-1.0
4874,2022-05-11,IBM,119.6459832131893,122.50216122396044,119.6459832131893,120.46598052978516,5301100.0,0.0,0.0,1.4925613403320312,0.0,1.4925613403320312,44.343485629577145,118.32846571159612,127.8429926404524,22.465802390092986,-77.53419760990703,0.965439661560211,1.396788821419786,-0.025076843721400843,-62406144.0,1.0
4875,2022-05-12,IBM,120.94510719272594,123.11026210524852,120.15274897973394,122.44689178466795,5384800.0,0.0,0.0,1.9809112548827983,0.0,1.9809112548827983,51.51412526175892,118.32846571159612,127.32416140897136,45.78218529861458,-54.21781470138542,0.9241534425421207,1.3022617456442531,0.017412909146279576,-57021344.0,1.0
4876,2022-05-13,IBM,122.5390141863331,123.27609377511853,120.74239235397256,123.09182739257812,4195100.0,0.0,0.0,0.6449356079101705,0.0,0.6449356079101705,53.752483291279056,118.32846571159612,127.32416140897136,52.95156529552075,-47.04843470447925,0.9327228813493633,1.2283539727852752,0.01639094132202379,-52826244.0,1.0
4877,2022-05-16,IBM,122.63114900657249,125.77292794588398,121.99541806497372,124.40933990478516,4250400.0,0.0,0.0,1.3175125122070312,0.0,1.3175125122070312,58.291155106031965,118.32846571159612,125.77292794588398,81.68318948790713,-18.31681051209288,1.033908221772137,1.1894648225826476,0.03130081889552039,-48575844.0,1.0
4878,2022-05-17,IBM,126.39943671035834,127.4866180419922,124.97134786164504,127.4866180419922,4372900.0,0.0,0.0,3.0772781372070455,0.0,3.0772781372070455,67.01514020100358,118.32846571159612,127.4866180419922,100.0,-0.0,1.3468829328005398,1.2209484446262262,0.019275742514557992,-44202944.0,1.0
4879,2022-05-18,IBM,126.31654456538467,126.79563437205763,121.77430139068596,122.4837417602539,6003000.0,0.0,0.0,-5.0028762817382955,5.0028762817382955,0.0,48.13052093993011,118.32846571159612,127.4866180419922,45.3724277425081,-54.6275722574919,1.1776521006436838,1.2122891758297178,-0.010059853861297707,-50205944.0,-1.0
4880,2022-05-19,IBM,121.61766178305406,121.9124992264248,118.58643988349785,119.4617156982422,5819700.0,0.0,0.0,-3.0220260620117045,3.0220260620117045,0.0,40.22914912623036,118.32846571159612,127.4866180419922,12.37422075722414,-87.62577924277586,0.7905700009797414,1.1279453408597226,-0.046757917168356644,-56025644.0,-1.0
4881,2022-05-20,IBM,119.94081232392232,120.1158703086201,115.90532651171996,118.37452697753906,6914500.0,0.0,0.0,-1.0871887207031392,1.0871887207031392,0.0,37.662614980996295,115.90532651171996,127.4866180419922,21.320596751794714,-78.67940324820528,0.39156389958034765,0.9806690526038476,-0.044332077717905594,-62940144.0,-1.0
4882,2022-05-23,IBM,119.31431247562196,121.5716074674898,119.24060310520431,120.85295867919922,3591500.0,0.0,0.0,2.4784317016601562,0.0,2.4784317016601562,46.620414187877586,115.90532651171996,127.4866180419922,42.720901676179054,-57.279098323820946,0.27219966642742577,0.8389751753685633,0.015797978258934586,-59348644.0,1.0
4883,2022-05-24,IBM,120.30014900840388,123.80125241716097,120.16193867892748,123.27609252929688,4189700.0,0.0,0.0,2.4231338500976562,0.0,2.4231338500976562,54.066538369096484,115.90532651171996,127.4866180419922,63.64373091127643,-36.35626908872357,0.36887711662679123,0.7449555636202089,0.023327017197331656,-55158944.0,1.0
4884,2022-05-25,IBM,122.41003619381463,124.2158806291782,122.41003619381463,123.81969451904295,3299300.0,0.0,0.0,0.5436019897460795,0.0,0.5436019897460795,55.667314695978995,115.90532651171996,127.4866180419922,68.33752510793543,-31.662474892064562,0.48378209113164417,0.692720869122496,0.011211413490096467,-51859644.0,1.0
4885,2022-05-26,IBM,124.3817035871252,126.7311385777178,123.93946146634111,126.123046875,3929300.0,0.0,0.0,2.3033523559570455,0.0,2.3033523559570455,62.121246912568914,115.90532651171996,127.4866180419922,88.22608719046599,-11.773912809534021,0.7520373777159932,0.7045841708411955,0.02462567618526257,-47930344.0,1.0
4886,2022-05-27,IBM,126.58370696172685,128.74887535307414,126.44551070637368,128.3158416748047,4608000.0,0.0,0.0,2.1927947998046875,0.0,2.1927947998046875,67.34347515420025,115.90532651171996,128.74887535307414,96.62839544102364,-3.3716045589763612,1.1285624737113125,0.7893798314152191,0.03140038981807414,-43322344.0,1.0
4887,2022-05-31,IBM,127.33000925111544,128.8318076692848,126.04933892512936,127.91967010498048,7978100.0,0.0,0.0,-0.39617156982420454,0.39617156982420454,0.0,65.46206663086997,115.90532651171996,128.8318076692848,92.94365146101244,-7.05634853898757,1.3790962274116083,0.907323110614497,0.0033968432894315725,-51300444.0,-1.0
4888,2022-06-01,IBM,128.684384921213,129.42146448017468,127.62484272050904,128.4632568359375,3796500.0,0.0,0.0,0.543586730957017,0.0,0.543586730957017,66.92498818548368,115.90532651171996,129.42146448017468,92.91064025483067,-7.089359745169338,1.6030302041202162,1.046464529315641,0.048818847218006445,-47503944.0,1.0
4889,2022-06-02,IBM,128.481708502643,129.25563583853392,126.08621712127218,129.12664794921875,3734800.0,0.0,0.0,0.66339111328125,0.0,0.66339111328125,68.78670255845125,115.90532651171996,129.42146448017468,97.81878128468354,-2.1812187153164526,1.8131289903032979,1.1997974215131724,0.08090401342795017,-43769144.0,1.0
4890,2022-06-03,IBM,129.22797075958266,131.3654999938473,128.74888101421112,130.0756072998047,4352200.0,0.0,0.0,0.9489593505859375,0.0,0.9489593505859375,71.44006247164937,115.90532651171996,131.3654999938473,91.6566738689331,-8.34332613106691,2.0327743237948823,1.3663928019695144,0.09884795843353911,-39416944.0,1.0
4891,2022-06-06,IBM,131.7340481626084,133.3464036750807,130.83113301203872,131.6419219970703,4766900.0,0.0,0.0,1.566314697265625,0.0,1.566314697265625,75.41953828387754,115.90532651171996,133.3464036750807,90.22719948977083,-9.772800510229175,2.3066437851579593,1.5544429986072035,0.08927347278695996,-34650044.0,1.0
4892,2022-06-07,IBM,131.38396912547003,131.7340711092978,129.8729619729251,131.5498046875,2887100.0,0.0,0.0,-0.0921173095703125,0.0921173095703125,0.0,74.71309794576285,115.90532651171996,133.3464036750807,89.69903652880517,-10.300963471194839,2.4875789477398484,1.7410701884337327,0.06711530182737468,-37537144.0,-1.0
4893,2022-06-08,IBM,130.89563266781946,131.5682113098615,129.1266359802888,129.75315856933594,3005700.0,0.0,0.0,-1.7966461181640625,1.7966461181640625,0.0,61.705806822672,115.90532651171996,133.3464036750807,79.39780283012995,-20.602197169870053,2.4576665905047292,1.8843894688479323,0.047920196163789175,-40542844.0,-1.0
4894,2022-06-09,IBM,129.1266379341971,129.94663532237874,127.08124866324974,127.10890197753906,3591000.0,0.0,0.0,-2.644256591796875,2.644256591796875,0.0,47.62533723580018,115.90532651171996,133.3464036750807,64.23671749675509,-35.76328250324491,2.195285538732662,1.9465686828248785,0.007816613433991426,-44133844.0,-1.0
4895,2022-06-10,IBM,126.96147885725264,126.96147885725264,124.61204379649958,125.47811126708984,4659500.0,0.0,0.0,-1.6307907104492188,1.6307907104492188,0.0,40.97224684201316,119.24060310520431,133.3464036750807,44.219455187861016,-55.780544812138984,1.8346072729639218,1.9241764008526872,-0.022115199266717234,-48793344.0,-1.0
4896,2022-06-13,IBM,123.43271370166563,126.74956462837014,123.2392248731816,124.48304748535156,6486000.0,0.0,0.0,-0.9950637817382812,0.9950637817382812,0.0,37.3033631424445,120.16193867892748,133.3464036750807,32.77424459532362,-67.22575540467638,1.4517390733430346,1.8296889353507566,-0.026865474377854248,-55279344.0,-1.0
4897,2022-06-14,IBM,124.38169665995318,126.17831835553906,124.2527087961322,125.0450668334961,4607800.0,0.0,0.0,0.5620193481445312,0.0,0.5620193481445312,40.760403962199824,122.41003619381463,133.3464036750807,24.09420352960207,-75.90579647039792,1.1800605279268837,1.6997632538659821,-0.026608308761833954,-50671544.0,1.0
4898,2022-06-15,IBM,125.31223953675492,127.56032558011108,124.91606758349567,126.27965545654295,4606900.0,0.0,0.0,1.2345886230468608,0.0,1.2345886230468608,48.024445281439235,123.2392248731816,133.3464036750807,30.08189172224867,-69.91810827775133,1.0522446856025596,1.5702595402132977,-0.022048063183638278,-46064644.0,1.0
4899,2022-06-16,IBM,124.6581070542124,125.52417447719108,123.8196788844247,124.9990005493164,5386400.0,0.0,0.0,-1.2806549072265483,1.2806549072265483,0.0,41.878174201513936,123.2392248731816,133.3464036750807,17.411146182594038,-82.58885381740596,0.8379521705486042,1.423798066280359,-0.0390281226117013,-51451044.0,-1.0
4900,2022-06-17,IBM,125.29383021688167,126.20595363280717,122.4008047406271,124.4001235961914,12968500.0,0.0,0.0,-0.598876953125,0.598876953125,0.0,39.17303298841532,122.4008047406271,133.3464036750807,18.26596120995289,-81.73403879004711,0.6127362018604714,1.2615856933963816,-0.05501133902496558,-64419544.0,-1.0
4901,2022-06-21,IBM,125.21091713420569,127.60642238362972,125.21091713420569,127.00755310058594,4089300.0,0.0,0.0,2.6074295043945312,0.0,2.6074295043945312,54.07579408493291,122.4008047406271,133.3464036750807,42.08767731711897,-57.91232268288103,0.6373022700267654,1.1367290087224584,-0.03452875964129554,-60330244.0,1.0
4902,2022-06-22,IBM,125.39519582122507,127.31158312348865,125.33069485329234,126.29811096191406,3791500.0,0.0,0.0,-0.709442138671875,0.709442138671875,0.0,50.21351615146796,122.4008047406271,133.3464036750807,35.60614859566403,-64.39385140433596,0.5926928107185461,1.027921769121676,-0.026627849722637875,-64121744.0,-1.0
4903,2022-06-23,IBM,126.3533872447762,127.71697535994774,125.76372637940815,127.55113983154295,4547900.0,0.0,0.0,1.253028869628892,0.0,1.253028869628892,56.53949059333826,122.4008047406271,133.3464036750807,47.05393575772346,-52.94606424227655,0.6509447645560726,0.9525263682085553,0.0034792044233222796,-59573844.0,1.0
4904,2022-06-24,IBM,128.25136339019636,131.17202859152414,128.18687647917156,130.88641357421875,11493000.0,0.0,0.0,3.3352737426757955,0.0,3.3352737426757955,68.73889476445177,122.4008047406271,133.3464036750807,77.52530386328516,-22.47469613671484,0.9552273088353189,0.9530665563339081,0.04310155972635665,-48080844.0,1.0
4905,2022-06-27,IBM,131.07067209252443,132.51719200762008,130.78505709237783,131.56820678710938,3936000.0,0.0,0.0,0.681793212890625,0.0,0.681793212890625,70.68011649289805,122.4008047406271,132.51719200762008,90.61932688552773,-9.380673114472268,1.237127594881997,1.009878764043526,0.05691666009856933,-44144844.0,1.0
4906,2022-06-28,IBM,131.67877298036356,132.8212471191873,130.20462776686895,130.7021484375,4064800.0,0.0,0.0,-0.866058349609375,0.866058349609375,0.0,64.78381451696532,122.4008047406271,132.8212471191873,79.66402380337246,-20.335976196627545,1.3748040464325726,1.0828638205213355,0.04524034212030603,-48209644.0,-1.0
4907,2022-06-29,IBM,131.51290903809428,132.2315576619127,128.5277434831874,129.642578125,4161500.0,0.0,0.0,-1.0595703125,1.0595703125,0.0,57.95839504806394,122.4008047406271,132.8212471191873,69.49583445010623,-30.504165549893774,1.3824788021040177,1.1427868168378719,0.026630755811765328,-52371144.0,-1.0
4908,2022-06-30,IBM,128.6014713032513,131.25495217752817,128.32506470241017,130.0848388671875,4878000.0,0.0,0.0,0.4422607421875,0.0,0.4422607421875,59.988614287502706,122.4008047406271,132.8212471191873,73.73999919974719,-26.260000800252815,1.4080171023390022,1.1958328739380981,0.040687031860423106,-47493144.0,1.0
4909,2022-07-01,IBM,129.90978294717812,130.52708306563693,128.30663588374662,130.0203399658203,4011900.0,0.0,0.0,-0.0644989013671875,0.0644989013671875,0.0,59.50506646687452,122.4008047406271,132.8212471191873,73.12103410187483,-26.878965898125166,1.4068347516751487,1.2380332494855084,0.04517854329367377,-51505044.0,-1.0
4910,2022-07-05,IBM,128.9607923620067,128.9607923620067,124.63046925521036,126.79562377929688,6273400.0,0.0,0.0,-3.2247161865234375,3.2247161865234375,0.0,40.61765226496449,122.4008047406271,132.8212471191873,42.17497567773142,-57.82502432226858,1.1326337868263607,1.216953356953679,-0.0016686355741474257,-57778444.0,-1.0
4911,2022-07-06,IBM,127.14575016540115,128.1960840609443,126.34418363050956,127.2194595336914,3237000.0,0.0,0.0,0.42383575439453125,0.0,0.42383575439453125,43.344821996430916,122.4008047406271,132.8212471191873,46.24232463468706,-53.75767536531294,0.9387067231293003,1.1613040301888033,0.007295030501724531,-54541444.0,1.0
4912,2022-07-07,IBM,127.98417594042952,130.20462316940487,127.91046657356372,129.75315856933594,3897100.0,0.0,0.0,2.5336990356445312,0.0,2.5336990356445312,56.97451135865853,122.4008047406271,132.8212471191873,70.55702206881476,-29.442977931185244,0.9781904940376478,1.1246813229585724,0.017263810740548502,-50644344.0,1.0
4913,2022-07-08,IBM,129.68866243503504,130.20462802232643,128.82260897398734,129.42147827148438,2820800.0,0.0,0.0,-0.3316802978515625,0.3316802978515625,0.0,54.9767750397192,122.4008047406271,132.8212471191873,67.37404493788233,-32.625955062117676,0.9715187751880876,1.0940488134044755,-0.011192416865358545,-53465144.0,-1.0
4914,2022-07-11,IBM,129.5596740494172,130.71135658522448,129.10822349290055,129.9097900390625,3904700.0,0.0,0.0,0.488311767578125,0.0,0.488311767578125,57.50777671816045,124.63046925521036,132.8212471191873,64.45444952268346,-35.545550477316546,0.994173851278731,1.0740738209793266,-0.012604996211055486,-49560444.0,1.0
4915,2022-07-12,IBM,129.76234765922638,130.41650940617916,127.67090267744696,128.23291015625,3235400.0,0.0,0.0,-1.6768798828125,1.6768798828125,0.0,47.03168991354983,124.63046925521036,132.8212471191873,43.981670127854265,-56.018329872145735,0.8668257424498336,1.032624205273428,-0.018892101704286457,-52795844.0,-1.0
4916,2022-07-13,IBM,126.39022827148438,127.97494440006513,126.04012637700018,126.39022827148438,4123200.0,0.0,0.0,-1.842681884765625,1.842681884765625,0.0,38.20679674020598,124.63046925521036,132.8212471191873,21.4846385227152,-78.5153614772848,0.6101786607655271,0.9481350963718478,-0.025087050107718056,-56919044.0,-1.0
4917,2022-07-14,IBM,124.93449636876124,128.46323841866823,124.40011411659188,128.12234497070312,5298400.0,0.0,0.0,1.73211669921875,0.0,1.73211669921875,48.65600169319219,124.40011411659188,132.8212471191873,44.20106953499067,-55.798930465009335,0.5403228358990901,0.8665726442772964,-0.01508626150114245,-51620644.0,1.0
4918,2022-07-15,IBM,129.61495180328723,129.61495180328723,127.70777284563545,128.91473388671875,4519300.0,0.0,0.0,0.792388916015625,0.0,0.792388916015625,52.863367218227715,124.40011411659188,132.8212471191873,53.61059810758783,-46.38940189241217,0.5426454754049956,0.8017872105028363,-0.008503331704810213,-47101344.0,1.0
4919,2022-07-18,IBM,129.12665007330398,129.27406882312502,126.94306431875488,127.26554107666016,8231700.0,0.0,0.0,-1.6491928100585938,1.6491928100585938,0.0,44.170988755553374,124.40011411659188,132.8212471191873,34.026620398765175,-65.97337960123483,0.40672167278637517,0.7227741029595441,0.003706100284511571,-55333044.0,-1.0
4920,2022-07-19,IBM,121.23070904520328,122.1336241938394,117.6743129029637,120.58576965332033,29690500.0,0.0,0.0,-6.6797714233398295,6.6797714233398295,0.0,24.977077032353606,117.6743129029637,132.2315576619127,20.0000535717229,-79.9999464282771,-0.23726559862325303,0.5307661626429847,-0.052143672868019686,-85023544.0,-1.0
4921,2022-07-20,IBM,120.41991236012863,120.43834321546775,117.98755962443462,119.01946258544922,9882000.0,0.0,0.0,-1.566307067871108,1.566307067871108,0.0,22.34948949953609,117.6743129029637,131.25495217752817,9.904906943555147,-90.09509305644485,-0.8640577215393535,0.251801385806517,-0.08272396681696947,-94905544.0,-1.0
4922,2022-07-21,IBM,118.6232992495712,118.67857776100662,115.28802414982697,117.1491470336914,11975400.0,0.0,0.0,-1.8703155517578125,1.8703155517578125,0.0,19.520152552422488,115.28802414982697,130.71135658522448,12.06693100638255,-87.93306899361745,-1.4944863208697967,-0.09745615552874586,-0.09482453300409377,-106880944.0,-1.0
4923,2022-07-22,IBM,117.03857733737168,118.22712151041404,115.82240093925644,118.1626205444336,6467200.0,0.0,0.0,1.0134735107421875,0.0,1.0134735107421875,25.42307351120334,115.28802414982697,130.71135658522448,18.637972089671415,-81.36202791032858,-1.8905337887661204,-0.45607168217622096,-0.0904255906432968,-100413744.0,1.0
4924,2022-07-25,IBM,118.3376834047744,118.97341439907196,117.84015571740836,118.4298095703125,4702400.0,0.0,0.0,0.26718902587890625,0.0,0.26718902587890625,27.05070118992934,115.28802414982697,130.71135658522448,20.37034106374404,-79.62965893625596,-2.1579686200818315,-0.7964510697573431,-0.07644761843112313,-95711344.0,1.0
4925,2022-07-26,IBM,118.17183223503028,119.13003994247686,117.59138678884348,118.00599670410156,3645300.0,0.0,0.0,-0.4238128662109375,0.4238128662109375,0.0,26.011684576410886,115.28802414982697,130.71135658522448,17.62247274160206,-82.37752725839795,-2.376713532860748,-1.1125035623780242,-0.06633607425230381,-99356644.0,-1.0
4926,2022-07-27,IBM,117.9046529372385,119.24981027224108,117.54532854680632,118.96419525146484,4175600.0,0.0,0.0,0.9581985473632812,0.0,0.9581985473632812,32.7502001831471,115.28802414982697,130.71135658522448,23.835128478465744,-76.16487152153425,-2.4445723293182624,-1.378917315766072,-0.07147972292680416,-95181044.0,1.0
4927,2022-07-28,IBM,118.62329408759126,119.59991857011704,118.4943062136468,119.05632781982422,3913700.0,0.0,0.0,0.092132568359375,0.0,0.092132568359375,33.422915703436075,115.28802414982697,130.71135658522448,24.43248685575083,-75.56751314424916,-2.4625300723224797,-1.5956398670773537,-0.07647229893487129,-91267344.0,1.0
4928,2022-07-29,IBM,119.33274638276576,120.69633462377963,119.13925752314628,120.50284576416016,5786800.0,0.0,0.0,1.4465179443359375,0.0,1.4465179443359375,43.63687394632094,115.28802414982697,130.41650940617916,34.47021645569952,-65.52978354430049,-2.333144763477648,-1.743140846357413,-0.05313846352506679,-85480544.0,1.0
4929,2022-08-01,IBM,120.46599554300964,122.26261752140984,120.41992542897374,121.65452575683594,4142100.0,0.0,0.0,1.1516799926757812,0.0,1.1516799926757812,50.59926792212701,115.28802414982697,129.61495180328723,44.43731245806441,-55.562687541935595,-2.1133140546994156,-1.8171754880258135,0.008863036713106842,-81338444.0,1.0
4930,2022-08-02,IBM,121.80193606513755,122.33631842198017,120.24485910545592,121.44261169433594,4403600.0,0.0,0.0,-0.2119140625,0.2119140625,0.0,49.30614319352636,115.28802414982697,129.61495180328723,42.95818121914301,-57.041818780857,-1.9339034923552276,-1.8405210888916965,0.020359267772252165,-85742044.0,-1.0
4931,2022-08-03,IBM,121.45182607572386,122.41001964793828,120.99115311514282,121.93091583251952,3088500.0,0.0,0.0,0.48830413818357954,0.0,0.48830413818357954,52.53151710971751,115.28802414982697,129.61495180328723,46.366477470751725,-53.63352252924828,-1.7323478385569047,-1.818886438824738,0.04081778587301965,-82653544.0,1.0
4932,2022-08-04,IBM,121.75586925668168,121.88485713537509,120.71475782816528,121.2859878540039,3179800.0,0.0,0.0,-0.6449279785156108,0.6449279785156108,0.0,47.88826213659676,115.28802414982697,129.27406882312502,42.88534638837642,-57.11465361162358,-1.6061392552226295,-1.7763370021043166,0.026432786402158515,-85833344.0,-1.0
4933,2022-08-05,IBM,120.92665443782798,122.23496398356816,120.76081891702388,122.05990600585938,2586500.0,0.0,0.0,0.7739181518554688,0.0,0.7739181518554688,53.570603840788664,115.28802414982697,122.41001964793828,95.08405134246777,-4.915948657532235,-1.427217244710448,-1.7065130506255428,0.030651881048509688,-83246844.0,1.0
4934,2022-08-08,IBM,122.63115973606794,122.86149623890908,121.63610435675932,122.17969512939452,3821200.0,0.0,0.0,0.11978912353514204,0.0,0.11978912353514204,54.45751230656337,115.28802414982697,122.86149623890908,90.99750944487604,-9.002490555123954,-1.26121577083957,-1.6174535946683484,0.03536852822622616,-79425644.0,1.0
4935,2022-08-09,IBM,121.20940784128152,122.02107343907484,120.46304163483586,120.78958129882812,3496000.0,1.65,0.0,-1.390113830566392,1.390113830566392,0.0,43.36548649570808,115.28802414982697,122.86149623890908,72.64246945508887,-27.357530544911125,-1.2276770781273711,-1.5394982913601531,0.015343995254242682,-82921644.0,-1.0
4936,2022-08-10,IBM,121.98377123350426,122.94471299613936,121.60125656487214,122.68348693847656,3664000.0,0.0,0.0,1.8939056396484375,0.0,1.8939056396484375,57.10126882949761,115.82240093925644,122.94471299613936,96.3322857019393,-3.6677142980607016,-1.0363289108381366,-1.43886441525575,0.03046590790320325,-79257644.0,1.0
4937,2022-08-11,IBM,123.48582263011272,124.29748825594136,123.14995853739885,123.65374755859376,3501900.0,0.0,0.0,0.9702606201172017,0.0,0.9702606201172017,62.48035954336665,117.54532854680632,124.29748825594136,90.46615120082727,-9.533848799172725,-0.7972025318889138,-1.3105320385823829,0.026147945091689717,-75755744.0,1.0
4938,2022-08-12,IBM,123.72840154037756,125.0998455759416,123.13131132484824,125.02520751953124,2766900.0,0.0,0.0,1.3714599609374716,0.0,1.3714599609374716,68.85061115282576,117.54532854680632,125.0998455759416,99.01200756947783,-0.9879924305221657,-0.4913636622454902,-1.1466983633150043,0.0277069985002667,-72988844.0,1.0
4939,2022-08-15,IBM,124.045622602138,126.12610691662805,123.37389429899028,125.88352966308594,2791200.0,0.0,0.0,0.8583221435547017,0.0,0.8583221435547017,72.25261687363911,117.54532854680632,126.12610691662805,97.17301574417486,-2.8269842558251344,-0.17767658583395018,-0.9528940078187934,0.03656803741941528,-70197644.0,1.0
4940,2022-08-16,IBM,125.57563835973023,128.15991118935978,125.43568669123788,127.40422058105467,4313600.0,0.0,0.0,1.5206909179687358,0.0,1.5206909179687358,77.31698084982618,118.4943062136468,128.15991118935978,92.18165225866414,-7.818347741335854,0.191423123737664,-0.7240305815075019,0.04488857244419542,-65884044.0,1.0
4941,2022-08-17,IBM,127.3109563185753,129.13953886470875,127.1616802066348,128.55177307128906,3667600.0,0.0,0.0,1.1475524902343892,0.0,1.1475524902343892,80.42747414675924,119.13925752314628,129.13953886470875,94.12250742409756,-5.877492575902448,0.569964996569027,-0.4652314658921961,0.059906221203649856,-62216444.0,1.0
4942,2022-08-18,IBM,128.55176186522797,129.7925927455301,128.51444995837215,129.74595642089844,3177700.0,0.0,0.0,1.194183349609375,0.0,1.194183349609375,83.19457106467249,120.24485910545592,129.7925927455301,99.51154560454097,-0.4884543954590345,0.9553105487952536,-0.1811230629547061,0.06296949314929101,-59038744.0,1.0
4943,2022-08-19,IBM,129.4473921331384,129.9978316813045,128.43047549620428,129.09286499023438,3155800.0,0.0,0.0,-0.6530914306640625,0.6530914306640625,0.0,76.3804392944792,120.24485910545592,129.9978316813045,90.72111928919911,-9.278880710800898,1.1942342656284097,0.09394840276191715,0.056581986503718706,-62194544.0,-1.0
4944,2022-08-22,IBM,128.42115535261715,128.60775760361977,126.38732178561676,126.4619598388672,3093600.0,0.0,0.0,-2.6309051513671733,2.6309051513671733,0.0,55.319669882637996,120.46304163483586,129.9978316813045,62.916101715875136,-37.083898284124864,1.1579429289569703,0.30674730800092787,0.04696082624879594,-65288144.0,-1.0
4945,2022-08-23,IBM,126.29401217792608,126.97507902968694,125.68759761015492,125.70626068115234,4141800.0,0.0,0.0,-0.755699157714858,0.755699157714858,0.0,50.68749874955684,120.46304163483586,129.9978316813045,54.99039853801918,-45.00960146198082,1.0560299212176858,0.4566038306442795,0.02463879873410879,-69429944.0,-1.0
4946,2022-08-24,IBM,125.8462004804406,126.05145155799876,124.1855430243807,124.29749298095705,2855400.0,0.0,0.0,-1.4087677001952983,1.4087677001952983,0.0,42.95141977810307,120.46304163483586,129.9978316813045,40.215372624186294,-59.784627375813706,0.8517686892557492,0.5356368023665735,0.005206032450073783,-72285344.0,-1.0
4947,2022-08-25,IBM,124.68932341722176,125.41702655600464,124.14822250746124,124.99720001220705,2706000.0,0.0,0.0,0.69970703125,0.0,0.69970703125,47.53994899404997,120.46304163483586,129.9978316813045,47.553835535691604,-52.446164464308396,0.7378452799350725,0.5760784978802733,-0.0002240148837170386,-69579344.0,1.0
4948,2022-08-26,IBM,125.10917913680002,125.1838029544186,121.6012618070978,121.63858795166016,4185300.0,0.0,0.0,-3.358612060546889,3.358612060546889,0.0,32.888881323184066,120.46304163483586,129.9978316813045,12.329021521136472,-87.67097847886353,0.3722570851252698,0.5353142153292726,-0.03372118435816762,-73764644.0,-1.0
4949,2022-08-29,IBM,121.27473473130176,122.60885254878424,120.8828956331093,121.57327270507812,2783000.0,0.0,0.0,-0.06531524658203125,0.06531524658203125,0.0,32.66300571027486,120.8828956331093,129.9978316813045,7.574129629856525,-92.42587037014347,0.07637500872216663,0.4435263740078514,-0.0457673054266432,-76547644.0,-1.0
4950,2022-08-30,IBM,121.80651076873242,122.00243743488214,120.62165482523852,120.89221954345705,2407900.0,0.0,0.0,-0.6810531616210795,0.6810531616210795,0.0,30.170070897350556,120.62165482523852,129.9978316813045,2.8856614201286086,-97.1143385798714,-0.21064083051184923,0.3126929331039112,-0.05958341409716983,-78955544.0,-1.0
4951,2022-08-31,IBM,121.20942619698845,121.28406425251116,119.79133161356349,119.83798217773438,3490400.0,0.0,0.0,-1.0542373657226705,1.0542373657226705,0.0,26.55067829414274,119.79133161356349,129.9978316813045,0.4570672009138028,-99.54293279908619,-0.5172090319578189,0.14671254009156517,-0.07636441640633795,-82445944.0,-1.0
4952,2022-09-01,IBM,119.79131882645252,121.11612637587272,119.17557272880956,120.96685028076172,3396200.0,0.0,0.0,1.1288681030273438,0.0,1.1288681030273438,36.03211326740186,119.17557272880956,129.9978316813045,16.551789786357006,-83.448210213643,-0.6614515173853022,-0.014920271403808343,-0.06294704753889668,-79049744.0,1.0
4953,2022-09-02,IBM,121.56393847438072,121.80650144822904,118.70909370314818,119.22222137451172,3040600.0,0.0,0.0,-1.74462890625,1.74462890625,0.0,29.289780703613843,118.70909370314818,129.9978316813045,4.545483050066676,-95.45451694993332,-0.906096778918112,-0.19315557290666913,-0.057248349413373534,-82090344.0,-1.0
4954,2022-09-06,IBM,119.23155315070056,119.47411612503902,117.83212180910958,118.22396087646484,3347100.0,0.0,0.0,-0.998260498046875,0.998260498046875,0.0,26.06918229471917,117.83212180910958,129.9978316813045,3.2208483637343956,-96.77915163626561,-1.1670778437362372,-0.38794002707258285,-0.05952209352297877,-85437444.0,-1.0
4955,2022-09-07,IBM,118.1959728318774,119.29685910012633,117.81345818373016,119.1475830078125,2401500.0,0.0,0.0,0.9236221313476562,0.0,0.9236221313476562,33.83595912896587,117.81345818373016,129.9978316813045,10.94947413051591,-89.05052586948409,-1.2845708972186003,-0.5672662011017865,-0.041432130686123614,-83035944.0,1.0
4956,2022-09-08,IBM,118.67177258604514,119.9219278100346,118.102669948893,119.85662841796876,2964600.0,0.0,0.0,0.7090454101562642,0.0,0.7090454101562642,39.468737635042615,117.81345818373016,129.9978316813045,16.76877547003428,-83.23122452996571,-1.3054228477439551,-0.7148975304302203,-0.04112549396095477,-80071344.0,1.0
4957,2022-09-09,IBM,120.25779376252945,120.80824757378396,119.47411563105912,120.52835845947266,3291900.0,0.0,0.0,0.671730041503892,0.0,0.671730041503892,44.622263733204775,117.81345818373016,128.60775760361977,25.151241133259745,-74.84875886674025,-1.2532979299131313,-0.8225776103268027,-0.009127280338281363,-76779444.0,1.0
4958,2022-09-12,IBM,121.59192655729642,122.20767976594578,121.18142441819684,121.8998031616211,3741100.0,0.0,0.0,1.3714447021484375,0.0,1.3714447021484375,53.87362269133633,117.81345818373016,126.97507902968694,44.60286063567371,-55.397139364326286,-1.0887737254023477,-0.8758168333419117,0.0026858737062633864,-73038344.0,1.0
4959,2022-09-13,IBM,120.48171254710893,121.20009131320114,118.270608388838,118.71842956542967,4565600.0,0.0,0.0,-3.1813735961914205,3.1813735961914205,0.0,37.22735717632969,117.81345818373016,126.05145155799876,10.985337576577717,-89.01466242342228,-1.2012501058903382,-0.940903487851597,-0.017981223160899673,-77603944.0,-1.0
4960,2022-09-14,IBM,118.95167317297243,120.35110462206625,118.34525145478986,119.12893676757812,3819100.0,0.0,0.0,0.4105072021484517,0.0,0.4105072021484517,39.98813693557059,117.81345818373016,125.41702655600464,17.300805614436253,-82.69919438556374,-1.2429361530426917,-1.001310020889816,-0.005916700175280343,-73784844.0,1.0
4961,2022-09-15,IBM,118.84903809522828,118.923676141482,116.525984069119,117.07642364501952,5141700.0,0.0,0.0,-2.052513122558608,2.052513122558608,0.0,31.89529526576318,116.525984069119,125.1838029544186,6.3577164548350895,-93.6422835451649,-1.4251648874768108,-1.086080994207215,-0.032161097248647796,-78926544.0,-1.0
4962,2022-09-16,IBM,116.02219028784504,118.97965353136708,115.52772567766404,118.7370834350586,9839700.0,0.0,0.0,1.6606597900390767,0.0,1.6606597900390767,42.717892484375476,115.52772567766404,122.60885254878424,45.322698149692236,-54.67730185030777,-1.4192212074152195,-1.152709036848816,-0.004069190574206516,-69086844.0,1.0
4963,2022-09-19,IBM,118.00938371561536,119.47412163599584,117.8134641729006,119.16625213623048,3981600.0,0.0,0.0,0.4291687011718892,0.0,0.4291687011718892,45.30945626083494,115.52772567766404,122.20767976594578,54.469333328941595,-45.53066667105841,-1.3641553371035116,-1.1949982968997552,0.007970391558359768,-65105244.0,1.0
4964,2022-09-20,IBM,118.39190158615448,118.47586405621394,117.10442010223164,117.8321304321289,2837500.0,0.0,0.0,-1.3341217041015767,1.3341217041015767,0.0,38.983338697084065,115.52772567766404,122.20767976594578,34.49731426309279,-65.50268573690721,-1.4118922944559529,-1.2383770964109948,-0.01104053093210744,-67942744.0,-1.0
4965,2022-09-21,IBM,118.3825752419144,119.26887901483448,116.54465405932848,116.55398559570312,3389500.0,0.0,0.0,-1.2781448364257812,1.2781448364257812,0.0,33.77108080974581,115.52772567766404,122.20767976594578,15.363278017724639,-84.63672198227536,-1.5351633756924628,-1.2977343522672884,-0.027554945152874932,-71332244.0,-1.0
4966,2022-09-22,IBM,116.395372482889,118.0280423959805,116.06883992384589,116.9084930419922,4046600.0,0.0,0.0,0.3545074462890767,0.0,0.3545074462890767,36.4887147884333,115.52772567766404,122.20767976594578,20.670312191970964,-79.32968780802904,-1.5859687470348547,-1.3553812312208018,-0.030033308872265296,-67285644.0,1.0
4967,2022-09-23,IBM,116.18078736227253,116.61927698258718,113.5778442458761,114.4828109741211,5195600.0,0.0,0.0,-2.425682067871108,2.425682067871108,0.0,27.56015556880851,113.5778442458761,122.20767976594578,10.486488718590225,-89.51351128140978,-1.8012015106571084,-1.4445452871080633,-0.06084498904125524,-72481244.0,-1.0
4968,2022-09-26,IBM,114.10030764774098,115.92889712400596,113.58717996297548,113.82975006103516,3987800.0,0.0,0.0,-0.6530609130859375,0.6530609130859375,0.0,25.613206928723855,113.5778442458761,122.20767976594578,2.919010618142447,-97.08098938185755,-2.0014006830784723,-1.5559163663021454,-0.04117877504183298,-76469044.0,-1.0
4969,2022-09-27,IBM,114.38018389663978,115.63967064747158,112.9620966395432,113.57784271240234,4117200.0,0.0,0.0,-0.2519073486328125,0.2519073486328125,0.0,24.83242977175111,112.9620966395432,122.20767976594578,6.659894399745918,-93.34010560025409,-2.155539074660453,-1.675840907973807,-0.04659736085789157,-80586244.0,-1.0
4970,2022-09-28,IBM,113.49388494380362,114.96795435420616,111.77724543751656,114.52946472167967,4996400.0,0.0,0.0,0.9516220092773295,0.0,0.9516220092773295,33.64868622623199,111.77724543751656,122.20767976594578,26.386430301005394,-73.61356969899461,-2.17582535707254,-1.7758377977935538,-0.0217546696768115,-75589844.0,1.0
4971,2022-09-29,IBM,113.6804784379402,114.39885722488134,112.48629808953952,113.47522735595705,3817700.0,0.0,0.0,-1.0542373657226278,1.0542373657226278,0.0,29.26162252741055,111.77724543751656,122.20767976594578,16.27911038960731,-83.72088961039269,-2.25102214475136,-1.870874667185115,-0.04431518719237737,-79407544.0,-1.0
4972,2022-09-30,IBM,113.50320916994396,114.22158075803674,110.65769606841468,110.8442840576172,5346100.0,0.0,0.0,-2.6309432983398438,2.6309432983398438,0.0,21.274555715809512,110.65769606841468,121.20009131320114,1.7698823167799125,-98.23011768322009,-2.4941601515496075,-1.9955317640580137,-0.06983494008941082,-84753644.0,-1.0
4973,2022-10-03,IBM,112.10378679879132,114.0163387525458,111.58132757536296,113.36327362060548,4261700.0,0.0,0.0,2.5189895629882812,0.0,2.5189895629882812,39.51383747087821,110.65769606841468,120.35110462206625,27.911518814211085,-72.08848118578891,-2.4552843780443254,-2.087482286855276,-0.03792562177340486,-80491944.0,1.0
4974,2022-10-04,IBM,114.56678085231717,117.22569895084888,114.3055476921822,117.08575439453124,4566100.0,0.0,0.0,3.722480773925753,0.0,3.722480773925753,56.642143609324336,110.65769606841468,119.47412163599584,72.91002772998094,-27.089972270019054,-2.099895668938757,-2.089964963271972,0.004562424837814438,-75925844.0,1.0
4975,2022-10-05,IBM,116.3487201555659,117.98139004384264,115.9009061150776,117.30966186523438,3212900.0,0.0,0.0,0.2239074707031392,0.0,0.2239074707031392,57.47785736749446,110.65769606841468,119.47412163599584,75.4496904196595,-24.550309580340503,-1.7796652220456792,-2.0279050150267137,0.00343147715622405,-72712944.0,1.0
4976,2022-10-06,IBM,116.50733458045578,116.89918081002936,113.605846034453,114.0350112915039,5074600.0,0.0,0.0,-3.2746505737304688,3.2746505737304688,0.0,43.37092163535983,110.65769606841468,119.47412163599584,38.30708031504215,-61.69291968495786,-1.7697170234151116,-1.9762674167043932,-0.003911501463031097,-77787544.0,-1.0
4977,2022-10-07,IBM,113.35394008273416,113.6338292016938,110.1539067570004,110.85362243652344,4499700.0,0.0,0.0,-3.1813888549804688,3.1813888549804688,0.0,34.013044783563956,110.1539067570004,119.26887901483448,7.676553035272823,-92.32344696472717,-1.9955411408578243,-1.9801221615350797,-0.026145428790943726,-82287244.0,-1.0
4978,2022-10-10,IBM,111.7585972068864,111.91719773066856,109.19297286453696,109.8553695678711,5990000.0,0.0,0.0,-0.9982528686523438,0.9982528686523438,0.0,31.54854003534942,109.19297286453696,119.26887901483448,6.574065830442248,-93.42593416955776,-2.2293603660874055,-2.029969802445545,-0.03277464209244718,-88277244.0,-1.0
4979,2022-10-11,IBM,109.58480753342188,111.23614057482156,109.09967444562508,109.90201568603516,4043100.0,0.0,0.0,0.0466461181640625,0.0,0.0466461181640625,31.814916819109754,109.09967444562508,118.0280423959805,8.986426689304764,-91.01357331069524,-2.383425192768854,-2.100660880510207,-0.040404004741397936,-84234144.0,1.0
4980,2022-10-12,IBM,110.08860194930156,110.84429261716538,109.342235699105,109.68743133544922,3338800.0,0.0,0.0,-0.2145843505859375,0.2145843505859375,0.0,31.17105074478428,109.09967444562508,117.98139004384264,6.617605386307239,-93.38239461369277,-2.494087552833605,-2.1793462149748866,-0.03337993770769021,-87572944.0,-1.0
4981,2022-10-13,IBM,108.3159991625205,113.96037585588896,107.8028785381359,113.62451171875,5837500.0,0.0,0.0,3.9370803833007812,0.0,3.9370803833007812,51.8152653315397,107.8028785381359,117.98139004384264,57.19532936962456,-42.80467063037545,-2.2382970915061264,-2.1911363902811347,0.025082282634327102,-81735444.0,1.0
4982,2022-10-14,IBM,113.63383038991276,114.32421454125593,111.80523379790748,111.99182891845705,3762400.0,0.0,0.0,-1.6326828002929545,1.6326828002929545,0.0,45.31220394028916,107.8028785381359,117.98139004384264,41.15484251280304,-58.84515748719695,-2.1426263028369448,-2.181434372792297,-0.012097786684762357,-85497844.0,-1.0
4983,2022-10-17,IBM,113.63382990838502,114.64141508357868,113.2886342752382,113.37259674072266,5458600.0,0.0,0.0,1.3807678222656108,0.0,1.3807678222656108,51.27902293277082,107.8028785381359,117.98139004384264,54.72036062899775,-45.27963937100225,-1.9331064420996,-2.131768786653758,-0.031713146257714264,-80039244.0,1.0
4984,2022-10-18,IBM,114.753370300792,115.63034955479478,113.65248402457344,114.69739532470705,5120300.0,0.0,0.0,1.3247985839843892,0.0,1.3247985839843892,56.529774162949266,107.8028785381359,117.98139004384264,67.73600228978107,-32.26399771021893,-1.6412410636872465,-2.0336632420604555,-0.02226812778241838,-74918944.0,1.0
4985,2022-10-19,IBM,114.15628956124964,115.630359074436,113.81109390526252,114.29623413085938,5906600.0,0.0,0.0,-0.40116119384767046,0.40116119384767046,0.0,54.478391428375645,107.8028785381359,117.98139004384264,63.79474630532054,-36.205253694679456,-1.4258694685578917,-1.9121044873599427,0.002290724895775309,-80825544.0,-1.0
4986,2022-10-20,IBM,117.78547708511704,120.31378943122964,116.7592288073566,119.69803619384766,13623100.0,0.0,0.0,5.401802062988281,0.0,5.401802062988281,70.89068047091229,107.8028785381359,120.31378943122964,95.07827013841263,-4.9217298615873615,-0.809968829530888,-1.6916773557941318,0.07978461653238877,-67202444.0,1.0
4987,2022-10-21,IBM,119.78199434407172,122.07706803896713,119.03562810467272,121.19075012207033,7201300.0,0.0,0.0,1.4927139282226705,0.0,1.4927139282226705,73.89199226588589,107.8028785381359,122.07706803896713,93.79076537518864,-6.2092346248113595,-0.19911828525513897,-1.393165541686333,0.10318458350090909,-60001144.0,1.0
4988,2022-10-24,IBM,122.1237050996162,124.18554024688076,121.14411452997784,123.793701171875,5610900.0,0.0,0.0,2.6029510498046733,0.0,2.6029510498046733,78.3775913570606,107.8028785381359,124.18554024688076,97.60820871496966,-2.391791285030342,0.489380296543672,-1.016656374040332,0.12640064332873746,-54390244.0,1.0
4989,2022-10-25,IBM,123.1499679741038,124.36281141493872,122.4969028092705,124.01760864257812,5957600.0,0.0,0.0,0.223907470703125,0.0,0.223907470703125,78.74013288267197,107.8028785381359,124.36281141493872,97.91543374644861,-2.0845662535513916,1.0410868435185563,-0.6051077305285543,0.1306455729034619,-48432644.0,1.0
4990,2022-10-26,IBM,124.75464800824275,126.75116960677916,123.90565619313432,125.9581527709961,5139000.0,0.0,0.0,1.9405441284179688,0.0,1.9405441284179688,81.7929218845362,107.8028785381359,126.75116960677916,95.8148371644164,-4.185162835583598,1.6162725661388464,-0.16083167119507402,0.10854736241045448,-43293644.0,1.0
4991,2022-10-27,IBM,126.46195613286235,127.25495873337208,125.43570072543493,125.7342529296875,3993200.0,0.0,0.0,-0.22389984130859375,0.22389984130859375,0.0,80.2586363564744,107.8028785381359,127.25495873337208,92.18229727401082,-7.817702725989169,2.0306366342282587,0.27746198988959264,0.12270916676641219,-47286844.0,-1.0
4992,2022-10-28,IBM,126.47129806838092,129.5500504813487,126.15409698424148,129.2235107421875,5965500.0,0.0,0.0,3.4892578125,0.0,3.4892578125,85.23790572145747,107.8028785381359,129.5500504813487,98.49847262892904,-1.501527371070964,2.610485041458105,0.7440666002032953,0.13981256897303918,-41321344.0,1.0
4993,2022-10-31,IBM,128.80367399936864,129.4660778449974,127.4415686339681,129.01824951171875,4915300.0,0.0,0.0,-0.20526123046875,0.20526123046875,0.0,83.80317395159759,107.8028785381359,129.5500504813487,97.55462010868071,-2.445379891319286,3.018658994077043,1.1989850789780452,0.12485771055628181,-46236644.0,-1.0
4994,2022-11-01,IBM,128.9809309572903,129.35410698004463,127.53484895654988,128.9342803955078,3590600.0,0.0,0.0,-0.0839691162109375,0.0839691162109375,0.0,83.14259899990074,107.8028785381359,129.5500504813487,97.16850500171323,-2.8314949982867637,3.2973543380656167,1.61865893079556,0.12807111604297594,-49827244.0,-1.0
4995,2022-11-02,IBM,128.51445946719025,130.77220724645412,127.62815569732582,127.65614318847656,5360500.0,0.0,0.0,-1.27813720703125,1.27813720703125,0.0,73.03192342813858,111.80523379790748,130.77220724645412,83.57110549856164,-16.428894501438364,3.37616904019589,1.9701609526756265,0.0664848584628488,-55187744.0,-1.0
4996,2022-11-03,IBM,127.27361892873664,127.32959390683082,124.98788383012612,125.45436096191406,4442400.0,0.0,0.0,-2.2017822265625,2.2017822265625,0.0,58.81542584383459,113.2886342752382,130.77220724645412,69.5837556013574,-30.416244398642593,3.22380284242179,2.2208893306248596,0.03518099224197546,-59630144.0,-1.0
4997,2022-11-04,IBM,126.55523046486108,128.49577689273144,125.89284096048658,127.77741241455078,4178000.0,0.0,0.0,2.3230514526367188,0.0,2.3230514526367188,66.70555380145295,113.65248402457344,130.77220724645412,82.50675672095157,-17.49324327904843,3.253003768109167,2.4273122181217213,0.0321802418456234,-55452144.0,1.0
4998,2022-11-07,IBM,127.47886108119728,129.40074445189842,127.3575724799827,129.06488037109375,4043100.0,0.0,0.0,1.2874679565429688,0.0,1.2874679565429688,70.33931326061386,113.81109390526252,130.77220724645412,89.93387497025937,-10.06612502974064,3.3415147147610043,2.610152717449578,0.04069802493178187,-51409044.0,1.0
4999,2022-11-08,IBM,129.68064324886265,131.48123815289793,129.41941719268917,130.65090942382812,5042800.0,0.0,0.0,1.586029052734375,0.0,1.586029052734375,74.32273079345838,116.7592288073566,131.48123815289793,94.35994972166434,-5.640050278335659,3.4993017943814237,2.7879825328359478,0.037256474071701406,-46366244.0,1.0
5000,2022-11-09,IBM,130.23551408576856,131.13238500763347,129.28200080754115,129.7068328857422,4720000.0,1.65,0.0,-0.9440765380859375,0.9440765380859375,0.0,68.04616275228287,119.03562810467272,131.48123815289793,85.7427216481945,-14.257278351805503,3.507735118175404,2.931933049903839,0.0315950495866566,-51086244.0,-1.0
5001,2022-11-10,IBM,132.41633574484584,133.4642625896607,130.55650148508002,133.33209228515625,5389000.0,0.0,0.0,3.6252593994140625,0.0,3.6252593994140625,76.74697548604578,121.14411452997784,133.4642625896607,98.92720197952022,-1.0727980204797798,3.763562715765829,3.0982589830762377,0.031794381064028876,-45697244.0,1.0
5002,2022-11-11,IBM,133.58701176164143,136.06994104230185,133.07721607637055,135.1636199951172,5871300.0,0.0,0.0,1.8315277099609375,0.0,1.8315277099609375,79.93231919127345,122.4969028092705,136.06994104230185,93.32263689511285,-6.677363104887145,4.067212614208032,3.292049709302597,0.04763179245305338,-39825944.0,1.0
5003,2022-11-14,IBM,134.65382218002867,137.91088773206266,134.2289756426243,136.13601684570312,5293500.0,0.0,0.0,0.9723968505859375,0.0,0.9723968505859375,81.48597777374154,123.90565619313432,137.91088773206266,87.3270864431896,-12.672913556810409,4.336335074125898,3.5009067822672577,0.055855870355842274,-34532444.0,1.0
5004,2022-11-15,IBM,136.02271819912252,137.9864015647777,134.05903483346734,136.26817321777344,4727100.0,0.0,0.0,0.1321563720703125,0.0,0.1321563720703125,81.70805840386097,124.98788383012612,137.9864015647777,86.78135167347736,-13.218648326522642,4.508311468994506,3.7023877196127075,0.06746271518309732,-29805344.0,1.0
5005,2022-11-16,IBM,136.0699054149579,136.84404153515544,135.95660631029733,136.43809509277344,3445200.0,0.0,0.0,0.169921875,0.0,0.169921875,82.0278876073944,124.98788383012612,137.9864015647777,88.08859207171923,-11.911407928280768,4.605229062193629,3.8829559881288924,0.08755163269448918,-26360144.0,1.0
5006,2022-11-17,IBM,135.39019708277894,138.00528214589477,135.23914118156026,137.92031860351562,3954000.0,0.0,0.0,1.4822235107421875,0.0,1.4822235107421875,84.71737008755376,124.98788383012612,138.00528214589477,99.34730780822599,-0.6526921917740036,4.746920458722883,4.055748882247691,0.07937949280157608,-22406144.0,1.0
5007,2022-11-18,IBM,138.36403079028292,140.01616682956058,137.77870720326484,139.38363647460938,4661700.0,0.0,0.0,1.46331787109375,0.0,1.46331787109375,86.94314420066117,124.98788383012612,140.01616682956058,95.79106705020791,-4.208932949792092,4.920568186931661,4.228712743184485,0.07995014657625399,-17744444.0,1.0
5008,2022-11-21,IBM,139.29866757574385,139.65740730616938,138.2601763431062,138.47731018066406,3476200.0,0.0,0.0,-0.9063262939453125,0.9063262939453125,0.0,78.74697901539095,124.98788383012612,140.01616682956058,89.76026303900171,-10.239736960998293,4.928242592285528,4.368618713004694,0.0599031479486094,-21220644.0,-1.0
5009,2022-11-22,IBM,139.34586172700742,140.9979975531485,138.79829498168576,140.76197814941406,7062100.0,0.0,0.0,2.28466796875,0.0,2.28466796875,83.32045150407248,124.98788383012612,140.9979975531485,98.52581057313134,-1.4741894268686677,5.060345709744723,4.5069641123527004,0.08523178785353802,-14158544.0,1.0
5010,2022-11-23,IBM,140.76199730343865,142.04594361068476,140.0067322276204,140.4315643310547,3658200.0,0.0,0.0,-0.330413818359375,0.330413818359375,0.0,80.43217845964503,125.89284096048658,142.04594361068476,90.00576350816253,-9.99423649183747,5.079819748343681,4.621535239550897,0.05324653595561113,-17816744.0,-1.0
5011,2022-11-25,IBM,139.97841580714626,141.13019184569683,139.81792431396906,140.07281494140625,2075200.0,0.0,0.0,-0.3587493896484375,0.3587493896484375,0.0,77.08456774196148,127.3575724799827,142.04594361068476,86.56672920556714,-13.433270794432865,5.008569317321388,4.698942055104996,0.0363203867021793,-19891944.0,-1.0
5012,2022-11-28,IBM,139.7046069372615,139.95007634633873,137.77869486520973,138.00526428222656,3538100.0,0.0,0.0,-2.0675506591796875,2.0675506591796875,0.0,60.3747003988307,129.28200080754115,142.04594361068476,68.34301601960308,-31.656983980396912,4.730735800918438,4.705300804267685,0.013730734010251266,-23430044.0,-1.0
5013,2022-11-29,IBM,137.75037633777475,138.93990901643957,137.55211368858963,138.29794311523438,2754700.0,0.0,0.0,0.2926788330078125,0.0,0.2926788330078125,61.729734117144524,129.28200080754115,142.04594361068476,70.63602874711022,-29.363971252889794,4.482496049094294,4.660739853233006,0.014895406972375902,-20675344.0,1.0
5014,2022-11-30,IBM,138.0147233549361,141.27178858809296,137.52379890997724,140.5731658935547,6377600.0,0.0,0.0,2.2752227783203125,0.0,2.2752227783203125,70.71297935303615,130.55650148508002,142.04594361068476,87.18146885610817,-12.818531143891834,4.4184228919574196,4.612276460977889,0.030307303821337728,-14297744.0,1.0
5015,2022-12-01,IBM,141.59278560366414,141.62110678546406,139.10042076688038,140.8186492919922,4495900.0,0.0,0.0,0.2454833984375,0.0,0.2454833984375,71.54452058752078,133.07721607637055,142.04594361068476,86.31584788369406,-13.684152116305937,4.337453448583574,4.557311858499026,0.021014530112916097,-9801844.0,1.0
5016,2022-12-02,IBM,139.84623769327695,140.8186365953582,139.46859796085334,140.3560333251953,2900000.0,0.0,0.0,-0.462615966796875,0.462615966796875,0.0,67.38432384892283,134.05903483346734,142.04594361068476,78.8414975977953,-21.1585024022047,4.1876823437617645,4.483385955551574,0.006976406091708354,-12701844.0,-1.0
5017,2022-12-05,IBM,139.66684864522102,140.60147629117813,138.59060070969232,139.16648864746094,2784600.0,0.0,0.0,-1.189544677734375,1.189544677734375,0.0,57.46953983237545,134.05903483346734,142.04594361068476,63.947817064876986,-36.052182935123014,3.927724981432391,4.372253760727737,0.004976833142539716,-15486444.0,-1.0
5018,2022-12-06,IBM,139.06265217929572,139.53469104317284,138.49619978045,139.25146484375,2847600.0,0.0,0.0,0.0849761962890625,0.0,0.0849761962890625,57.97916804879409,135.23914118156026,142.04594361068476,58.94579288833292,-41.05420711166708,3.6860730125713985,4.2350176110964695,-0.010730975264220177,-12638844.0,1.0
5019,2022-12-07,IBM,139.09097463469823,139.81791852527314,138.10912572175602,139.03433227539062,3971300.0,0.0,0.0,-0.217132568359375,0.217132568359375,0.0,56.000729096525326,135.23914118156026,142.04594361068476,55.75585795750075,-44.24414204249925,3.437416900317487,4.075497468940673,-0.009949558436664674,-16610144.0,-1.0
5020,2022-12-08,IBM,139.6290928251968,140.80919000730793,139.12873277242034,139.51580810546875,2665700.0,0.0,0.0,0.481475830078125,0.0,0.481475830078125,59.533711512184006,137.52379890997724,142.04594361068476,44.05009851143959,-55.94990148856041,3.241836344109771,3.908765243974493,-0.003976552025248492,-13944444.0,1.0
5021,2022-12-09,IBM,139.15707878290962,140.04451432708447,138.75113219446004,138.82666015625,3047600.0,0.0,0.0,-0.68914794921875,0.68914794921875,0.0,52.56321377180796,137.52379890997724,142.04594361068476,28.8106934320106,-71.18930656798939,2.9966849455009594,3.726349184279786,0.005951916967048776,-16992044.0,-1.0
5022,2022-12-12,IBM,139.55357725533509,140.8658447265625,138.7227842414416,140.8658447265625,4032800.0,0.0,0.0,2.0391845703125,0.0,2.0391845703125,66.11062617435843,137.52379890997724,142.04594361068476,73.90399993309312,-26.096000066906882,2.933134499829549,3.567706247389739,0.01856789445659701,-12959244.0,1.0
5023,2022-12-13,IBM,141.9609379784092,144.6421291949149,141.5644271321714,142.14976501464844,8811500.0,0.0,0.0,1.2839202880859375,0.0,1.2839202880859375,71.93373766330296,137.52379890997724,144.6421291949149,64.98667411457022,-35.01332588542977,2.952339222072993,3.4446328423263903,0.011215505541702031,-4147744.0,1.0
5024,2022-12-14,IBM,142.0553955121037,143.41486992356673,140.1483542179411,141.47950744628906,4205900.0,0.0,0.0,-0.670257568359375,0.670257568359375,0.0,65.18685494513971,137.52379890997724,144.6421291949149,55.57073608514729,-44.42926391485271,2.8802729252484482,3.3317608589108016,0.004692973250485899,-8353644.0,-1.0
5025,2022-12-15,IBM,140.21443298278936,140.64870068542413,133.66253102192076,134.39891052246094,6687000.0,0.0,0.0,-7.080596923828125,7.080596923828125,0.0,30.41475539282925,133.66253102192076,144.6421291949149,6.706798272011534,-93.29320172798846,2.2261531611603402,3.11063931936071,-0.04244294072440857,-15040644.0,-1.0
5026,2022-12-16,IBM,133.3509865140004,133.9835168983645,131.1984903266025,132.3219451904297,9834400.0,0.0,0.0,-2.07696533203125,2.07696533203125,0.0,25.763383478962012,131.1984903266025,144.6421291949149,8.356776575390263,-91.64322342460973,1.5226130555599298,2.793034066600554,-0.0491824111073893,-24875044.0,-1.0
5027,2022-12-19,IBM,132.32193323545846,132.58627383771363,129.52745691885482,131.10406494140625,5282900.0,0.0,0.0,-1.2178802490234375,1.2178802490234375,0.0,23.347578716844453,129.52745691885482,144.6421291949149,10.430977223691405,-89.5690227763086,0.8569018640071988,2.405807626081883,-0.05850854001058958,-30157944.0,-1.0
5028,2022-12-20,IBM,131.0757509703574,133.5209088784093,130.60371209673426,133.37930297851562,5156500.0,0.0,0.0,2.275238037109375,0.0,2.275238037109375,36.236121553988994,129.52745691885482,144.6421291949149,25.48415201672409,-74.5158479832759,0.5070684734261022,2.0260597955507267,-0.04067361783472201,-25001444.0,1.0
5029,2022-12-21,IBM,133.90798168581497,135.08807884760932,133.09607426228112,134.1912078857422,3793700.0,0.0,0.0,0.8119049072265625,0.0,0.8119049072265625,40.36476261377252,129.52745691885482,144.6421291949149,30.855786230140197,-69.1442137698598,0.29197126857948774,1.6792420901564789,-0.03816485237071743,-21207744.0,1.0
5030,2022-12-22,IBM,133.06775641866273,133.5303597036568,130.86805352527654,133.00167846679688,3337100.0,0.0,0.0,-1.1895294189453125,1.1895294189453125,0.0,36.38239279251873,129.52745691885482,144.6421291949149,22.98575506294518,-77.01424493705483,0.025229273885429393,1.3484395269022689,-0.04195866761396605,-24544844.0,-1.0
5031,2022-12-23,IBM,132.72788707021266,133.9268698431317,131.7932593196511,133.72860717773438,2092500.0,0.0,0.0,0.7269287109375,0.0,0.7269287109375,40.52022649996485,129.52745691885482,144.6421291949149,27.795179294318512,-72.2048207056815,-0.12605551736857024,1.053540518048101,-0.05066691335065898,-22452344.0,1.0
5032,2022-12-27,IBM,133.80412001157214,134.73876206203894,133.3320811911209,134.45553588867188,2742400.0,0.0,0.0,0.7269287109375,0.0,0.7269287109375,44.672488480066235,129.52745691885482,144.6421291949149,32.604603525691836,-67.39539647430816,-0.18515834249427598,0.8058007459396256,-0.0541276246582868,-19709944.0,1.0
5033,2022-12-28,IBM,134.43665334119157,134.8237286400268,132.12366594979295,132.18975830078125,2539500.0,0.0,0.0,-2.265777587890625,2.265777587890625,0.0,35.707524569118675,129.52745691885482,144.6421291949149,17.61401989603975,-82.38598010396025,-0.4100996986211385,0.5626206570274728,-0.06566144675782504,-22249444.0,-1.0
5034,2022-12-29,IBM,132.71843186469093,134.30447533154054,132.59569716589385,133.1715850830078,2337200.0,0.0,0.0,0.9818267822265625,0.0,0.9818267822265625,41.57035278093103,129.52745691885482,144.6421291949149,24.109872166562774,-75.89012783343722,-0.5033399386156248,0.3494285378988532,-0.009131959735998119,-19912244.0,1.0
5035,2022-12-30,IBM,132.68067543671907,133.02054398959305,131.6516341869416,133.0111083984375,2858000.0,0.0,0.0,-0.1604766845703125,0.1604766845703125,0.0,40.867522750109565,129.52745691885482,144.6421291949149,23.048144319347127,-76.95185568065287,-0.5834568999033536,0.1628514503384118,0.005208230630346478,-22770244.0,-1.0
