,datetime,symbol,Open,High,Low,Close,Volume,Dividends,Stock Splits,change_in_price,down_days,up_days,RSI,low_14,high_14,k_percent,r_percent,MACD,MACD_EMA,Price_Rate_Of_Change,On Balance Volume,Prediction
13,2023-01-23,GOOG,99.12999725341795,101.4000015258789,98.75,101.20999908447266,31791800.0,0.0,0.0,1.9300003051757812,0.0,1.9300003051757812,88.59031954409451,85.56999969482422,101.4000015258789,98.79973203140437,-1.2002679685956228,1.2787042489061662,0.6093701278578862,0.13975220277280376,115784500.0,1.0
14,2023-01-24,GOOG,99.5500030517578,101.08999633789062,98.6999969482422,99.20999908447266,27391400.0,0.0,0.0,-2.0,2.0,0.0,74.00958660956512,85.56999969482422,101.4000015258789,86.1654947056924,-13.834505294307595,1.4330038299353305,0.7801040335390403,0.11172121760830778,88393100.0,-1.0
15,2023-01-25,GOOG,97.1999969482422,97.72000122070312,95.26200103759766,96.7300033569336,31000900.0,0.0,0.0,-2.4799957275390625,2.4799957275390625,0.0,59.903300652879956,85.56999969482422,101.4000015258789,70.49906741145229,-29.50093258854772,1.3816631785800695,0.9039004210771617,0.0484500446260856,57392200.0,-1.0
16,2023-01-26,GOOG,98.27999877929688,99.20999908447266,96.81999969482422,99.16000366210938,24542100.0,0.0,0.0,2.4300003051757812,0.0,2.4300003051757812,67.01191713393192,85.56999969482422,101.4000015258789,85.84966769002395,-14.150332309976047,1.4757419263385998,1.0209033948754453,0.07888151138208332,81934300.0,1.0
17,2023-01-27,GOOG,99.0500030517578,101.58000183105467,98.97000122070312,100.70999908447266,29020400.0,0.0,0.0,1.5499954223632812,0.0,1.5499954223632812,70.81943655749322,86.69999694824219,101.58000183105467,94.15320926684014,-5.846790733159873,1.6274015078617623,1.1444282433183832,0.08523702341155293,110954700.0,1.0
18,2023-01-30,GOOG,98.74500274658205,99.40899658203124,97.5199966430664,97.9499969482422,24365100.0,0.0,0.0,-2.7600021362304545,2.7600021362304545,0.0,57.244299946742714,86.69999694824219,101.58000183105467,75.60481390026023,-24.395186099739778,1.5471080510298663,1.2261418216313726,0.06282544548675317,86589600.0,-1.0
19,2023-01-31,GOOG,97.86000061035156,99.91000366210938,97.79000091552734,99.87000274658205,22306800.0,0.0,0.0,1.9200057983398438,0.0,1.9200057983398438,62.945584728184585,89.73999786376953,101.58000183105467,85.55744500426276,-14.442554995737241,1.5917070775699642,1.3001076406526457,0.088145609881072,108896400.0,1.0
20,2023-02-01,GOOG,99.73999786376952,102.19000244140624,98.41999816894533,101.43000030517578,26392600.0,0.0,0.0,1.5599975585937358,0.0,1.5599975585937358,67.06306208379883,90.56999969482422,102.19000244140624,93.45953565756251,-6.540464342437496,1.7102965254888005,1.3829091265293216,0.08007663028236633,135289000.0,1.0
21,2023-02-02,GOOG,106.79000091552734,108.81999969482422,106.54000091552734,108.8000030517578,46622600.0,0.0,0.0,7.370002746582017,0.0,7.370002746582017,79.48794072787112,90.83999633789062,108.81999969482422,99.88878398591228,-0.1112160140877237,2.2760833028138876,1.562871852324455,0.09589045517238826,181911600.0,1.0
22,2023-02-03,GOOG,103.51000213623048,108.0199966430664,103.3000030517578,105.22000122070312,36823400.0,0.0,0.0,-3.5800018310546733,3.5800018310546733,0.0,65.61481429514785,90.83999633789062,108.81999969482422,79.97776528371541,-20.022234716284597,2.444676327232628,1.740279980051297,0.03962061231601832,145088200.0,-1.0
23,2023-02-06,GOOG,102.68499755859376,104.6999969482422,102.20999908447266,103.47000122070312,25573000.0,0.0,0.0,-1.75,1.75,0.0,59.734493854203286,91.37999725341795,108.81999969482422,69.32340753910067,-30.676592460899332,2.426456670916238,1.8781664687569894,0.04293924176537156,119515200.0,-1.0
24,2023-02-07,GOOG,103.62999725341795,108.66999816894533,103.5479965209961,108.04000091552734,33738800.0,0.0,0.0,4.569999694824219,0.0,4.569999694824219,68.29582933328317,91.37999725341795,108.81999969482422,95.52753056132039,-4.472469438679622,2.701398060942253,2.0434371622207737,0.11692336571993978,153254000.0,1.0
25,2023-02-08,GOOG,102.69000244140624,103.58000183105467,98.45500183105467,100.0,73546000.0,0.0,0.0,-8.040000915527344,8.040000915527344,0.0,47.70545543636243,95.26200103759766,108.81999969482422,34.94615305834197,-65.05384694165804,2.3192268965703136,2.0987623191172977,0.008471120480722627,79708000.0,-1.0
26,2023-02-09,GOOG,100.54000091552734,100.61000061035156,93.86000061035156,95.45999908447266,97798600.0,0.0,0.0,-4.540000915527344,4.540000915527344,0.0,39.873018406125524,93.86000061035156,108.81999969482422,10.695177620577336,-89.30482237942266,1.6725563498002316,2.013314525165209,-0.05212987834104188,-18090600.0,-1.0
27,2023-02-10,GOOG,95.73999786376952,97.0199966430664,94.52999877929688,94.86000061035156,49325300.0,0.0,0.0,-0.5999984741210938,0.5999984741210938,0.0,38.89912634570539,93.86000061035156,108.81999969482422,6.684492387689543,-93.31550761231045,1.1059307781215608,1.8314860683706238,-0.03154667109916731,-67415900.0,-1.0
28,2023-02-13,GOOG,95.01000213623048,95.3499984741211,94.0500030517578,95.0,43116600.0,0.0,0.0,0.1399993896484375,0.0,0.1399993896484375,39.29829506858182,93.86000061035156,108.81999969482422,7.620317242075705,-92.3796827579243,0.6610618148162217,1.597038427507568,-0.04876341857063493,-24299300.0,1.0
29,2023-02-14,GOOG,94.66000366210938,95.1750030517578,92.6500015258789,94.9499969482422,42513100.0,0.0,0.0,-0.05000305175779829,0.05000305175779829,0.0,39.1927754097201,92.6500015258789,108.81999969482422,14.223844667963329,-85.77615533203668,0.3024652287152634,1.3378028696724567,-0.0638864570387162,-66812400.0,-1.0
30,2023-02-15,GOOG,94.73999786376952,97.33999633789062,94.36000061035156,97.0999984741211,36964500.0,0.0,0.0,2.150001525878892,0.0,2.150001525878892,46.3409160354461,92.6500015258789,108.81999969482422,27.52008319202202,-72.47991680797799,0.1761314897947699,1.1052382728760437,-0.107536803763423,-29847900.0,1.0
31,2023-02-16,GOOG,95.54000091552734,97.87999725341795,94.97000122070312,95.77999877929688,35642100.0,0.0,0.0,-1.3199996948242188,1.3199996948242188,0.0,42.778486438188914,92.6500015258789,108.81999969482422,19.356818848805858,-80.64318115119414,-0.02178177646167967,0.8796555379526697,-0.08971680604342014,-65490000.0,-1.0
32,2023-02-17,GOOG,95.06999969482422,95.75,93.4499969482422,94.58999633789062,31095100.0,0.0,0.0,-1.19000244140625,1.19000244140625,0.0,39.61096861877155,92.6500015258789,108.81999969482422,11.997495557776276,-88.00250444222372,-0.26434325881464815,0.6507106675480124,-0.08582202356286162,-96585100.0,-1.0
33,2023-02-21,GOOG,93.23999786376952,93.41500091552734,92.0,92.0500030517578,28367200.0,0.0,0.0,-2.5399932861328267,2.5399932861328267,0.0,33.501653606109244,92.0,108.81999969482422,0.29728330954241944,-99.70271669045758,-0.6400722766919955,0.39242311134975244,-0.14800071943975235,-124952300.0,-1.0
34,2023-02-22,GOOG,91.93399810791016,92.36000061035156,90.87000274658205,91.8000030517578,29891100.0,0.0,0.0,-0.25,0.25,0.0,32.92494365683649,90.87000274658205,108.81999969482422,5.181061076819998,-94.81893892318,-0.9452443415819545,0.12478105224601298,-0.08199996948242205,-154843400.0,-1.0
35,2023-02-23,GOOG,92.12999725341795,92.12999725341795,90.01000213623047,91.06999969482422,32423700.0,0.0,0.0,-0.7300033569335795,0.7300033569335795,0.0,31.120000416111054,90.01000213623047,108.66999816894533,5.680588338472064,-94.31941166152794,-1.2279691258329706,-0.14585681037752746,-0.04598784236069098,-187267100.0,-1.0
36,2023-02-24,GOOG,89.62999725341797,90.12999725341795,88.86000061035156,89.3499984741211,31295600.0,0.0,0.0,-1.720001220703125,1.720001220703125,0.0,27.08358008281934,88.86000061035156,108.66999816894533,2.4734877544543945,-97.5265122455456,-1.5649521391016634,-0.42974957889886234,-0.0580856219774174,-218562700.0,-1.0
37,2023-02-27,GOOG,90.08999633789062,90.4499969482422,89.61000061035156,90.0999984741211,22724300.0,0.0,0.0,0.75,0.0,0.75,31.550493431648732,88.86000061035156,108.66999816894533,6.259454904534343,-93.74054509546565,-1.7537732661518675,-0.6946093255666864,-0.051578963430304325,-195838400.0,1.0
38,2023-02-28,GOOG,89.54000091552734,91.4499969482422,89.5199966430664,90.3000030517578,30546900.0,0.0,0.0,0.20000457763670454,0.0,0.20000457763670454,32.81688756373886,88.86000061035156,103.58000183105467,9.78262447003692,-90.21737552996308,-1.8661770368996287,-0.9289618063180619,-0.04897308105253695,-165291500.0,1.0
39,2023-03-01,GOOG,90.16000366210938,91.1999969482422,89.8499984741211,90.51000213623048,26323900.0,0.0,0.0,0.20999908447268467,0.0,0.20999908447268467,34.289732995229656,88.86000061035156,100.61000061035156,14.042566177692938,-85.95743382230707,-1.9166928802230245,-1.1265342829857725,-0.06786814048866296,-138967600.0,1.0
40,2023-03-02,GOOG,89.86000061035156,92.4800033569336,89.7699966430664,92.30999755859376,23328600.0,0.0,0.0,1.7999954223632812,0.0,1.7999954223632812,45.998358589808824,88.86000061035156,97.87999725341795,38.248317430297384,-61.751682569702616,-1.7963004084075038,-1.2605017539351517,-0.036228871005719476,-115639000.0,1.0
41,2023-03-03,GOOG,92.73999786376952,94.11000061035156,92.66000366210938,94.0199966430664,30242500.0,0.0,0.0,1.709999084472642,0.0,1.709999084472642,54.822411716475585,88.86000061035156,97.87999725341795,57.206185732688674,-42.793814267311326,-1.5500103656531934,-1.3184084024316127,-0.006026003984481498,-85396500.0,1.0
42,2023-03-06,GOOG,94.36000061035156,96.3000030517578,94.3000030517578,95.58000183105467,28288200.0,0.0,0.0,1.560005187988267,0.0,1.560005187988267,61.452710121765136,88.86000061035156,97.87999725341795,74.50114990750832,-25.498850092491683,-1.2191733866023924,-1.2985600484567947,0.03834870898713638,-57108300.0,1.0
43,2023-03-07,GOOG,95.41999816894533,96.08999633789062,93.84400177001952,94.16999816894533,24101500.0,0.0,0.0,-1.4100036621093466,1.4100036621093466,0.0,53.295483257415725,88.86000061035156,97.87999725341795,58.86917444337989,-41.13082555662012,-1.0551259633568293,-1.2498705805300192,0.02581693941612717,-81209800.0,-1.0
44,2023-03-08,GOOG,94.40499877929688,96.23999786376952,94.40499877929688,94.6500015258789,25395200.0,0.0,0.0,0.48000335693357954,0.0,0.48000335693357954,55.60999118395655,88.86000061035156,97.87999725341795,64.19072140096722,-35.80927859903277,-0.8774071998948756,-1.1753746596480104,0.03931044079335977,-55814600.0,1.0
45,2023-03-09,GOOG,94.48999786376952,95.91999816894533,92.3550033569336,92.66000366210938,24438900.0,0.0,0.0,-1.9899978637695312,1.9899978637695312,0.0,44.95339461794611,88.86000061035156,96.3000030517578,51.075293075301374,-48.924706924698626,-0.8826787165070584,-1.116833431155726,0.037045386060605034,-80253500.0,-1.0
46,2023-03-10,GOOG,92.5,93.18000030517578,90.8000030517578,91.01000213623048,32850100.0,0.0,0.0,-1.650001525878892,1.650001525878892,0.0,37.988731248400114,88.86000061035156,96.3000030517578,28.897860488773553,-71.10213951122645,-1.005056537460007,-1.0944774292222037,0.010099929828198295,-113103600.0,-1.0
47,2023-03-13,GOOG,90.56500244140624,93.08000183105467,89.94000244140625,91.66000366210938,31508600.0,0.0,0.0,0.650001525878892,0.0,0.650001525878892,42.068454372895346,88.86000061035156,96.3000030517578,37.63443727081067,-62.36556272918933,-1.0387441140076277,-1.0833305175948527,0.015060914334322328,-81595000.0,1.0
48,2023-03-14,GOOG,93.06999969482422,94.83000183105467,92.77999877929688,94.25,32303900.0,0.0,0.0,2.589996337890625,0.0,2.589996337890625,55.52202968696083,88.86000061035156,96.3000030517578,72.44620458255754,-27.553795417442455,-0.8510506614144049,-1.0368737175417546,0.04132137637274913,-49291100.0,1.0
49,2023-03-15,GOOG,93.54000091552734,97.25,93.04000091552734,96.5500030517578,38367300.0,0.0,0.0,2.3000030517577983,0.0,2.3000030517577983,64.0714943533168,88.86000061035156,97.25,91.65676997419266,-8.343230025807348,-0.5144685764235817,-0.9323911980937719,0.04593224575130872,-10923800.0,1.0
50,2023-03-16,GOOG,96.56999969482422,101.97000122070312,95.87000274658205,101.06999969482422,54499500.0,0.0,0.0,4.5199966430664205,0.0,4.5199966430664205,74.97778940862409,89.5199966430664,101.97000122070312,92.77107473923719,-7.2289252607628045,0.10900172933489216,-0.724110234459841,0.0749840810835396,43575700.0,1.0
51,2023-03-17,GOOG,100.83999633789062,103.48999786376952,100.75,102.45999908447266,76140300.0,0.0,0.0,1.3899993896484375,0.0,1.3899993896484375,77.41089783210063,89.5199966430664,103.48999786376952,92.6270673636704,-7.372932636329583,0.7050989644292684,-0.4382657836686888,0.07198155599095846,119716000.0,1.0
52,2023-03-20,GOOG,101.05999755859376,102.58000183105467,100.79000091552734,101.93000030517578,26033900.0,0.0,0.0,-0.529998779296875,0.529998779296875,0.0,74.23509716763957,89.7699966430664,103.48999786376952,88.62975641547509,-11.370243584524916,1.1223404432318347,-0.12614225744336097,0.08240418697161545,93682100.0,-1.0
53,2023-03-21,GOOG,101.9800033569336,105.95999908447266,101.86000061035156,105.83999633789062,33122800.0,0.0,0.0,3.9099960327148438,0.0,3.9099960327148438,80.90386913157819,89.7699966430664,105.95999908447266,99.25878487655369,-0.7412151234463181,1.7437150346798944,0.2478313872336661,0.1182249829013704,126804900.0,1.0
54,2023-03-22,GOOG,105.13999938964844,107.51000213623048,104.20999908447266,104.22000122070312,32336900.0,0.0,0.0,-1.6199951171875,1.6199951171875,0.0,71.99532108410389,89.94000244140625,107.51000213623048,81.2748948624255,-18.72510513757451,2.083043374352883,0.6148755012513449,0.12475714549664829,94468000.0,-1.0
55,2023-03-23,GOOG,105.88999938964844,107.10099792480467,105.41000366210938,106.26000213623048,31385800.0,0.0,0.0,2.040000915527358,0.0,2.040000915527358,75.85789906028202,89.94000244140625,107.51000213623048,92.88560033175057,-7.114399668249424,2.485767242547894,0.9890552494833001,0.16756400002246652,125853800.0,1.0
56,2023-03-24,GOOG,105.73999786376952,106.16000366210938,104.73999786376952,106.05999755859376,25236200.0,0.0,0.0,-0.20000457763671875,0.20000457763671875,0.0,74.6924828927082,89.94000244140625,107.51000213623048,91.74727033112094,-8.252729668879054,2.7570866215735776,1.342662582303037,0.1571022618498661,100617600.0,-1.0
57,2023-03-27,GOOG,105.31999969482422,105.4000015258789,102.62999725341795,103.05999755859376,25393400.0,0.0,0.0,-3.0,3.0,0.0,59.00371577990706,89.94000244140625,107.51000213623048,74.67271112732233,-25.327288872677673,2.701396404171149,1.614409997382443,0.09347477515749358,75224200.0,-1.0
58,2023-03-28,GOOG,103.0,103.0,100.27999877929688,101.36000061035156,24913500.0,0.0,0.0,-1.6999969482422017,1.6999969482422017,0.0,51.87884470784767,89.94000244140625,107.51000213623048,64.99714494764285,-35.00285505235715,2.4926682024022,1.7900619748687348,0.049818719902217534,50310700.0,-1.0
59,2023-03-29,GOOG,102.72000122070312,102.81999969482422,101.02999877929688,101.9000015258789,26148300.0,0.0,0.0,0.5400009155273438,0.0,0.5400009155273438,53.91832793391838,89.94000244140625,107.51000213623048,68.07057081506855,-31.929429184931458,2.3433896594449806,1.9007276813786855,0.008212148348281767,76459000.0,1.0
60,2023-03-30,GOOG,101.44000244140624,101.61000061035156,100.29000091552734,101.31999969482422,25009800.0,0.0,0.0,-0.5800018310546875,0.5800018310546875,0.0,51.22759358353241,89.94000244140625,107.51000213623048,64.76947894751692,-35.23052105248308,2.1538311517532236,1.9513484375144596,-0.01112628733002985,51449200.0,-1.0
61,2023-03-31,GOOG,101.70999908447266,104.19000244140624,101.44000244140624,104.0,28108000.0,0.0,0.0,2.6800003051757812,0.0,2.6800003051757812,61.47717110596917,92.77999877929688,107.51000213623048,76.17107035771123,-23.828929642288767,2.192864151501297,1.999651627687458,0.02030805149246251,79557200.0,1.0
62,2023-04-03,GOOG,102.66999816894533,104.9499969482422,102.37999725341795,104.91000366210938,20719900.0,0.0,0.0,0.910003662109375,0.0,0.910003662109375,64.4076877143207,93.04000091552734,107.51000213623048,82.03180197109364,-17.96819802890636,2.270487301483115,2.0538188049481994,-0.00878677917573123,100277100.0,1.0
63,2023-04-04,GOOG,104.83999633789062,106.0999984741211,104.5999984741211,105.12000274658205,20377200.0,0.0,0.0,0.20999908447267046,0.0,0.20999908447267046,65.11432302994059,95.87000274658205,107.51000213623048,79.46735811881669,-20.532641881183316,2.322033961822953,2.1074618699954475,0.008635593123559993,120654300.0,1.0
64,2023-04-05,GOOG,106.12000274658205,106.54000091552734,104.10199737548828,104.9499969482422,21864200.0,0.0,0.0,-0.17000579833984375,0.17000579833984375,0.0,63.928746579679085,100.27999877929688,107.51000213623048,64.59192255376722,-35.408077446232774,2.322450539190271,2.1504596254265147,-0.012328300034370354,98790100.0,-1.0
65,2023-04-06,GOOG,105.7699966430664,109.62999725341795,104.81500244140624,108.9000015258789,34684200.0,0.0,0.0,3.9500045776367045,0.0,3.9500045776367045,75.76067123148377,100.27999877929688,109.62999725341795,92.19255778961323,-7.807442210386773,2.609563238525965,2.2422803849339727,0.02677733389269754,133474300.0,1.0
66,2023-04-10,GOOG,107.38999938964844,107.97000122070312,105.5999984741211,106.9499969482422,19741500.0,0.0,0.0,-1.9500045776367045,1.9500045776367045,0.0,63.833701229304125,100.27999877929688,109.62999725341795,71.33689045411658,-28.663109545883415,2.65000550911887,2.323825435978521,0.03774499788277996,113732800.0,-1.0
67,2023-04-11,GOOG,106.91999816894533,107.22000122070312,105.27999877929688,106.12000274658205,18721300.0,0.0,0.0,-0.8299942016601562,0.8299942016601562,0.0,59.2524906217148,100.27999877929688,109.62999725341795,62.4599456721745,-37.54005432782551,2.585583270457775,2.3761770163344913,0.04696134675974295,95011500.0,-1.0
68,2023-04-12,GOOG,107.38999938964844,107.58699798583984,104.97000122070312,105.22000122070312,22761600.0,0.0,0.0,-0.9000015258789205,0.9000015258789205,0.0,54.37036888225618,100.27999877929688,109.62999725341795,52.83425933254626,-47.16574066745373,2.434160672166257,2.387773749886154,0.03258095824445162,72249900.0,-1.0
69,2023-04-13,GOOG,106.47000122070312,108.26499938964844,106.44000244140624,108.19000244140624,21650700.0,0.0,0.0,2.970001220703111,0.0,2.970001220703111,65.26725459847064,100.27999877929688,109.62999725341795,84.59898345441087,-15.40101654558913,2.5236888189284343,2.4149567681675883,0.06780500165095216,93900600.0,1.0
70,2023-04-14,GOOG,107.69000244140624,109.58000183105467,107.58999633789062,109.45999908447266,20758700.0,0.0,0.0,1.2699966430664205,0.0,1.2699966430664205,68.92836931003656,100.27999877929688,109.62999725341795,98.1818374685748,-1.8181625314252097,2.6659615147336666,2.465157724089276,0.05249999119685245,114659300.0,1.0
71,2023-04-17,GOOG,105.43000030517578,106.70999908447266,105.31999969482422,106.41999816894533,29043400.0,0.0,0.0,-3.0400009155273295,3.0400009155273295,0.0,53.385904933795956,100.27999877929688,109.62999725341795,65.66845338684,-34.33154661316001,2.5054007294937435,2.4732063260177863,0.014393236623070571,85615900.0,-1.0
72,2023-04-18,GOOG,107.0,107.0500030517578,104.77999877929688,105.12000274658205,17641400.0,0.0,0.0,-1.2999954223632812,1.2999954223632812,0.0,48.040889851897866,100.29000091552734,109.62999725341795,51.71310197906922,-48.286898020930785,2.2476904153469945,2.428103140083692,0.0,67974500.0,-1.0
73,2023-04-19,GOOG,104.21499633789062,105.7249984741211,103.8000030517578,105.0199966430664,16732000.0,0.0,0.0,-0.10000610351563921,0.10000610351563921,0.0,47.617711506798166,100.29000091552734,109.62999725341795,50.642372399551796,-49.35762760044821,2.012208654527001,2.3449242373661066,0.0006669813898014798,51242500.0,-1.0
74,2023-04-20,GOOG,104.6500015258789,106.88800048828124,104.63999938964844,105.9000015258789,22515300.0,0.0,0.0,0.8800048828125,0.0,0.8800048828125,51.918034601475824,101.44000244140624,109.62999725341795,54.45667777385509,-45.54332222614491,1.8747763755646503,2.25089465993575,-0.027548208980392785,73757800.0,1.0
75,2023-04-21,GOOG,106.08999633789062,106.63999938964844,105.48500061035156,105.91000366210938,22379000.0,0.0,0.0,0.01000213623046875,0.0,0.01000213623046875,51.96974609618503,102.37999725341795,109.62999725341795,48.689743568157525,-51.31025643184247,1.7465268832309278,2.150021100243513,-0.009724107674693339,96136800.0,1.0
76,2023-04-24,GOOG,106.0500030517578,107.31999969482422,105.36000061035156,106.77999877929688,21410900.0,0.0,0.0,0.8699951171875,0.0,0.8699951171875,56.64899362787132,103.8000030517578,109.62999725341795,51.11490036629006,-48.885099633709935,1.6953675963060846,2.059090396318124,0.006219336747388837,117547700.0,1.0
77,2023-04-25,GOOG,106.61000061035156,107.44000244140624,104.55999755859376,104.61000061035156,31408100.0,0.0,0.0,-2.1699981689453125,2.1699981689453125,0.0,44.24378952574878,103.8000030517578,109.62999725341795,13.893625457862518,-86.10637454213747,1.463251395710813,1.939922592906798,-0.005797382657999228,86139600.0,-1.0
78,2023-04-26,GOOG,105.55999755859376,107.0199966430664,103.2699966430664,104.4499969482422,37068200.0,0.0,0.0,-0.1600036621093608,0.1600036621093608,0.0,43.434571188606206,103.2699966430664,109.62999725341795,18.55346213733415,-81.44653786266585,1.2519814332358408,1.8023343579338897,-0.03456886411653015,49071400.0,-1.0
79,2023-04-27,GOOG,105.2300033569336,109.1500015258789,104.41999816894533,108.37000274658205,38235200.0,0.0,0.0,3.9200057983398438,0.0,3.9200057983398438,62.71311405685348,103.2699966430664,109.58000183105467,80.82411902329362,-19.17588097670638,1.3842800994252116,1.7187235047548783,-0.009957942143316134,87306600.0,1.0
80,2023-04-28,GOOG,107.8000030517578,108.29000091552734,106.04000091552734,108.22000122070312,23957900.0,0.0,0.0,-0.15000152587892046,0.15000152587892046,0.0,61.78339493229403,103.2699966430664,109.58000183105467,78.4469177150528,-21.553082284947198,1.4602063634080196,1.66702007575469,0.01691414285593429,63348700.0,-1.0
81,2023-05-01,GOOG,107.72000122070312,108.68000030517578,107.5,107.70999908447266,20926300.0,0.0,0.0,-0.5100021362304688,0.5100021362304688,0.0,58.387623709134665,103.2699966430664,109.58000183105467,70.36448163082724,-29.635518369172758,1.462431087999974,1.6261022777410554,0.02463847289021137,42422400.0,-1.0
82,2023-05-02,GOOG,107.66000366210938,107.7300033569336,104.5,105.9800033569336,20343100.0,0.0,0.0,-1.7299957275390625,1.7299957275390625,0.0,48.05077825407911,103.2699966430664,109.58000183105467,42.94777314963162,-57.05222685036837,1.3097142695478823,1.5628246755299955,0.009141180199519372,22079300.0,-1.0
83,2023-05-03,GOOG,106.22000122070312,108.12999725341795,105.62000274658205,106.12000274658205,17116300.0,0.0,0.0,0.1399993896484517,0.0,0.1399993896484517,48.89557981289208,103.2699966430664,109.58000183105467,45.1664621281281,-54.8335378718719,1.1862894811189904,1.487517636102797,0.0020774430361965024,39195600.0,1.0
84,2023-05-04,GOOG,106.16000366210938,106.3000030517578,104.6999969482422,105.20999908447266,19780600.0,0.0,0.0,-0.9100036621093892,0.9100036621093892,0.0,43.58024928924849,103.2699966430664,109.1500015258789,32.9932114015238,-67.00678859847619,1.0035733107928877,1.3907287704804459,-0.006609428320576649,19415000.0,-1.0
85,2023-05-05,GOOG,105.31999969482422,106.44000244140624,104.73899841308594,106.21499633789062,20705300.0,0.0,0.0,1.0049972534179688,0.0,1.0049972534179688,50.4449031823952,103.2699966430664,109.1500015258789,50.084987232452406,-49.915012767547594,0.9290541893340389,1.2983938538234985,-0.0052912759680213695,40120300.0,1.0
86,2023-05-08,GOOG,105.79499816894533,108.41999816894533,105.79000091552734,108.23999786376952,17266000.0,0.0,0.0,2.025001525878892,0.0,2.025001525878892,61.371868615946255,103.2699966430664,109.1500015258789,84.52376009466646,-15.476239905333546,1.0214347135775057,1.243002025569054,0.0347002889995085,57386300.0,1.0
87,2023-05-09,GOOG,108.77999877929688,110.59500122070312,107.7249984741211,107.94000244140624,24782400.0,0.0,0.0,-0.29999542236328125,0.29999542236328125,0.0,59.14266712009571,103.2699966430664,110.59500122070312,63.7543055276359,-36.2456944723641,1.0582635089697305,1.206054322139666,0.033413169891172156,32603900.0,-1.0
88,2023-05-10,GOOG,108.5500030517578,113.51000213623048,108.4800033569336,112.27999877929688,47533500.0,0.0,0.0,4.339996337890639,0.0,4.339996337890639,74.56465270804821,103.2699966430664,113.51000213623048,87.98825491104745,-12.011745088952557,1.4209253477347232,1.2490285273605874,0.03608005844438478,80137400.0,1.0
89,2023-05-11,GOOG,115.86000061035156,118.44000244140624,114.93000030517578,116.9000015258789,57115100.0,0.0,0.0,4.620002746582031,0.0,4.620002746582031,82.62173086124805,103.2699966430664,118.44000244140624,89.84838281541155,-10.151617184588444,2.057074686386386,1.410637759472342,0.08020698768496448,137252500.0,1.0
90,2023-05-12,GOOG,117.0,118.26000213623048,116.5500030517578,117.91999816894533,31272500.0,0.0,0.0,1.0199966430664205,0.0,1.0199966430664205,83.91935187186037,103.2699966430664,118.44000244140624,96.57215508435853,-3.4278449156414768,2.6133296950380895,1.6511761469505588,0.09479156226215713,168525000.0,1.0
91,2023-05-15,GOOG,116.48999786376952,118.79499816894533,116.4800033569336,116.95999908447266,22107900.0,0.0,0.0,-0.9599990844726705,0.9599990844726705,0.0,77.62484007824165,103.2699966430664,118.79499816894533,88.1803613261237,-11.8196386738763,2.9428309842569575,1.909507114725496,0.10360441007497578,146417100.0,-1.0
92,2023-05-16,GOOG,116.83000183105467,121.1999969482422,116.83000183105467,120.08999633789062,32370100.0,0.0,0.0,3.1299972534179688,0.0,3.1299972534179688,82.54908086438816,104.41999816894533,121.1999969482422,93.38497800297165,-6.615021997028349,3.4169500462512303,2.2109957013234887,0.13164335874236044,178787200.0,1.0
93,2023-05-17,GOOG,120.18000030517578,122.27999877929688,119.45999908447266,121.4800033569336,26659600.0,0.0,0.0,1.3900070190429688,0.0,1.3900070190429688,84.31758843655808,104.5,122.27999877929688,95.50058786677307,-4.499412133226917,3.8602732091815284,2.540851203151416,0.15464313671743146,205446800.0,1.0
94,2023-05-18,GOOG,121.55999755859376,123.9000015258789,121.48999786376952,123.5199966430664,27014500.0,0.0,0.0,2.0399932861328125,0.0,2.0399932861328125,86.61467422416862,104.5,123.9000015258789,98.04121209833109,-1.9587879016689105,4.326240748841059,2.897929112511324,0.16292426589297437,232461300.0,1.0
95,2023-05-19,GOOG,124.1999969482422,126.47899627685548,122.72000122070312,123.25,30251300.0,0.0,0.0,-0.26999664306640625,0.26999664306640625,0.0,84.71960182338682,104.5,126.47899627685548,85.30871821359874,-14.69128178640127,4.620479978839484,3.2424392859482887,0.13867334102428597,202210000.0,-1.0
96,2023-05-22,GOOG,123.51000213623048,127.0500030517578,123.4499969482422,125.87000274658205,29760200.0,0.0,0.0,2.6200027465820455,0.0,2.6200027465820455,87.72636277735198,104.6999969482422,127.0500030517578,94.72035801820142,-5.279641981798573,5.007239996111764,3.595399428121412,0.1661108013677215,231970200.0,1.0
97,2023-05-23,GOOG,124.93000030517578,125.41999816894533,123.0500030517578,123.29000091552734,24477900.0,0.0,0.0,-2.5800018310547017,2.5800018310547017,0.0,71.69654357140203,104.6999969482422,127.0500030517578,83.1767288169151,-16.823271183084895,5.047477267109798,3.8858149960115247,0.09805844545716713,207492300.0,-1.0
98,2023-05-24,GOOG,121.87999725341795,122.75,120.75,121.63999938964844,23087900.0,0.0,0.0,-1.6500015258789062,1.6500015258789062,0.0,63.177805317956924,104.73899841308594,127.0500030517578,75.75185990176277,-24.248140098237233,4.889912598637039,4.086634516587762,0.04054745767236123,184404400.0,-1.0
99,2023-05-25,GOOG,125.20999908447266,125.9800033569336,122.9000015258789,124.3499984741211,33812700.0,0.0,0.0,2.7099990844726562,0.0,2.7099990844726562,69.94522666747191,105.79000091552734,127.0500030517578,87.30007381779392,-12.699926182206086,4.926826839359492,4.254672981176338,0.05452849732887066,218217100.0,1.0
100,2023-05-26,GOOG,124.06500244140624,126.0,123.29000091552734,125.43000030517578,25154700.0,0.0,0.0,1.0800018310546875,0.0,1.0800018310546875,72.28727589791428,107.7249984741211,127.0500030517578,91.61706409913755,-8.382935900862439,4.985718671902234,4.400882119345344,0.07241793166042854,243371800.0,1.0
101,2023-05-30,GOOG,126.29000091552734,126.37999725341795,122.88999938964844,124.63999938964844,27230700.0,0.0,0.0,-0.7900009155273438,0.7900009155273438,0.0,67.82628243920252,108.4800033569336,127.0500030517578,87.02205868758807,-12.977941312411936,4.912040920580807,4.503113879605764,0.037888277046455476,216141100.0,-1.0
102,2023-05-31,GOOG,123.6999969482422,124.9000015258789,123.0999984741211,123.37000274658205,41548800.0,0.0,0.0,-1.269996643066392,1.269996643066392,0.0,60.85966201293381,114.93000030517578,127.0500030517578,69.63696805915694,-30.36303194084305,4.697059392530761,4.541902982194809,0.015558111108173511,174592300.0,-1.0
103,2023-06-01,GOOG,123.5,125.04000091552734,123.3000030517578,124.37000274658205,25017700.0,0.0,0.0,1.0,0.0,1.0,64.20043677817318,116.4800033569336,127.0500030517578,74.64521870811345,-25.354781291886553,4.554844132337081,4.5444912122234795,0.006881526284135964,199610000.0,1.0
104,2023-06-02,GOOG,124.48999786376952,126.74500274658205,124.3499984741211,125.2300033569336,19362400.0,0.0,0.0,0.8600006103515483,0.0,0.8600006103515483,66.9958015098373,116.4800033569336,127.0500030517578,82.78145934369893,-17.21854065630107,4.460097179431614,4.52761240566398,0.016064935958893356,218972400.0,1.0
105,2023-06-05,GOOG,124.61000061035156,127.98999786376952,124.37999725341795,126.62999725341795,22672500.0,0.0,0.0,1.3999938964843608,0.0,1.3999938964843608,71.21730793356878,116.83000183105467,127.98999786376952,87.81361027042658,-12.186389729573417,4.446686686912599,4.511427261912839,0.006037931915883421,241644900.0,1.0
106,2023-06-06,GOOG,126.5999984741211,128.8800048828125,125.97000122070312,127.91000366210938,19450100.0,0.0,0.0,1.2800064086914205,0.0,1.2800064086914205,74.63940005141492,119.45999908447266,128.8800048828125,89.7027534646096,-10.297246535390407,4.487587020161229,4.506659213562314,0.03747264751622037,261095000.0,1.0
107,2023-06-07,GOOG,127.5749969482422,129.5500030517578,122.62999725341795,122.94000244140624,34179300.0,0.0,0.0,-4.970001220703139,4.970001220703139,0.0,48.69915913643928,120.75,129.5500030517578,24.886382749251204,-75.1136172507488,4.072111948959645,4.41974976063881,0.010687299065116784,226915700.0,-1.0
108,2023-06-08,GOOG,122.58499908447266,123.7300033569336,122.01000213623048,122.66999816894533,24815000.0,0.0,0.0,-0.2700042724609091,0.2700042724609091,0.0,47.660842931660746,120.75,129.5500030517578,21.818153444410505,-78.1818465555895,3.6786565052094318,4.271531109548882,-0.013510255937199678,202100700.0,-1.0
109,2023-06-09,GOOG,122.55999755859376,124.28500366210938,122.41999816894533,122.87000274658205,20304500.0,0.0,0.0,0.20000457763671875,0.0,0.20000457763671875,48.59756143338126,120.75,129.5500030517578,24.0909319475585,-75.90906805244151,3.344422794247592,4.086109446484569,-0.020409770807344074,222405200.0,1.0
110,2023-06-12,GOOG,123.3949966430664,124.75,122.3499984741211,124.3499984741211,22255700.0,0.0,0.0,1.4799957275390483,0.0,1.4799957275390483,55.41116596459666,120.75,129.5500030517578,40.90905938267816,-59.09094061732184,3.162486150871871,3.9013847873587966,-0.002326708255355081,244660900.0,1.0
111,2023-06-13,GOOG,125.6500015258789,125.86000061035156,123.84500122070312,124.43000030517578,19287700.0,0.0,0.0,0.0800018310546875,0.0,0.0800018310546875,55.77678674199372,120.75,129.5500030517578,41.81817078393736,-58.18182921606264,2.9902836385712135,3.7191645575987295,0.00859202022367711,263948600.0,1.0
112,2023-06-14,GOOG,123.8000030517578,124.79000091552734,122.16000366210938,124.37999725341795,24659600.0,0.0,0.0,-0.05000305175782671,0.05000305175782671,0.0,55.44888624915225,122.01000213623048,129.5500030517578,31.43229216732422,-68.56770783267578,2.817301017157078,3.538791849508379,8.036107272801907e-05,239289000.0,-1.0
113,2023-06-15,GOOG,123.87999725341795,126.16000366210938,123.13999938964844,125.79000091552734,24517100.0,0.0,0.0,1.4100036621093892,0.0,1.4100036621093892,62.602186110779805,122.01000213623048,129.5500030517578,50.132603717760915,-49.86739628223909,2.7621295883369896,3.3834593972727096,0.004471752324382239,263806100.0,1.0
114,2023-06-16,GOOG,126.6999969482422,126.6999969482422,123.79000091552734,124.05999755859376,56686800.0,0.0,0.0,-1.7300033569335795,1.7300033569335795,0.0,51.0075539609637,122.01000213623048,129.5500030517578,27.188264899831378,-72.81173510016863,2.5494386424300615,3.216655246302984,-0.020295346683779747,207119300.0,-1.0
115,2023-06-20,GOOG,123.53500366210938,125.1750030517578,122.83000183105467,123.8499984741211,22698000.0,0.0,0.0,-0.20999908447267046,0.20999908447267046,0.0,49.71782642696653,122.01000213623048,129.5500030517578,24.40313149168797,-75.59686850831203,2.336996690190432,3.040723535079465,-0.03174110758931181,184421300.0,-1.0
116,2023-06-21,GOOG,123.23500061035156,123.41000366210938,120.86000061035156,121.26000213623048,22612000.0,0.0,0.0,-2.589996337890611,2.589996337890611,0.0,36.561889982273975,120.86000061035156,129.5500030517578,4.603008210595976,-95.39699178940403,1.937335055462185,2.8200458391549965,-0.013665204748767201,161809300.0,-1.0
117,2023-06-22,GOOG,120.66000366210938,123.93499755859376,119.5999984741211,123.87000274658205,20781900.0,0.0,0.0,2.6100006103515625,0.0,2.6100006103515625,51.48804046930638,119.5999984741211,129.5500030517578,42.914596060167284,-57.085403939832716,1.8103151836562006,2.6180997080544963,0.009782380333812624,182591200.0,1.0
118,2023-06-23,GOOG,122.04000091552734,123.44000244140624,121.86000061035156,123.0199966430664,29542900.0,0.0,0.0,-0.8500061035156392,0.8500061035156392,0.0,47.30551409036682,119.5999984741211,129.5500030517578,34.371825080683685,-65.62817491931632,1.6223674936969843,2.4189532651824095,0.0012207527722916112,153048300.0,-1.0
119,2023-06-26,GOOG,121.46600341796876,122.72000122070312,118.98999786376952,119.08999633789062,23185000.0,0.0,0.0,-3.9300003051757812,3.9300003051757812,0.0,33.00318824659624,118.98999786376952,129.5500030517578,0.9469547821326203,-99.05304521786738,1.1431505092110967,2.1637927139875477,-0.04229997748914449,129863300.0,-1.0
120,2023-06-27,GOOG,117.83999633789062,119.8949966430664,116.91000366210938,119.01000213623048,27221700.0,0.0,0.0,-0.07999420166014204,0.07999420166014204,0.0,32.77049076762823,116.91000366210938,129.5500030517578,16.613912781047343,-83.38608721895265,0.7482877145800586,1.8806917141055182,-0.04355861251830162,102641600.0,-1.0
121,2023-06-28,GOOG,117.95999908447266,121.2699966430664,117.5999984741211,121.08000183105467,19753100.0,0.0,0.0,2.0699996948241903,0.0,2.0699996948241903,44.46233626935954,116.91000366210938,126.6999969482422,42.59449467500607,-57.40550532499393,0.595510345971789,1.623655440478386,-0.026531560501964813,122394700.0,1.0
122,2023-06-29,GOOG,120.08999633789062,120.91000366210938,119.20999908447266,120.01000213623048,18517500.0,0.0,0.0,-1.0699996948241903,1.0699996948241903,0.0,40.28388140931199,116.91000366210938,126.6999969482422,31.66497037860224,-68.33502962139775,0.3836766033158625,1.3756596730455832,-0.04594958849851938,103877200.0,-1.0
123,2023-06-30,GOOG,121.0999984741211,122.02999877929688,120.87999725341795,120.97000122070312,23865800.0,0.0,0.0,0.959999084472642,0.0,0.959999084472642,45.57843706424204,116.91000366210938,126.6999969482422,41.47089216439597,-58.52910783560403,0.2899137349859586,1.1585104854334494,-0.02490727388924241,127743000.0,1.0
124,2023-07-03,GOOG,120.31999969482422,121.0199966430664,119.70500183105467,120.55999755859376,13888300.0,0.0,0.0,-0.4100036621093608,0.4100036621093608,0.0,43.67038681237122,116.91000366210938,126.6999969482422,37.2829050011145,-62.7170949988855,0.1804441351154935,0.9628972153697076,-0.026564400129684196,113854700.0,-1.0
125,2023-07-05,GOOG,120.05999755859376,123.37000274658205,120.05999755859376,122.62999725341795,17830300.0,0.0,0.0,2.0699996948241903,0.0,2.0699996948241903,54.71427819059824,116.91000366210938,126.6999969482422,58.42694089903764,-41.57305910096236,0.25773981215161257,0.8218657347260019,0.01129799680894239,131685000.0,1.0
126,2023-07-06,GOOG,120.63999938964844,121.1500015258789,119.25,120.93000030517578,17732500.0,0.0,0.0,-1.6999969482421733,1.6999969482421733,0.0,46.1418121827889,116.91000366210938,126.6999969482422,41.06230234867052,-58.93769765132948,0.17975670481295936,0.6934439287433302,-0.02373457960940739,113952500.0,-1.0
127,2023-07-07,GOOG,120.88999938964844,121.75,120.08999633789062,120.13999938964844,20982400.0,0.0,0.0,-0.7900009155273438,0.7900009155273438,0.0,42.56584354353515,116.91000366210938,126.6999969482422,32.99282883180559,-67.00717116819442,0.05359340950541025,0.5654738248956958,-0.023410805820244573,92970100.0,-1.0
128,2023-07-10,GOOG,119.06999969482422,119.06999969482422,116.63999938964844,116.87000274658205,32960100.0,0.0,0.0,-3.269996643066392,3.269996643066392,0.0,31.066771469815862,116.63999938964844,125.1750030517578,2.6948243496917774,-97.30517565030821,-0.3067057888997198,0.39103790213655765,-0.01864131043391637,60010000.0,-1.0
129,2023-07-11,GOOG,116.76000213623048,118.2249984741211,115.83000183105467,117.70999908447266,18286600.0,0.0,0.0,0.8399963378906108,0.0,0.8399963378906108,36.17717906740406,115.83000183105467,123.93499755859376,23.195536637115588,-76.8044633628844,-0.5184906407826162,0.2091321935526771,-0.010923477257564596,78296600.0,1.0
130,2023-07-12,GOOG,119.3000030517578,120.95999908447266,119.0,119.62000274658205,22059600.0,0.0,0.0,1.9100036621093892,0.0,1.9100036621093892,46.56966673363498,115.83000183105467,123.93499755859376,46.76129442795061,-53.23870557204938,-0.5261510506386315,0.06207554471438575,-0.012058135632586064,100356200.0,1.0
131,2023-07-13,GOOG,121.54000091552734,125.33499908447266,121.05999755859376,124.83000183105467,31535900.0,0.0,0.0,5.209999084472628,0.0,5.209999084472628,64.67418755036466,115.83000183105467,125.33499908447266,94.68703419944296,-5.312965800557035,-0.1105592201834753,0.027548591734807972,0.04016331646551197,131892100.0,1.0
132,2023-07-14,GOOG,125.12999725341795,127.08999633789062,124.9000015258789,125.6999969482422,20482800.0,0.0,0.0,0.8699951171875284,0.0,0.8699951171875284,66.83915707764574,115.83000183105467,127.08999633789062,87.6554168050033,-12.344583194996707,0.28570572302687935,0.07918001799322891,0.039100567742488934,152374900.0,1.0
133,2023-07-17,GOOG,126.05999755859376,127.27999877929688,124.5,125.05999755859376,20675300.0,0.0,0.0,-0.6399993896484375,0.6399993896484375,0.0,63.53411303109144,115.83000183105467,127.27999877929688,80.61133788298585,-19.38866211701414,0.5418611548287231,0.17171624536033728,0.03732581362912635,131699600.0,-1.0
134,2023-07-18,GOOG,124.90499877929688,124.98999786376952,123.3000030517578,124.08000183105467,21071200.0,0.0,0.0,-0.9799957275390909,0.9799957275390909,0.0,58.42941177440815,115.83000183105467,127.27999877929688,72.05242095078931,-27.947579049210695,0.658203507702197,0.26901369782871726,0.011824224171189002,110628400.0,-1.0
135,2023-07-19,GOOG,124.79000091552734,125.47000122070312,122.47000122070312,122.77999877929688,22313800.0,0.0,0.0,-1.3000030517577983,1.3000030517577983,0.0,52.03071867714322,115.83000183105467,127.27999877929688,60.69867948138765,-39.30132051861235,0.6381527596822991,0.3428415101994385,0.015298093686037184,88314600.0,-1.0
136,2023-07-20,GOOG,122.12000274658205,124.6999969482422,118.68499755859376,119.52999877929688,27541700.0,0.0,0.0,-3.25,3.25,0.0,39.540089608475,115.83000183105467,127.27999877929688,32.31439244016762,-67.68560755983238,0.35591815081696154,0.34545683832294316,-0.005077414794827484,60772900.0,-1.0
137,2023-07-21,GOOG,120.87000274658205,121.3000030517578,119.06999969482422,120.30999755859376,56498100.0,0.0,0.0,0.7799987792968892,0.0,0.7799987792968892,43.308847522135736,115.83000183105467,127.27999877929688,39.126610668895054,-60.87338933110495,0.1929588872153829,0.3149572481014298,0.029434369223648504,117271000.0,1.0
138,2023-07-24,GOOG,121.9260025024414,123.3499984741211,121.37999725341795,121.87999725341795,22276100.0,0.0,0.0,1.5699996948241903,0.0,1.5699996948241903,50.478211291903726,115.83000183105467,127.27999877929688,52.83840205120818,-47.16159794879182,0.18832482886618607,0.28963076425438017,0.03542603178471504,139547100.0,1.0
139,2023-07-25,GOOG,121.87999725341795,123.69000244140624,121.52999877929688,122.79000091552734,31820800.0,0.0,0.0,0.9100036621093892,0.0,0.9100036621093892,54.340034504839025,115.83000183105467,127.27999877929688,60.78603440624642,-39.21396559375358,0.25513947276803606,0.28273250595711114,0.026500569270684782,171367900.0,1.0
140,2023-07-26,GOOG,130.36000061035156,131.3699951171875,128.7100067138672,129.66000366210938,46216900.0,0.0,0.0,6.870002746582031,0.0,6.870002746582031,72.8100219501901,115.83000183105467,131.3699951171875,88.99618922870422,-11.00381077129578,0.8526040821725474,0.3967068212002008,0.0386926360667017,217584800.0,1.0
141,2023-07-27,GOOG,131.8000030517578,133.60000610351562,129.17999267578125,129.8699951171875,35931600.0,0.0,0.0,0.209991455078125,0.0,0.209991455078125,73.19247693741426,115.83000183105467,133.60000610351562,79.00950990704764,-20.99049009295235,1.3277378972135097,0.5829130364028657,0.033174210582219255,253516400.0,1.0
142,2023-07-28,GOOG,130.97000122070312,134.07000732421875,130.9199981689453,133.00999450683594,26971000.0,0.0,0.0,3.1399993896484375,0.0,3.1399993896484375,78.42778322493731,115.83000183105467,134.07000732421875,94.1885279706737,-5.811472029326308,1.9353431241318475,0.8533990539486657,0.06356946348505566,280487400.0,1.0
143,2023-07-31,GOOG,133.00999450683594,133.8300018310547,132.1300048828125,133.11000061035156,18381900.0,0.0,0.0,0.100006103515625,0.0,0.100006103515625,78.58149931268585,118.68499755859376,134.07000732421875,93.760116317819,-6.239883682181004,2.39730935390736,1.162181113940408,0.07277561771470631,298869300.0,1.0
144,2023-08-01,GOOG,130.85499572753906,132.9199981689453,130.75,131.88999938964844,22154300.0,0.0,0.0,-1.220001220703125,1.220001220703125,0.0,71.41816980290547,118.68499755859376,134.07000732421875,85.83031166193248,-14.169688338067518,2.6346080739749738,1.4566665059473236,0.07419775778567361,276715000.0,-1.0
145,2023-08-02,GOOG,129.83999633789062,130.4199981689453,127.8499984741211,128.63999938964844,22705800.0,0.0,0.0,-3.25,3.25,0.0,55.7867990576204,118.68499755859376,134.07000732421875,64.70585318247454,-35.294146817525466,2.5312456766313716,1.6715823400841348,0.07621518199102884,254009200.0,-1.0
146,2023-08-03,GOOG,128.3699951171875,129.77000427246094,127.7750015258789,128.77000427246094,15018100.0,0.0,0.0,0.1300048828125,0.0,0.1300048828125,56.22897919702911,118.68499755859376,134.07000732421875,65.55086325912052,-34.449136740879474,2.4317882377638824,1.823623519620085,0.07031840150895974,269027300.0,1.0
147,2023-08-04,GOOG,129.60000610351562,131.92999267578125,128.31500244140625,128.5399932861328,20509500.0,0.0,0.0,-0.230010986328125,0.230010986328125,0.0,55.10394229517055,118.68499755859376,134.07000732421875,64.05583017281047,-35.94416982718952,2.3078047575579177,1.920459767207652,0.05464388072529336,248517800.0,-1.0
148,2023-08-07,GOOG,129.50999450683594,132.05999755859375,129.42999267578125,131.94000244140625,17621000.0,0.0,0.0,3.4000091552734375,0.0,3.4000091552734375,66.5269656487696,118.68499755859376,134.07000732421875,86.1553231667645,-13.84467683323549,2.455590069749192,2.0274858277159606,0.07451748072038544,266138800.0,1.0
149,2023-08-08,GOOG,130.97999572753906,131.94000244140625,130.1300048828125,131.83999633789062,16836000.0,0.0,0.0,-0.100006103515625,0.100006103515625,0.0,65.95741700311663,118.68499755859376,134.07000732421875,85.50530015710045,-14.494699842899546,2.5354146728551967,2.1290715967438083,0.01681314680093826,249302800.0,-1.0
150,2023-08-09,GOOG,132.19000244140625,132.47000122070312,129.5050048828125,130.14999389648438,17745200.0,0.0,0.0,-1.69000244140625,1.69000244140625,0.0,56.52203235092544,119.06999969482422,134.07000732421875,73.86659044057696,-26.133409559423036,2.434247769665177,2.190106831328082,0.00215599283763912,231557600.0,-1.0
151,2023-08-10,GOOG,131.97000122070312,132.64700317382812,130.03500366210938,130.2100067138672,17855700.0,0.0,0.0,0.0600128173828125,0.0,0.0600128173828125,56.775388621730066,121.37999725341795,134.07000732421875,69.58236763552088,-30.417632364479118,2.3320325189918094,2.218491968860828,-0.0210509578874154,249413300.0,1.0
152,2023-08-11,GOOG,129.20199584960938,130.44000244140625,128.75,130.1699981689453,15191500.0,0.0,0.0,-0.040008544921875,0.040008544921875,0.0,56.52202934139422,121.52999877929688,134.07000732421875,68.89946971485308,-31.100530285146906,2.2221819106925977,2.219229957227182,-0.022087013957819868,234221800.0,-1.0
153,2023-08-14,GOOG,129.85000610351562,131.91000366210938,129.58999633789062,131.8300018310547,17526200.0,0.0,0.0,1.660003662109375,0.0,1.660003662109375,64.17553794868769,127.7750015258789,134.07000732421875,64.41614885001678,-35.58385114998322,2.2432136575463204,2.2240266972910097,-0.0004549060495215862,251748000.0,1.0
154,2023-08-15,GOOG,131.58999633789062,131.99000549316406,129.81900024414062,130.27000427246094,14769200.0,0.0,0.0,-1.55999755859375,1.55999755859375,0.0,53.889298708443064,127.7750015258789,134.07000732421875,39.63463778286,-60.36536221714,2.109684319218047,2.201158221676417,0.012671057917803985,236978800.0,-1.0
155,2023-08-16,GOOG,129.27999877929688,130.8979949951172,128.4600067138672,129.11000061035156,17548400.0,0.0,0.0,-1.160003662109375,1.160003662109375,0.0,47.374314195949744,127.7750015258789,134.07000732421875,21.207273309021097,-78.7927266909789,1.8884899353794538,2.1386245644170248,0.0026403380182487,219430400.0,-1.0
156,2023-08-17,GOOG,130.4499969482422,132.49099731445312,129.85000610351562,130.4600067138672,23665600.0,0.0,0.0,1.350006103515625,0.0,1.350006103515625,54.724501043124064,127.7750015258789,133.8300018310547,44.343601200038805,-55.656398799961195,1.8013604618474517,2.0711717439031103,0.01493708983989439,243096000.0,1.0
157,2023-08-18,GOOG,129.05999755859375,129.8300018310547,127.0,128.11000061035156,23619400.0,0.0,0.0,-2.350006103515625,2.350006103515625,0.0,42.73576801921133,127.0,132.9199981689453,18.750016109368435,-81.24998389063155,1.525104330211235,1.9619582611647353,-0.029028359558774253,219476600.0,-1.0
158,2023-08-21,GOOG,127.8499984741211,129.25999450683594,127.16000366210938,128.92999267578125,21851100.0,0.0,0.0,0.8199920654296875,0.0,0.8199920654296875,47.37721971444658,127.0,132.64700317382812,34.17729043833529,-65.82270956166471,1.3566964126086418,1.8409058914535166,-0.022072237127884753,241327700.0,1.0
159,2023-08-22,GOOG,129.1300048828125,130.9499969482422,128.9250030517578,129.69000244140625,15569400.0,0.0,0.0,0.760009765625,0.0,0.760009765625,51.5748020959644,127.0,132.64700317382812,47.6359293345799,-52.364070665420094,1.269919263211733,1.7267085658051597,-0.0035343179150970627,256897100.0,1.0
160,2023-08-23,GOOG,130.85000610351562,134.07000732421875,130.50999450683594,133.2100067138672,26497000.0,0.0,0.0,3.5200042724609375,0.0,3.5200042724609375,66.0479585169985,127.0,134.07000732421875,87.83593041826737,-12.164069581732637,1.4682564257472563,1.675018137793579,0.023039703903805275,283394100.0,1.0
161,2023-08-24,GOOG,134.7270050048828,134.97000122070312,130.3000030517578,130.4199981689453,18680400.0,0.0,0.0,-2.790008544921875,2.790008544921875,0.0,51.869880839667,127.0,134.97000122070312,42.910886388090105,-57.089113611909895,1.384352516860588,1.616885013606981,0.0019205654414740092,264713700.0,-1.0
162,2023-08-25,GOOG,130.13999938964844,131.39999389648438,128.0399932861328,130.69000244140625,20678100.0,0.0,0.0,0.2700042724609375,0.0,0.2700042724609375,52.99656087302011,127.0,134.97000122070312,46.29864336558674,-53.70135663441326,1.324378464456828,1.5583837037769506,-0.008647495818966844,285391800.0,1.0
163,2023-08-28,GOOG,132.0800018310547,133.24000549316406,130.85000610351562,131.7899932861328,16715500.0,0.0,0.0,1.0999908447265625,0.0,1.0999908447265625,57.65607964852642,127.0,134.97000122070312,60.1002829672118,-39.8997170327882,1.3500458975576066,1.516716142533082,0.011667989282419855,302107300.0,1.0
164,2023-08-29,GOOG,132.9980010986328,137.2949981689453,132.97999572753906,135.49000549316406,30803300.0,0.0,0.0,3.70001220703125,0.0,3.70001220703125,69.42115085910211,127.0,137.2949981689453,82.46728512078828,-17.53271487921173,1.6499273950223312,1.543358393030932,0.049415264910942724,332910600.0,1.0
165,2023-08-30,GOOG,135.57000732421875,137.25,135.02099609375,136.92999267578125,21773400.0,0.0,0.0,1.4399871826171875,0.0,1.4399871826171875,72.81321964783572,127.0,137.2949981689453,96.45453561842201,-3.545464381577992,1.980945149322764,1.630875744289299,0.04959363505249881,354684000.0,1.0
166,2023-08-31,GOOG,137.0500030517578,138.39999389648438,136.82000732421875,137.35000610351562,28147900.0,0.0,0.0,0.420013427734375,0.0,0.420013427734375,73.79166245126497,127.0,138.39999389648438,90.78957583220676,-9.21042416779323,2.25121991619784,1.7549445786710072,0.07212555966858258,382831900.0,1.0
167,2023-09-01,GOOG,138.42999267578125,138.5800018310547,135.94000244140625,136.8000030517578,16665700.0,0.0,0.0,-0.5500030517578125,0.5500030517578125,0.0,69.98593016211655,127.0,138.5800018310547,84.62868309292179,-15.371316907078207,2.3934439189637544,1.8826444467295567,0.06104095883854721,366166200.0,-1.0
168,2023-09-05,GOOG,136.44000244140625,137.3699951171875,135.55999755859375,136.7100067138672,17730200.0,0.0,0.0,-0.089996337890625,0.089996337890625,0.0,69.3110278365991,127.0,138.5800018310547,83.85151276770408,-16.14848723229592,2.470418074402488,2.0001991722641432,0.05412910895450529,348436000.0,-1.0
169,2023-09-06,GOOG,137.01499938964844,137.47999572753906,134.69000244140625,135.3699951171875,15814300.0,0.0,0.0,-1.3400115966796875,1.3400115966796875,0.0,59.45989939433755,127.0,138.5800018310547,72.279739151174,-27.720260848826012,2.3956772326562543,2.0792947843425655,0.016214911001092736,332621700.0,-1.0
170,2023-09-07,GOOG,134.60000610351562,136.5800018310547,133.9600067138672,136.1999969482422,16976000.0,0.0,0.0,0.8300018310546875,0.0,0.8300018310546875,63.198175639766184,127.0,138.5800018310547,79.44728405456794,-20.55271594543205,2.376029275369092,2.138641682547871,0.04431834734278639,349597700.0,1.0
171,2023-09-08,GOOG,135.8699951171875,137.51499938964844,135.8699951171875,137.1999969482422,17810700.0,0.0,0.0,1.0,0.0,1.0,67.37977463186597,127.16000366210938,138.5800018310547,87.91589225850156,-12.084107741498434,2.4133302606720406,2.1935793981727048,0.04981249051360792,367408400.0,1.0
172,2023-09-11,GOOG,137.3800048828125,138.26400756835938,136.5500030517578,137.74000549316406,17180800.0,0.0,0.0,0.540008544921875,0.0,0.540008544921875,69.5365302605571,128.0399932861328,138.5800018310547,92.03040173724213,-7.969598262757873,2.4581298714350908,2.246489492825182,0.04514767820128052,384589200.0,1.0
173,2023-09-12,GOOG,137.1300048828125,137.63999938964844,135.92999267578125,136.07000732421875,15212900.0,0.0,0.0,-1.6699981689453125,1.6699981689453125,0.0,56.262661356868044,128.0399932861328,138.5800018310547,76.18602967788635,-23.813970322113644,2.331997360344957,2.263591066329137,0.004280772068342431,369376300.0,-1.0
174,2023-09-13,GOOG,135.89999389648438,137.6999969482422,134.92999267578125,137.5,16394900.0,0.0,0.0,1.42999267578125,0.0,1.42999267578125,63.20275777583684,128.0399932861328,138.5800018310547,89.75331161780673,-10.246688382193268,2.3206734597932837,2.2750075450219667,0.004162764585611267,385771200.0,1.0
175,2023-09-14,GOOG,138.38999938964844,139.5500030517578,137.05999755859375,138.99000549316406,19064600.0,0.0,0.0,1.4900054931640625,0.0,1.4900054931640625,69.09800054873799,128.0399932861328,139.5500030517578,95.13469084738573,-4.865309152614275,2.404215724061686,2.3008491808299105,0.011940293533095447,404835800.0,1.0
176,2023-09-15,GOOG,138.8000030517578,139.36000061035156,137.17999267578125,138.3000030517578,48947600.0,0.0,0.0,-0.69000244140625,0.69000244140625,0.0,63.64932566965471,130.85000610351562,139.5500030517578,85.63217886814823,-14.367821131851768,2.387227721445072,2.318124888952943,0.01096491203609462,355888200.0,-1.0
177,2023-09-18,GOOG,137.6300048828125,139.92999267578125,137.6300048828125,138.9600067138672,16233600.0,0.0,0.0,0.660003662109375,0.0,0.660003662109375,66.5596405232053,132.97999572753906,139.92999267578125,86.04336132608815,-13.95663867391185,2.3993629638765412,2.334372503937663,0.01645819537343174,372121800.0,1.0
178,2023-09-19,GOOG,138.25,139.1750030517578,137.5,138.8300018310547,15479100.0,0.0,0.0,-0.1300048828125,0.1300048828125,0.0,65.37013056514931,133.9600067138672,139.92999267578125,81.57464939207513,-18.425350607924877,2.3711567104769813,2.341729345245527,0.025559627972741916,356642700.0,-1.0
179,2023-09-20,GOOG,138.8300018310547,138.83999633789062,134.52000427246094,134.58999633789062,21473500.0,0.0,0.0,-4.2400054931640625,4.2400054931640625,0.0,39.084574656560136,133.9600067138672,139.92999267578125,10.552614830964425,-89.44738516903557,1.9838023075053854,2.270143937697499,-0.011820856434845428,335169200.0,-1.0
180,2023-09-21,GOOG,132.38999938964844,133.19000244140625,131.08999633789062,131.36000061035156,22042700.0,0.0,0.0,-3.2299957275390625,3.2299957275390625,0.0,28.877855099000655,131.08999633789062,139.92999267578125,3.054348238851931,-96.94565176114807,1.4000488162230056,2.0961249134026003,-0.04256557192267085,313126500.0,-1.0
181,2023-09-22,GOOG,131.67999267578125,133.00999450683594,130.50999450683594,131.25,17348700.0,0.0,0.0,-0.1100006103515625,0.1100006103515625,0.0,28.584527542620037,130.50999450683594,139.92999267578125,7.855686167791638,-92.14431383220835,0.9179621518642591,1.860492361094932,-0.047117796096546205,295777800.0,-1.0
182,2023-09-25,GOOG,130.77000427246094,132.22000122070312,130.02999877929688,132.1699981689453,14650000.0,0.0,0.0,0.9199981689453125,0.0,0.9199981689453125,34.95994471589117,130.02999877929688,139.92999267578125,21.616168777724003,-78.383831222276,0.6031879351612588,1.6090314759081976,-0.02866178397404473,310427800.0,1.0
183,2023-09-26,GOOG,130.91400146484375,131.40499877929688,128.19000244140625,129.4499969482422,20378800.0,0.0,0.0,-2.720001220703125,2.720001220703125,0.0,26.798647225998522,128.19000244140625,139.92999267578125,10.732500467901927,-89.26749953209807,0.13271601219662443,1.313768383165883,-0.058545476740056834,290049000.0,-1.0
184,2023-09-27,GOOG,129.44000244140625,131.72000122070312,129.3800048828125,131.4600067138672,18764200.0,0.0,0.0,2.010009765625,0.0,2.010009765625,38.95061805616846,128.19000244140625,139.92999267578125,27.8535518955227,-72.1464481044773,-0.07705721490015094,1.0356032635526762,-0.05417654854087495,308813200.0,1.0
185,2023-09-28,GOOG,130.69000244140625,134.17999267578125,130.69000244140625,133.1300048828125,18201400.0,0.0,0.0,1.6699981689453125,0.0,1.6699981689453125,47.332408590297646,128.19000244140625,139.92999267578125,42.078420363091894,-57.921579636908106,-0.1073121600981608,0.8070201788225088,-0.0373824877430442,327014600.0,1.0
186,2023-09-29,GOOG,134.0800018310547,134.88999938964844,131.32000732421875,131.85000610351562,23224200.0,0.0,0.0,-1.279998779296875,1.279998779296875,0.0,42.20749468989829,128.19000244140625,139.92999267578125,31.175525609832178,-68.82447439016782,-0.23190135756803443,0.5992358715444002,-0.05116580502900936,303790400.0,-1.0
187,2023-10-02,GOOG,132.15499877929688,135.36000061035156,132.06500244140625,135.1699981689453,19210400.0,0.0,0.0,3.3199920654296875,0.0,3.3199920654296875,56.35150685309942,128.19000244140625,139.92999267578125,59.45486825961278,-40.54513174038721,-0.06202868142364082,0.46698296095079195,-0.026363204018129416,323000800.0,1.0
188,2023-10-03,GOOG,134.92999267578125,135.24000549316406,132.81500244140625,133.3000030517578,19628700.0,0.0,0.0,-1.8699951171875,1.8699951171875,0.0,48.61841406692091,128.19000244140625,139.92999267578125,43.52644685673883,-56.47355314326117,-0.07740400747215403,0.35810556726620274,-0.009584614913683898,303372100.0,-1.0
189,2023-10-04,GOOG,133.66000366210938,136.57000732421875,133.42999267578125,136.27000427246094,22848000.0,0.0,0.0,2.970001220703125,0.0,2.970001220703125,58.94349996821682,128.19000244140625,139.92999267578125,68.82460436292554,-31.17539563707447,0.14835497012853693,0.3161554478386696,0.037378225025087586,326220100.0,1.0
190,2023-10-05,GOOG,136.1300048828125,136.5,134.4550018310547,135.99000549316406,15922900.0,0.0,0.0,-0.279998779296875,0.279998779296875,0.0,57.68260630942744,128.19000244140625,139.92999267578125,66.43960425894733,-33.56039574105267,0.30120492966969437,0.3131653442048746,0.0361143275669642,310297200.0,-1.0
191,2023-10-06,GOOG,134.94000244140625,139.18600463867188,134.94000244140625,138.72999572753906,20819300.0,0.0,0.0,2.739990234375,0.0,2.739990234375,65.915312872609,128.19000244140625,139.18600463867188,95.85295725708195,-4.147042742918042,0.636101277827521,0.3777525309294039,0.04963303056271884,331116500.0,1.0
192,2023-10-09,GOOG,137.99000549316406,139.97000122070312,136.6999969482422,139.5,16599100.0,0.0,0.0,0.7700042724609375,0.0,0.7700042724609375,67.93790208755826,128.19000244140625,139.97000122070312,96.0101759812646,-3.9898240187354115,0.9526602597044871,0.4927340766844207,0.0776361783598658,347715600.0,1.0
193,2023-10-10,GOOG,139.50999450683594,140.74000549316406,138.42999267578125,139.1999969482422,19554900.0,0.0,0.0,-0.3000030517578125,0.3000030517578125,0.0,66.17264757310724,128.19000244140625,140.74000549316406,87.7290185622212,-12.270981437778806,1.165888167257208,0.6273648947989783,0.05887714771855812,328160700.0,-1.0
194,2023-10-11,GOOG,139.85000610351562,142.22000122070312,139.83999633789062,141.6999969482422,20146300.0,0.0,0.0,2.5,0.0,2.5,72.93459726941926,128.19000244140625,142.22000122070312,96.29362567566098,-3.7063743243390213,1.5190907363194128,0.8057100631030653,0.06437310712166955,348307000.0,1.0
195,2023-10-12,GOOG,142.16000366210938,142.3800048828125,139.4499969482422,140.2899932861328,18173100.0,0.0,0.0,-1.410003662109375,1.410003662109375,0.0,64.53895380354427,128.19000244140625,142.3800048828125,85.27123863924744,-14.728761360752552,1.6660259235711692,0.9777732351966861,0.06401203482683915,330133900.0,-1.0
196,2023-10-13,GOOG,140.64999389648438,141.33999633789062,137.97000122070312,138.5800018310547,19438700.0,0.0,0.0,-1.709991455078125,1.709991455078125,0.0,55.58527052155087,128.19000244140625,142.3800048828125,73.2205609727772,-26.779439027222796,1.6257504912114484,1.1073686863996386,0.025227518741602006,310695200.0,-1.0
197,2023-10-16,GOOG,139.72999572753906,140.90499877929688,139.32000732421875,140.49000549316406,17345600.0,0.0,0.0,1.910003662109375,0.0,1.910003662109375,62.322088260525845,129.3800048828125,142.3800048828125,85.46154315655048,-14.538456843449518,1.7280335239749718,1.2315016539147052,0.05393850170141801,328040800.0,1.0
198,2023-10-17,GOOG,140.02999877929688,141.25,138.5290069580078,140.99000549316406,17424000.0,0.0,0.0,0.5,0.0,0.5,63.97269372805519,130.69000244140625,142.3800048828125,88.10950299954577,-11.89049700045424,1.8283631442112949,1.3508739519740234,0.034637125359340715,345464800.0,1.0
199,2023-10-18,GOOG,140.75,141.99000549316406,138.7050018310547,139.27999877929688,18304900.0,0.0,0.0,-1.7100067138671875,1.7100067138671875,0.0,54.54348857996796,131.32000732421875,142.3800048828125,71.97100553510626,-28.028994464893742,1.7497221581426743,1.4306435932077537,0.024192905016819033,327159900.0,-1.0
200,2023-10-19,GOOG,139.8000030517578,141.0050048828125,138.60000610351562,138.97999572753906,21831200.0,0.0,0.0,-0.3000030517578125,0.3000030517578125,0.0,52.96322110929669,132.06500244140625,142.3800048828125,67.03821279164029,-32.961787208359716,1.6442371327557908,1.4733623011173613,0.0018020616139209356,305328700.0,-1.0
201,2023-10-20,GOOG,138.58999633789062,139.0399932861328,136.2449951171875,136.74000549316406,24953900.0,0.0,0.0,-2.239990234375,2.239990234375,0.0,42.38391628276739,132.81500244140625,142.3800048828125,41.03504495478997,-58.96495504521003,1.3641657741503366,1.4515229957239566,-0.019784906859038998,280374800.0,-1.0
202,2023-10-23,GOOG,136.22999572753906,139.02000427246094,135.11000061035156,137.89999389648438,20780700.0,0.0,0.0,1.1599884033203125,0.0,1.1599884033203125,48.52739449659271,133.42999267578125,142.3800048828125,49.94407959791867,-50.055920402081334,1.2217252717277347,1.4055634509247124,-0.009339102588063919,301155500.0,1.0
203,2023-10-24,GOOG,139.16000366210938,140.7100067138672,138.75,140.1199951171875,26535200.0,0.0,0.0,2.220001220703125,0.0,2.220001220703125,58.33731183809484,134.4550018310547,142.3800048828125,71.48253759821938,-28.51746240178061,1.2732978817523701,1.379110337090244,-0.011150330734529312,327690700.0,1.0
204,2023-10-25,GOOG,129.77000427246094,130.10000610351562,126.08999633789062,126.66999816894533,58796100.0,0.0,0.0,-13.449996948242173,13.449996948242173,0.0,25.012649017770826,126.08999633789062,142.3800048828125,3.5604759166041515,-96.43952408339584,0.22625916588498285,1.1485401028491917,-0.09708458029082945,268894600.0,-1.0
205,2023-10-26,GOOG,124.47000122070312,125.45999908447266,122.31999969482422,123.44000244140624,33907400.0,0.0,0.0,-3.229995727539091,3.229995727539091,0.0,21.594505571092796,122.31999969482422,142.3800048828125,5.583262497123694,-94.4167375028763,-0.8543122088306063,0.747969640513232,-0.10925096831868919,234987200.0,-1.0
206,2023-10-27,GOOG,124.02999877929688,124.44000244140624,121.45999908447266,123.4000015258789,37367700.0,0.0,0.0,-0.04000091552732954,0.04000091552732954,0.0,21.55241910027172,121.45999908447266,142.3800048828125,9.273431662051468,-90.72656833794854,-1.6943689160224835,0.25950192920608883,-0.12164569221343446,197619500.0,-1.0
207,2023-10-30,GOOG,124.45999908447266,126.5500030517578,123.87999725341795,125.75,24165600.0,0.0,0.0,2.3499984741210938,0.0,2.3499984741210938,30.706919888873287,121.45999908447266,142.3800048828125,20.506690853153525,-79.49330914684649,-2.1457597078545234,-0.22155039820603378,-0.10809280728698867,221785100.0,1.0
208,2023-10-31,GOOG,126.2699966430664,126.55999755859376,123.9250030517578,125.3000030517578,21123400.0,0.0,0.0,-0.4499969482422017,0.4499969482422017,0.0,29.93508310206269,121.45999908447266,142.3800048828125,18.355654411863856,-81.64434558813615,-2.5108575482357764,-0.6794118282119825,-0.10037331885457423,200661700.0,-1.0
209,2023-11-01,GOOG,125.33999633789062,127.73999786376952,124.9250030517578,127.56999969482422,26536600.0,0.0,0.0,2.2699966430664205,0.0,2.2699966430664205,38.87748144998901,121.45999908447266,141.99000549316406,29.76131857301752,-70.23868142698248,-2.587206765596278,-1.0609708156888418,-0.08209811759588315,227198300.0,1.0
210,2023-11-02,GOOG,129.55999755859375,130.08999633789062,128.11000061035156,128.5800018310547,24091700.0,0.0,0.0,1.0100021362304688,0.0,1.0100021362304688,42.636171494985895,121.45999908447266,141.99000549316406,34.68095725273504,-65.31904274726496,-2.5369707258906544,-1.3561707977292043,-0.05967532056679137,251290000.0,1.0
211,2023-11-03,GOOG,129.08999633789062,130.72999572753906,129.00999450683594,130.3699951171875,19517900.0,0.0,0.0,1.7899932861328125,0.0,1.7899932861328125,49.043957247361945,121.45999908447266,141.99000549316406,43.39986970945506,-56.600130290544946,-2.3259091813682744,-1.5501184744570184,-0.05460477964160981,270807900.0,1.0
212,2023-11-06,GOOG,130.22000122070312,131.55999755859375,129.92999267578125,131.4499969482422,15360400.0,0.0,0.0,1.0800018310546875,0.0,1.0800018310546875,52.72068934116543,121.45999908447266,141.99000549316406,48.66047123852943,-51.33952876147057,-2.0478874985803373,-1.6496722792816825,-0.061875524343933064,286168300.0,1.0
213,2023-11-07,GOOG,131.97999572753906,133.27999877929688,131.13999938964844,132.39999389648438,19223800.0,0.0,0.0,0.9499969482421875,0.0,0.9499969482421875,55.946870036647944,121.45999908447266,141.0050048828125,55.9733515808983,-44.026648419101704,-1.7309432661129733,-1.665926476647941,0.045235618618204354,305392100.0,1.0
214,2023-11-08,GOOG,132.36000061035156,133.5399932861328,132.16000366210938,133.25999450683594,15093600.0,0.0,0.0,0.8600006103515625,0.0,0.8600006103515625,58.87788132136707,121.45999908447266,140.7100067138672,61.29865322414122,-38.70134677585878,-1.3942952529344552,-1.611600231905244,0.07955275333124678,320485700.0,1.0
215,2023-11-09,GOOG,133.36000061035156,133.9600067138672,131.50999450683594,131.69000244140625,17976500.0,0.0,0.0,-1.5699920654296875,1.5699920654296875,0.0,51.64055395778315,121.45999908447266,140.7100067138672,53.142853519250046,-46.857146480749954,-1.2398918077795145,-1.5372585470800983,0.06717990934375151,302509200.0,-1.0
216,2023-11-10,GOOG,131.52999877929688,134.27000427246094,130.8699951171875,134.05999755859375,20872900.0,0.0,0.0,2.3699951171875,0.0,2.3699951171875,60.16859965891016,121.45999908447266,140.7100067138672,65.45451158617229,-34.545488413827705,-0.9157311966639838,-1.4129530769968757,0.06608347959120286,323382100.0,1.0
217,2023-11-13,GOOG,133.36000061035156,134.11000061035156,132.77000427246094,133.63999938964844,16409900.0,0.0,0.0,-0.4199981689453125,0.4199981689453125,0.0,58.07448051116935,121.45999908447266,134.27000427246094,95.08193108771536,-4.91806891228463,-0.6848276506511013,-1.267327991727721,0.06656022453922539,306972200.0,-1.0
218,2023-11-14,GOOG,135.64999389648438,137.24000549316406,135.10000610351562,135.42999267578125,22317300.0,0.0,0.0,1.7899932861328125,0.0,1.7899932861328125,64.20148751300847,121.45999908447266,137.24000549316406,88.52970797029663,-11.470292029703376,-0.3533245295048175,-1.0845272992831403,0.06161317707736824,329289500.0,1.0
219,2023-11-15,GOOG,136.63999938964844,136.83999633789062,135.3300018310547,136.3800048828125,15840900.0,0.0,0.0,0.95001220703125,0.0,0.95001220703125,67.14208521485153,121.45999908447266,137.24000549316406,94.55006171684515,-5.4499382831548555,-0.013788925244170969,-0.8703796244753463,0.06066264536227406,345130400.0,1.0
220,2023-11-16,GOOG,136.9600067138672,138.8800048828125,136.0800018310547,138.6999969482422,17615100.0,0.0,0.0,2.3199920654296875,0.0,2.3199920654296875,73.31791844889433,123.87999725341795,138.8800048828125,98.79994771324274,-1.2000522867572587,0.4374567219987,-0.608812355180537,0.06389508432187152,362745500.0,1.0
221,2023-11-17,GOOG,137.82000732421875,138.0,135.47999572753906,136.94000244140625,25565300.0,0.0,0.0,-1.7599945068359375,1.7599945068359375,0.0,62.95957987891596,123.9250030517578,138.8800048828125,87.02773517969251,-12.972264820307489,0.6456130797896549,-0.35792726818649856,0.041764972389658706,337180200.0,-1.0
222,2023-11-20,GOOG,135.5,138.4250030517578,135.49000549316406,137.9199981689453,19569400.0,0.0,0.0,0.9799957275390625,0.0,0.9799957275390625,66.04194160379468,124.9250030517578,138.8800048828125,93.12069804440412,-6.879301955595885,0.8795174259704766,-0.11043832935510349,0.041691877091600826,356749600.0,1.0
223,2023-11-21,GOOG,137.94000244140625,138.96499633789062,137.7050018310547,138.6199951171875,17648100.0,0.0,0.0,0.6999969482421875,0.0,0.6999969482421875,68.22146456443802,128.11000061035156,138.96499633789062,96.82172863663263,-3.178271363367365,1.1085930368272727,0.13336794388137183,0.040222128405360325,374397700.0,1.0
224,2023-11-22,GOOG,139.10000610351562,141.10000610351562,139.0,140.02000427246094,17306400.0,0.0,0.0,1.4000091552734375,0.0,1.4000091552734375,72.32113964522637,129.00999450683594,141.10000610351562,91.06699094191694,-8.933009058083048,1.3871163304007155,0.3841176211852406,0.06325462583813835,391704100.0,1.0
225,2023-11-24,GOOG,139.5399932861328,139.677001953125,137.47000122070312,138.22000122070312,8828600.0,0.0,0.0,-1.8000030517578125,1.8000030517578125,0.0,60.70346266030468,129.92999267578125,141.10000610351562,74.21663902693577,-25.78336097306424,1.445935009090391,0.5964810987662709,0.031030909576819532,382875500.0,-1.0
226,2023-11-27,GOOG,137.57000732421875,139.6300048828125,137.5399932861328,138.0500030517578,17886400.0,0.0,0.0,-0.1699981689453125,0.1699981689453125,0.0,59.65910400204261,130.8699951171875,141.10000610351562,70.18573043729882,-29.814269562701174,1.4619790203709044,0.7695806830871976,0.032999129618755285,364989100.0,-1.0
227,2023-11-28,GOOG,137.6300048828125,138.66000366210938,137.0399932861328,138.6199951171875,17046900.0,0.0,0.0,0.5699920654296875,0.0,0.5699920654296875,62.1766024824985,130.8699951171875,141.10000610351562,75.7574943991504,-24.242505600849597,1.5033578365395783,0.9163361137776739,0.023554623155323418,382036000.0,1.0
228,2023-11-29,GOOG,138.98500061035156,139.6699981689453,136.2949981689453,136.39999389648438,21014700.0,0.0,0.0,-2.220001220703125,2.220001220703125,0.0,48.55838608757429,130.8699951171875,141.10000610351562,54.056626006437625,-45.94337399356238,1.3415507430281934,1.001379039627778,0.0001465685067914002,361021300.0,-1.0
229,2023-11-30,GOOG,136.39999389648438,136.9600067138672,132.7899932861328,133.9199981689453,29913500.0,0.0,0.0,-2.4799957275390625,2.4799957275390625,0.0,37.86765737965747,130.8699951171875,141.10000610351562,29.814269562701174,-70.18573043729882,1.0016560628565685,1.0014344442735361,-0.034462861459763405,331107800.0,-1.0
230,2023-12-01,GOOG,133.32000732421875,133.5,132.15199279785156,133.32000732421875,24258400.0,0.0,0.0,-0.5999908447265625,0.5999908447265625,0.0,35.675105260280674,132.15199279785156,141.10000610351562,13.053339176729187,-86.94666082327082,0.6760794114482565,0.9363634377084802,-0.026434898880160485,306849400.0,-1.0
231,2023-12-04,GOOG,131.29400634765625,131.4499969482422,129.39999389648438,130.6300048828125,24117100.0,0.0,0.0,-2.69000244140625,2.69000244140625,0.0,27.452355723476913,129.39999389648438,141.10000610351562,10.512903444570226,-89.48709655542977,0.1987062949265237,0.788832009152089,-0.0528566805605879,282732300.0,-1.0
232,2023-12-05,GOOG,130.3699951171875,133.5399932861328,129.72999572753906,132.38999938964844,19235100.0,0.0,0.0,1.7599945068359375,0.0,1.7599945068359375,38.204924115174926,129.39999389648438,141.10000610351562,25.555575842623362,-74.44442415737664,-0.03717002061145536,0.6236316031993802,-0.04494298042841727,301967400.0,1.0
233,2023-12-06,GOOG,132.89999389648438,133.30999755859375,131.30999755859375,131.42999267578125,16360600.0,0.0,0.0,-0.9600067138671875,0.9600067138671875,0.0,34.945155728500836,129.39999389648438,141.10000610351562,17.350398814771538,-82.64960118522846,-0.2981315428046116,0.4392789739985818,-0.06134845975268388,285606800.0,-1.0
234,2023-12-07,GOOG,136.60000610351562,140.0,136.22999572753906,138.4499969482422,38419400.0,0.0,0.0,7.0200042724609375,0.0,7.0200042724609375,62.17544454414831,129.39999389648438,141.10000610351562,77.35037273139864,-22.649627268601357,0.06080926819416277,0.363585032837698,0.001663982965618871,324026200.0,1.0
235,2023-12-08,GOOG,135.66000366210938,137.99000549316406,135.57000732421875,136.63999938964844,22990900.0,0.0,0.0,-1.80999755859375,1.80999755859375,0.0,55.2903421567296,129.39999389648438,141.10000610351562,61.880324268491805,-38.11967573150819,0.19695045025784452,0.33025811632172736,-0.01021371699340512,301035300.0,-1.0
236,2023-12-11,GOOG,133.82000732421875,134.7899932861328,132.88999938964844,134.6999969482422,24502900.0,0.0,0.0,-1.94000244140625,1.94000244140625,0.0,48.63038539807168,129.39999389648438,141.10000610351562,45.29912412033825,-54.70087587966175,0.1466112921515048,0.29352875148768287,-0.028278735442397007,276532400.0,-1.0
237,2023-12-12,GOOG,133.27000427246094,134.5399932861328,132.8300018310547,133.63999938964844,26584000.0,0.0,0.0,-1.05999755859375,1.05999755859375,0.0,45.19803085667318,129.39999389648438,141.10000610351562,36.239325379643496,-63.760674620356504,0.02094278792984028,0.23901155877611435,-0.02023456473854779,249948400.0,-1.0
238,2023-12-13,GOOG,134.5449981689453,134.77999877929688,132.9499969482422,133.97000122070312,25414500.0,0.0,0.0,0.3300018310546875,0.0,0.3300018310546875,46.5531148684421,129.39999389648438,140.0,43.11325181881782,-56.88674818118218,-0.05142917397083124,0.18092341222672523,0.000373380021217784,275362900.0,1.0
239,2023-12-14,GOOG,134.77000427246094,135.03500366210938,131.05999755859375,133.1999969482422,29619100.0,0.0,0.0,-0.7700042724609375,0.7700042724609375,0.0,43.647399169498904,129.39999389648438,140.0,35.84906475192966,-64.15093524807034,-0.1689696077675933,0.11094480822786151,-0.0009001677871552927,245743800.0,-1.0
240,2023-12-15,GOOG,132.9199981689453,134.8300018310547,132.6300048828125,133.83999633789062,58569400.0,0.0,0.0,0.6399993896484375,0.0,0.6399993896484375,46.83016038221933,129.39999389648438,140.0,41.886791366409376,-58.11320863359062,-0.2080800296909615,0.04713984064409689,0.02457315574593899,304313200.0,1.0
241,2023-12-18,GOOG,133.86000061035156,138.3800048828125,133.77000427246094,137.19000244140625,25699800.0,0.0,0.0,3.350006103515625,0.0,3.350006103515625,60.35407899705313,129.39999389648438,140.0,73.4906043340694,-26.509395665930597,0.03088613634901094,0.043889099785079703,0.036256538060933874,330013000.0,1.0
242,2023-12-19,GOOG,138.0,138.77000427246094,137.4499969482422,138.10000610351562,20661000.0,0.0,0.0,0.910003662109375,0.0,0.910003662109375,63.281390087740846,129.39999389648438,140.0,82.07553959941383,-17.924460400586167,0.2903512459496653,0.09318152901799684,0.050749553370122547,350674000.0,1.0
243,2023-12-20,GOOG,140.3300018310547,143.0780029296875,139.41000366210938,139.66000366210938,33507300.0,0.0,0.0,1.55999755859375,0.0,1.55999755859375,67.96070245965558,129.39999389648438,143.0780029296875,75.01098837351992,-24.989011626480085,0.6147712787306716,0.19749947896053185,0.008739665876045688,384181300.0,1.0
244,2023-12-21,GOOG,140.77000427246094,142.02999877929688,140.47300720214844,141.8000030517578,18101500.0,0.0,0.0,2.1399993896484375,0.0,2.1399993896484375,73.33863988807477,129.39999389648438,143.0780029296875,90.65653579532398,-9.343464204676028,1.0326527785608164,0.3645301388805888,0.037763493011990557,402282800.0,1.0
245,2023-12-22,GOOG,142.1300048828125,143.25,142.05499267578125,142.72000122070312,18494700.0,0.0,0.0,0.9199981689453125,0.0,0.9199981689453125,75.38792423548642,129.72999572753906,143.25,96.07989192446902,-3.9201080755309823,1.4216748580879823,0.5759590827220676,0.05953975095888531,420777500.0,1.0
246,2023-12-26,GOOG,142.97999572753906,143.94500732421875,142.5,142.82000732421875,11170100.0,0.0,0.0,0.100006103515625,0.0,0.100006103515625,75.62293555324659,131.05999755859375,143.94500732421875,91.26892396308999,-8.731076036910018,1.7182405085428343,0.8044153678862211,0.0686920680671701,431947600.0,1.0
247,2023-12-27,GOOG,142.8300018310547,143.32000732421875,141.05099487304688,141.44000244140625,17288400.0,0.0,0.0,-1.3800048828125,1.3800048828125,0.0,65.64293533542661,131.05999755859375,143.94500732421875,80.55876612918507,-19.44123387081494,1.8209255663665829,1.0077174075822937,0.05575876056309803,414659200.0,-1.0
248,2023-12-28,GOOG,141.85000610351562,142.27000427246094,140.8280029296875,141.27999877929688,12192500.0,0.0,0.0,-0.160003662109375,0.160003662109375,0.0,64.50409842422113,131.05999755859375,143.94500732421875,79.31698467135305,-20.68301532864695,1.8678617091298975,1.1797462678918145,0.06066067579711998,402466700.0,-1.0
249,2023-12-29,GOOG,140.67999267578125,141.43499755859375,139.89999389648438,140.92999267578125,14872700.0,0.0,0.0,-0.350006103515625,0.350006103515625,0.0,61.79801208762378,131.05999755859375,143.94500732421875,76.60060253519525,-23.399397464804743,1.855428152319007,1.314882644777253,0.05297367402783926,387594000.0,-1.0
250,2024-01-02,GOOG,139.60000610351562,140.61500549316406,137.74000549316406,139.55999755859375,20071900.0,0.0,0.0,-1.3699951171875,1.3699951171875,0.0,51.95414293870972,131.05999755859375,143.94500732421875,65.96813005665346,-34.031869943346535,1.715254921912674,1.3949571002043373,0.01727527571259957,367522100.0,-1.0
251,2024-01-03,GOOG,138.60000610351562,141.08999633789062,138.42999267578125,140.36000061035156,18974300.0,0.0,0.0,0.8000030517578125,0.0,0.8000030517578125,56.610986360362496,131.05999755859375,143.94500732421875,72.1769189230157,-27.82308107698429,1.6497034327933022,1.4459063667221304,0.016364912432675238,386496400.0,1.0
252,2024-01-04,GOOG,139.85000610351562,140.63499450683594,138.00999450683594,138.0399932861328,18253300.0,0.0,0.0,-2.32000732421875,2.32000732421875,0.0,42.74702823606084,131.05999755859375,143.94500732421875,54.17144305284499,-45.82855694715501,1.3944735806312565,1.4356198095039556,-0.011599673016592371,368243100.0,-1.0
253,2024-01-05,GOOG,138.3520050048828,138.80999755859375,136.85000610351562,137.38999938964844,15433200.0,0.0,0.0,-0.649993896484375,0.649993896484375,0.0,39.61106565592267,132.6300048828125,143.94500732421875,42.06799363486798,-57.932006365132025,1.1267643706201511,1.3738487217271949,-0.031100166200276447,352809900.0,-1.0
254,2024-01-08,GOOG,138.0,140.63999938964844,137.8800048828125,140.52999877929688,17645300.0,0.0,0.0,3.1399993896484375,0.0,3.1399993896484375,57.13798876418227,133.77000427246094,143.94500732421875,66.43727252414037,-33.562727475859624,1.1546643490544284,1.3300118471926416,-0.015344747916724133,370455200.0,1.0
255,2024-01-09,GOOG,140.05999755859375,142.8000030517578,139.7899932861328,142.55999755859375,19579700.0,0.0,0.0,2.029998779296875,0.0,2.029998779296875,64.76618858475095,136.85000610351562,143.94500732421875,80.47907642942246,-19.520923570577533,1.3253019625722686,1.3290698702685673,-0.00182054160685452,390034900.0,1.0
256,2024-01-10,GOOG,142.52000427246094,144.52499389648438,142.4600067138672,143.8000030517578,16641900.0,0.0,0.0,1.2400054931640625,0.0,1.2400054931640625,68.69321421483536,136.85000610351562,144.52499389648438,90.55385019125704,-9.446149808742952,1.5428070611173155,1.371817308438317,0.016685524389249196,406676800.0,1.0
257,2024-01-11,GOOG,144.89500427246094,146.66000366210938,142.21499633789062,143.6699981689453,17471100.0,0.0,0.0,-0.1300048828125,0.1300048828125,0.0,67.77934210977125,136.85000610351562,146.66000366210938,69.52083346295271,-30.47916653704729,1.6852644318886973,1.4345067331283932,0.016916756867913163,389205700.0,-1.0
258,2024-01-12,GOOG,144.33999633789062,144.74000549316406,143.36000061035156,144.24000549316406,13995200.0,0.0,0.0,0.57000732421875,0.0,0.57000732421875,69.8111683622551,136.85000610351562,146.66000366210938,75.3313071232587,-24.668692876741307,1.8231417090304092,1.5122337283087965,0.023486929606231666,403200900.0,1.0
259,2024-01-16,GOOG,143.42999267578125,145.83999633789062,143.05599975585938,144.0800018310547,19198900.0,0.0,0.0,-0.160003662109375,0.160003662109375,0.0,68.41385560616567,136.85000610351562,146.66000366210938,73.70028060002363,-26.299719399976357,1.8976248481873483,1.5893119522845072,0.03238753476305578,384002000.0,-1.0
260,2024-01-17,GOOG,142.91000366210938,143.41000366210938,140.50999450683594,142.88999938964844,17884500.0,0.0,0.0,-1.19000244140625,1.19000244140625,0.0,58.385306249665405,136.85000610351562,146.66000366210938,61.56977359124478,-38.43022640875522,1.839426260072969,1.6393348138421997,0.018025069594580057,366117500.0,-1.0
261,2024-01-18,GOOG,143.44000244140625,145.5850067138672,143.35000610351562,144.99000549316406,18876800.0,0.0,0.0,2.100006103515625,0.0,2.100006103515625,67.95121494514633,136.85000610351562,146.66000366210938,82.97656896476634,-17.023431035233656,1.9403888071657036,1.6995456125069008,0.05034781617690376,384994300.0,1.0
262,2024-01-19,GOOG,146.30499267578125,148.0399932861328,145.8000030517578,147.97000122070312,27170900.0,0.0,0.0,2.9799957275390625,0.0,2.9799957275390625,76.7151032825166,136.85000610351562,148.0399932861328,99.37451165682822,-0.6254883431717864,2.2350982814248255,1.8066561462904858,0.07700707386313477,412165200.0,1.0
263,2024-01-22,GOOG,148.7100067138672,150.01499938964844,147.5800018310547,147.7100067138672,21829200.0,0.0,0.0,-0.2599945068359375,0.2599945068359375,0.0,74.65983404034421,136.85000610351562,150.01499938964844,82.49150131957009,-17.508498680429913,2.419784509660701,1.9292818189645289,0.05109235036603499,390336000.0,-1.0
264,2024-01-23,GOOG,147.72000122070312,148.86000061035156,147.19000244140625,148.67999267578125,14113600.0,0.0,0.0,0.9699859619140625,0.0,0.9699859619140625,77.28008957556571,136.85000610351562,150.01499938964844,89.85941971369328,-10.140580286306722,2.6142836026005796,2.066282175691739,0.04292925941354708,404449600.0,1.0
265,2024-01-24,GOOG,150.2899932861328,151.57000732421875,149.83999633789062,150.35000610351562,19245000.0,0.0,0.0,1.670013427734375,0.0,1.670013427734375,81.15182682250463,136.85000610351562,151.57000732421875,91.71194891623216,-8.288051083767844,2.8700969703097314,2.2270451346153375,0.045549394386315,423694600.0,1.0
266,2024-01-25,GOOG,151.74000549316406,154.75999450683594,151.22000122070312,153.63999938964844,21495100.0,0.0,0.0,3.2899932861328125,0.0,3.2899932861328125,86.4144252656503,136.85000610351562,154.75999450683594,93.74653354337255,-6.253466456627439,3.3002624977899018,2.4416886072502506,0.06939515102505345,445189700.0,1.0
267,2024-01-26,GOOG,152.8699951171875,154.11000061035156,152.8000030517578,153.7899932861328,19494500.0,0.0,0.0,0.149993896484375,0.0,0.149993896484375,86.61107937171423,137.8800048828125,154.75999450683594,94.2535437384237,-5.746456261576303,3.611642267474707,2.6756793392951423,0.06620900879972136,464684200.0,1.0
268,2024-01-29,GOOG,153.63999938964844,155.1999969482422,152.9199981689453,154.83999633789062,20909300.0,0.0,0.0,1.0500030517578125,0.0,1.0500030517578125,88.01264445762487,139.7899932861328,155.1999969482422,97.66385123426839,-2.3361487657315996,3.8982033871655517,2.9201841488692244,0.07468069385127363,485593500.0,1.0
269,2024-01-30,GOOG,154.00999450683594,155.0399932861328,152.77499389648438,153.0500030517578,26578900.0,0.0,0.0,-1.7899932861328125,1.7899932861328125,0.0,72.98445044715318,140.50999450683594,155.1999969482422,85.36423730996631,-14.635762690033696,3.93550162760846,3.123247644617072,0.07110367209397173,459014600.0,-1.0
270,2024-01-31,GOOG,145.38999938964844,145.58999633789062,141.5500030517578,141.8000030517578,43908600.0,0.0,0.0,-11.25,11.25,0.0,32.607718561308815,140.50999450683594,155.1999969482422,8.78154071156427,-91.21845928843572,3.0224389776517455,3.103085911224007,-0.022001533350908486,415106000.0,-1.0
271,2024-02-01,GOOG,143.69000244140625,144.6199951171875,142.25999450683594,142.7100067138672,25526900.0,0.0,0.0,0.910003662109375,0.0,0.910003662109375,35.91662670134704,140.50999450683594,155.1999969482422,14.976254876787118,-85.02374512321288,2.3452256382562098,2.9515138566304477,-0.035547708748007945,440632900.0,1.0
272,2024-02-02,GOOG,140.88999938964844,143.8800048828125,138.1699981689453,143.5399932861328,42116900.0,0.0,0.0,0.829986572265625,0.0,0.829986572265625,39.06521355834533,138.1699981689453,155.1999969482422,31.532563136268255,-68.46743686373175,1.854128923501463,2.732036870004651,-0.02823108278515085,482749800.0,1.0
273,2024-02-05,GOOG,144.0399932861328,146.6699981689453,143.91000366210938,144.92999267578125,29254400.0,0.0,0.0,1.3899993896484375,0.0,1.3899993896484375,44.3488831111587,138.1699981689453,155.1999969482422,39.694627078035765,-60.30537292196424,1.5591200079283567,2.497453497589392,-0.025221954430529436,512004200.0,1.0
274,2024-02-06,GOOG,145.9600067138672,146.74000549316406,144.52000427246094,145.41000366210938,21517700.0,0.0,0.0,0.480010986328125,0.0,0.480010986328125,46.207444896370816,138.1699981689453,155.1999969482422,42.513247282,-57.486752718,1.3485113919592777,2.2676650764633695,-0.03285668267951425,533521900.0,1.0
275,2024-02-07,GOOG,146.1199951171875,147.0,145.2100067138672,146.67999267578125,21436100.0,0.0,0.0,1.269989013671875,0.0,1.269989013671875,51.184345092909524,138.1699981689453,155.1999969482422,49.970611373040235,-50.02938862695977,1.2694466552178199,2.0680213922142596,-0.04530074682059726,554958000.0,1.0
276,2024-02-08,GOOG,146.97000122070312,147.61000061035156,146.4199981689453,147.22000122070312,18241300.0,0.0,0.0,0.540008544921875,0.0,0.540008544921875,53.30399931163011,138.1699981689453,155.1999969482422,53.141536702631896,-46.858463297368104,1.2361123248047647,1.9016395787323606,-0.04272054328792341,573199300.0,1.0
277,2024-02-09,GOOG,147.9499969482422,150.69500732421875,147.42999267578125,150.22000122070312,21877700.0,0.0,0.0,3.0,0.0,3.0,63.47135454095694,138.1699981689453,155.1999969482422,70.75750977978241,-29.242490220217583,1.4352251732293269,1.808356697631754,-0.029837220527348607,595077000.0,1.0
278,2024-02-12,GOOG,149.5399932861328,150.58999633789062,148.55999755859375,148.72999572753906,17236100.0,0.0,0.0,-1.4900054931640625,1.4900054931640625,0.0,56.4300479966733,138.1699981689453,155.1999969482422,62.008210895654244,-37.991789104345756,1.4560085887075047,1.737887075846904,-0.02822611720404755,577840900.0,-1.0
279,2024-02-13,GOOG,146.07000732421875,148.0399932861328,145.11000061035156,146.3699951171875,18138500.0,0.0,0.0,-2.3600006103515625,2.3600006103515625,0.0,46.91776152284572,138.1699981689453,155.1999969482422,48.150308490983605,-51.849691509016395,1.2674370440872167,1.6437970694949668,0.032228434182484555,559702400.0,-1.0
280,2024-02-14,GOOG,147.3699951171875,147.8300018310547,145.55499267578125,147.13999938964844,16651800.0,0.0,0.0,0.7700042724609375,0.0,0.7700042724609375,50.08536854222383,138.1699981689453,155.1999969482422,52.67176666863785,-47.32823333136215,1.1666769206507581,1.5483730397261253,0.031041920449652594,576354200.0,1.0
281,2024-02-15,GOOG,144.4600067138672,144.75999450683594,141.8800048828125,143.94000244140625,26724300.0,0.0,0.0,-3.1999969482421875,3.1999969482421875,0.0,38.942236159495415,138.1699981689453,155.1999969482422,33.88141330623845,-66.11858669376154,0.8191679287780573,1.402532017536512,0.0027867435835533527,549629900.0,-1.0
282,2024-02-16,GOOG,144.2100067138672,144.47999572753906,141.52000427246094,141.75999450683594,21849700.0,0.0,0.0,-2.1800079345703125,2.1800079345703125,0.0,33.14556959300158,138.1699981689453,155.0399932861328,21.280363823182512,-78.71963617681749,0.36366403525059354,1.1947584210793283,-0.021872616636618658,527780200.0,-1.0
283,2024-02-20,GOOG,140.94000244140625,143.32899475097656,140.8000030517578,142.1999969482422,18625600.0,0.0,0.0,0.44000244140625,0.0,0.44000244140625,35.38548910802086,138.1699981689453,150.69500732421875,32.17561543737566,-67.82438456262435,0.03774335574931342,0.9633554080133253,-0.022075556241139438,546405800.0,1.0
284,2024-02-21,GOOG,142.63999938964844,143.97999572753906,141.91000366210938,143.83999633789062,16499600.0,0.0,0.0,1.6399993896484375,0.0,1.6399993896484375,43.5233073122655,138.1699981689453,150.69500732421875,45.26941336851685,-54.730586631483156,-0.08721156558425491,0.7532420132938092,-0.019361852193216955,562905400.0,1.0
285,2024-02-22,GOOG,146.1199951171875,146.1999969482422,144.00999450683594,145.32000732421875,23024700.0,0.0,0.0,1.480010986328125,0.0,1.480010986328125,50.071155441411406,138.1699981689453,150.69500732421875,57.08585971183143,-42.91414028816857,-0.06605330204490656,0.5893829502260661,-0.012905813617240969,585930100.0,1.0
286,2024-02-23,GOOG,144.97000122070312,145.9550018310547,144.7899932861328,145.2899932861328,14519400.0,0.0,0.0,-0.0300140380859375,0.0300140380859375,0.0,49.93568400318445,140.8000030517578,150.69500732421875,45.37633446881087,-54.62366553118913,-0.0511178529985159,0.4612827895811497,-0.032818585371512166,571410700.0,-1.0
287,2024-02-26,GOOG,143.4499969482422,143.83999633789062,138.74000549316406,138.75,33513000.0,0.0,0.0,-6.5399932861328125,6.5399932861328125,0.0,29.71941065511126,138.74000549316406,150.69500732421875,0.08360104814016386,-99.91639895185985,-0.5605426167356597,0.25691770831778776,-0.06710143222098641,537897700.0,-1.0
288,2024-02-27,GOOG,139.41000366210938,140.49000549316406,138.5,140.10000610351562,22364000.0,0.0,0.0,1.350006103515625,0.0,1.350006103515625,35.900318985838496,138.5,150.69500732421875,13.120173370770209,-86.8798266292298,-0.8455838380165233,0.03641739905092548,-0.04283657322425927,560261700.0,1.0
289,2024-02-28,GOOG,139.10000610351562,139.27999877929688,136.63999938964844,137.42999267578125,30628700.0,0.0,0.0,-2.670013427734375,2.670013427734375,0.0,29.899546865504874,136.63999938964844,150.69500732421875,5.620724583084087,-94.3792754169159,-1.2722629732369057,-0.22531867540664086,-0.06599161855474567,529633000.0,-1.0
290,2024-02-29,GOOG,138.35000610351562,139.9499969482422,137.57000732421875,139.77999877929688,35485000.0,0.0,0.0,2.350006103515625,0.0,2.350006103515625,40.07232770001619,136.63999938964844,150.69500732421875,22.34078702954808,-77.65921297045192,-1.4045921453317476,-0.46117336939166226,-0.02890095589516739,565118000.0,1.0
291,2024-03-01,GOOG,139.61000061035156,140.0,137.97500610351562,138.0800018310547,28522000.0,0.0,0.0,-1.6999969482421875,1.6999969482421875,0.0,35.74285362340031,136.63999938964844,150.58999633789062,10.322600404494727,-89.67739959550526,-1.6278743911654203,-0.694513573746414,-0.02595931728541223,536596000.0,-1.0
292,2024-03-04,GOOG,136.5399932861328,136.6300048828125,132.86000061035156,134.1999969482422,43571500.0,0.0,0.0,-3.8800048828125,3.8800048828125,0.0,27.825705151896358,132.86000061035156,148.0399932861328,8.827384614147457,-91.17261538585254,-2.093775407523907,-0.9743659405019127,-0.05625879164337699,493024500.0,-1.0
293,2024-03-05,GOOG,132.74000549316406,134.02000427246094,131.5500030517578,133.77999877929688,28447600.0,0.0,0.0,-0.4199981689453125,0.4199981689453125,0.0,27.076610164947667,131.5500030517578,147.8300018310547,13.697763481253618,-86.30223651874638,-2.468441010364103,-1.273180954474351,-0.06993880571966982,464576900.0,-1.0
294,2024-03-06,GOOG,134.24000549316406,134.74000549316406,131.9499969482422,132.55999755859375,23175200.0,0.0,0.0,-1.220001220703125,1.220001220703125,0.0,24.835683693732804,131.5500030517578,146.1999969482422,6.894163328479682,-93.10583667152031,-2.83117408989267,-1.584779581558015,-0.08780628352953879,441401700.0,-1.0
295,2024-03-07,GOOG,133.88999938964844,135.82000732421875,132.66000366210938,135.24000549316406,24107300.0,0.0,0.0,2.6800079345703125,0.0,2.6800079345703125,37.86925908807928,131.5500030517578,146.1999969482422,25.18774046924181,-74.81225953075818,-2.8693127746543325,-1.8416862201772786,-0.06917192000399086,465509000.0,1.0
296,2024-03-08,GOOG,135.03500366210938,138.98500061035156,134.8000030517578,136.2899932861328,26472400.0,0.0,0.0,1.04998779296875,0.0,1.04998779296875,42.38552536759842,131.5500030517578,146.1999969482422,32.35489562567311,-67.64510437432689,-2.7827350795282086,-2.029895992047465,-0.017729778117961725,491981400.0,1.0
297,2024-03-11,GOOG,137.07000732421875,139.97999572753906,137.07000732421875,138.94000244140625,22536400.0,0.0,0.0,2.6500091552734375,0.0,2.6500091552734375,52.45083105844227,131.5500030517578,146.1999969482422,50.44370285657149,-49.556297143428516,-2.471794729619205,-2.118275739561813,-0.008279825921294282,514517800.0,1.0
298,2024-03-12,GOOG,138.25,140.27999877929688,138.2100067138672,139.6199951171875,19019700.0,0.0,0.0,0.67999267578125,0.0,0.67999267578125,54.789349946727,131.5500030517578,146.1999969482422,55.085293020949855,-44.914706979050145,-2.1457674644808264,-2.1237740845456154,0.015935403901045087,533537500.0,1.0
299,2024-03-13,GOOG,140.05999755859375,142.19000244140625,140.00999450683594,140.77000427246094,19637000.0,0.0,0.0,1.1500091552734375,0.0,1.1500091552734375,58.74833949989891,131.5500030517578,145.9550018310547,64.00556752531126,-35.99443247468873,-1.7741411849484905,-2.0538475046261904,0.007082597666403068,553174500.0,1.0
300,2024-03-14,GOOG,142.3000030517578,144.72999572753906,141.48500061035156,144.33999633789062,36117900.0,0.0,0.0,3.5699920654296875,0.0,3.5699920654296875,68.59788798697929,131.5500030517578,144.72999572753906,97.04097415497752,-2.959025845022483,-1.1779771694638157,-1.8786734375937153,0.04533599669628652,589292400.0,1.0
301,2024-03-15,GOOG,143.41000366210938,144.33999633789062,141.1300048828125,142.1699981689453,41025900.0,0.0,0.0,-2.1699981689453125,2.1699981689453125,0.0,58.75815989193008,131.5500030517578,144.72999572753906,80.57663898935358,-19.423361010646424,-0.8705781261301411,-1.6770543753010005,0.05938898213072963,548266500.0,-1.0
302,2024-03-18,GOOG,149.3699951171875,152.92999267578125,148.13999938964844,148.47999572753906,47676700.0,0.0,0.0,6.30999755859375,0.0,6.30999755859375,72.15781037624309,131.5500030517578,152.92999267578125,79.18615945799156,-20.81384054200844,-0.11645567299726167,-1.3649346348402527,0.10988187384044945,595943200.0,1.0
303,2024-03-19,GOOG,148.97999572753906,149.6199951171875,147.00999450683594,147.9199981689453,17748400.0,0.0,0.0,-0.55999755859375,0.55999755859375,0.0,69.83438049609794,131.5500030517578,152.92999267578125,76.56689925982705,-23.433100740172957,0.43103596707035763,-1.0057405144581306,0.11587206467442934,578194800.0,-1.0
304,2024-03-20,GOOG,148.7899932861328,149.75999450683594,147.6649932861328,149.67999267578125,17730000.0,0.0,0.0,1.7599945068359375,0.0,1.7599945068359375,72.98843410780654,131.5500030517578,152.92999267578125,84.79887007827091,-15.201129921729084,0.9954687401149727,-0.6054986635435098,0.10677304492824113,595924800.0,1.0
305,2024-03-21,GOOG,150.32000732421875,151.30499267578125,148.00999450683594,148.74000549316406,19843900.0,0.0,0.0,-0.9399871826171875,0.9399871826171875,0.0,68.5701804962074,131.5500030517578,152.92999267578125,80.402295528202,-19.597704471797993,1.351359043576025,-0.21412712211960272,0.09134942270408053,576080900.0,-1.0
306,2024-03-22,GOOG,150.24000549316406,152.55999755859375,150.08999633789062,151.77000427246094,19226300.0,0.0,0.0,3.029998779296875,0.0,3.029998779296875,74.34607056804157,131.5500030517578,152.92999267578125,94.57442017643965,-5.425579823560352,1.8564996791696728,0.19999823813825254,0.09234202969346672,595307200.0,1.0
307,2024-03-25,GOOG,150.9499969482422,151.45599365234375,148.8000030517578,151.14999389648438,15114700.0,0.0,0.0,-0.6200103759765625,0.6200103759765625,0.0,71.25440055472302,131.9499969482422,152.92999267578125,91.51573335660699,-8.484266643393008,2.1816489257363685,0.5963283756578759,0.08258128622350536,580192500.0,-1.0
308,2024-03-26,GOOG,151.24000549316406,153.1999969482422,151.02999877929688,151.6999969482422,19312700.0,0.0,0.0,0.5500030517578125,0.0,0.5500030517578125,72.42799361542036,132.66000366210938,153.1999969482422,92.69717385442041,-7.302826145579592,2.455408277734449,0.9681443560731907,0.07764433007067484,599505200.0,1.0
309,2024-03-27,GOOG,152.14500427246094,152.69000244140625,150.1300048828125,151.94000244140625,16622000.0,0.0,0.0,0.2400054931640625,0.0,0.2400054931640625,72.9833623799189,134.8000030517578,153.1999969482422,93.15220149569353,-6.847798504306462,2.661055977155428,1.3067266802896382,0.05265350073672237,616127200.0,1.0
310,2024-03-28,GOOG,152.0,152.6699981689453,151.3300018310547,152.25999450683594,21105600.0,0.0,0.0,0.3199920654296875,0.0,0.3199920654296875,73.79536445344635,137.07000732421875,153.1999969482422,94.1723307744337,-5.827669225566293,2.8173769779068323,1.6088567398130773,0.07097134745616551,637232800.0,1.0
311,2024-04-01,GOOG,151.8300018310547,157.0,151.64999389648438,156.5,24469800.0,0.0,0.0,4.2400054931640625,0.0,4.2400054931640625,82.04567166043113,138.2100067138672,157.0,97.3390091609612,-2.6609908390388015,3.245977892719935,1.9362809703944492,0.05401403894958112,661702600.0,1.0
312,2024-04-02,GOOG,154.75,155.99000549316406,153.4600067138672,155.8699951171875,17598100.0,0.0,0.0,-0.6300048828125,0.6300048828125,0.0,77.84381244833305,140.00999450683594,157.0,93.34900225154631,-6.6509977484536895,3.494528329427709,2.2479304422011013,0.053745247746435076,644104500.0,-1.0
313,2024-04-03,GOOG,154.9199981689453,156.5500030517578,154.1320037841797,156.3699951171875,17266200.0,0.0,0.0,0.5,0.0,0.5,78.8363575130524,141.1300048828125,157.0,96.03021375772074,-3.969786242279262,3.689323932779331,2.5362091403167475,0.044695368578066,661370700.0,1.0
314,2024-04-04,GOOG,155.0800018310547,156.17999267578125,151.8800048828125,151.94000244140625,24184800.0,0.0,0.0,-4.42999267578125,4.42999267578125,0.0,54.07272429803806,141.1300048828125,157.0,68.1159476028214,-31.884052397178614,3.4465082640386697,2.718268965061132,0.021514030052858013,637185900.0,-1.0
315,2024-04-05,GOOG,151.67999267578125,154.83999633789062,151.08099365234375,153.94000244140625,16289800.0,0.0,0.0,2.0,0.0,2.0,60.531028740067065,147.00999450683594,157.0,69.36941065059837,-30.63058934940164,3.376535779818454,2.8499223280125965,0.014297938379508102,653475700.0,1.0
316,2024-04-08,GOOG,154.01499938964844,156.65499877929688,153.99000549316406,156.13999938964844,16641500.0,0.0,0.0,2.1999969482421875,0.0,2.1999969482421875,66.5085574677245,147.00999450683594,157.0,91.39139001535042,-8.608609984649576,3.4587333247456513,2.9716845273592076,0.03301360036164791,670117200.0,1.0
317,2024-04-09,GOOG,157.35000610351562,159.88999938964844,156.63999938964844,158.13999938964844,21538100.0,0.0,0.0,2.0,0.0,2.0,71.09972977951587,147.6649932861328,159.88999938964844,85.68507872158247,-14.31492127841753,3.6432615058132285,3.105999923050012,0.042452225253527764,691655300.0,1.0
318,2024-04-10,GOOG,157.8800048828125,158.16000366210938,156.1999969482422,157.66000366210938,16339200.0,0.0,0.0,-0.4799957275390625,0.4799957275390625,0.0,68.49938062067284,148.00999450683594,159.88999938964844,81.22899990752252,-18.771000092477472,3.708025959942688,3.2264051304285477,0.037646446813168755,675316100.0,-1.0
319,2024-04-11,GOOG,158.33999633789062,161.1199951171875,157.92999267578125,160.7899932861328,17832800.0,0.0,0.0,3.1299896240234375,0.0,3.1299896240234375,75.2971227945883,148.8000030517578,161.1199951171875,97.32141198385442,-2.678588016145593,3.966196417255503,3.3743633877939394,0.05602258693706896,693148900.0,1.0
333,2023-01-23,IBM,133.49258253866344,134.99367704693182,133.17159957432233,133.92686462402344,5898400.0,0.0,0.0,0.623077392578125,0.0,0.623077392578125,43.62218973356659,131.93486728368805,138.94936912817568,28.39827238623947,-71.60172761376053,-0.2405516268504755,0.1365371077038276,-0.011772888039341622,19634800.0,1.0
334,2023-01-24,IBM,133.35097658834454,134.76709315388447,132.17087945039458,133.5775604248047,4407600.0,0.0,0.0,-0.34930419921875,0.34930419921875,0.0,41.059699249816894,131.93486728368805,138.94936912817568,23.4185288925051,-76.5814711074949,-0.2827629682954864,0.05267709250396477,-0.02285908632859368,15227200.0,-1.0
335,2023-01-25,IBM,132.6145905152757,133.1432717018429,131.56666373280063,132.88836669921875,7347500.0,0.0,0.0,-0.6891937255859375,0.6891937255859375,0.0,36.216358796081686,131.56666373280063,138.94936912817568,17.902691434038633,-82.09730856596137,-0.3530380225679437,-0.028465930510416952,-0.03097906144751872,7879700.0,-1.0
336,2023-01-26,IBM,129.83902054977028,130.53764331779678,125.5434636168662,126.93125915527344,17548500.0,0.0,0.0,-5.9571075439453125,5.9571075439453125,0.0,16.640151765707756,125.5434636168662,138.94936912817568,10.352120841344602,-89.6478791586554,-0.7709043034277272,-0.17695360509387906,-0.07626234892982886,-9668800.0,-1.0
337,2023-01-27,IBM,126.92181003823003,127.91309451795809,126.28927969918976,126.87460327148438,8143100.0,0.0,0.0,-0.0566558837890625,0.0566558837890625,0.0,16.542028944498526,125.5434636168662,138.94936912817568,9.929501990709957,-90.07049800929005,-1.0850306779180414,-0.35856901965871163,-0.07882657617035949,-17811900.0,-1.0
338,2023-01-30,IBM,126.80853431069902,128.49842719830585,126.48753691736566,127.73372650146484,5375700.0,0.0,0.0,0.8591232299804688,0.0,0.8591232299804688,24.347422784431487,125.5434636168662,138.94936912817568,16.33804507088978,-83.66195492911021,-1.2581305856840572,-0.5384813328637809,-0.0681176899238044,-12436200.0,1.0
339,2023-01-31,IBM,127.92252336300416,128.06412925029073,126.27982304307032,127.1955795288086,7206400.0,0.0,0.0,-0.53814697265625,0.53814697265625,0.0,22.805841441597792,125.5434636168662,138.94936912817568,12.323792007549455,-87.67620799245054,-1.4114434392091937,-0.7130737541328634,-0.04045304891567225,-19642600.0,-1.0
340,2023-02-01,IBM,126.9690082207884,128.19629764030412,125.37351468883988,127.5354461669922,5428900.0,0.0,0.0,0.33986663818360796,0.0,0.33986663818360796,26.210425006089437,125.37351468883988,138.94936912817568,15.924828067456051,-84.07517193254395,-1.4904950403243618,-0.8685580113711633,-0.039325950532113074,-14213700.0,1.0
341,2023-02-02,IBM,128.35680985311362,129.07430371591292,127.30888303460748,128.76275634765625,6107800.0,0.0,0.0,1.2273101806640483,0.0,1.2273101806640483,37.66558493684895,125.37351468883988,138.94936912817568,24.965218019693154,-75.03478198030685,-1.451614433553857,-0.9851692958077021,-0.03406528035024847,-8105900.0,1.0
342,2023-02-03,IBM,128.725010508976,129.29144853123822,127.95085981808892,129.28201293945312,3755700.0,0.0,0.0,0.519256591796875,0.0,0.519256591796875,42.05679534793547,125.37351468883988,138.94936912817568,28.790071874138867,-71.20992812586113,-1.368974331425477,-1.0619303029312572,-0.03468200123709264,-4350200.0,1.0
343,2023-02-06,IBM,128.2340803377573,128.69668361339075,127.40328732208351,128.5644989013672,4841300.0,0.0,0.0,-0.7175140380859375,0.7175140380859375,0.0,37.810017634477575,125.37351468883988,136.58915427473022,28.45120145035401,-71.548798549646,-1.3379581583221807,-1.117135874009442,-0.037529219035704164,-9191500.0,-1.0
344,2023-02-07,IBM,128.08302352967098,128.77219623704076,126.93124754996649,128.24351501464844,3737600.0,0.0,0.0,-0.32098388671875,0.32098388671875,0.0,35.93690144763114,125.37351468883988,134.99367704693182,29.83317972169645,-70.16682027830355,-1.3204169820477318,-1.1577920956171,-0.03495303464059818,-12929100.0,-1.0
345,2023-02-08,IBM,128.1207807999694,129.09317960107452,127.60153522523336,128.37567138671875,4593700.0,0.0,0.0,0.1321563720703125,0.0,0.1321563720703125,37.409946212494134,125.37351468883988,134.99367704693182,31.206923398269122,-68.79307660173087,-1.2820082580892347,-1.182635328111527,0.011379483990451744,-8335400.0,1.0
346,2023-02-09,IBM,129.00644456875014,129.71363402921097,127.4295736452321,127.82140350341795,3918800.0,1.65,0.0,-0.5542678833007955,0.5542678833007955,0.0,33.66406443134038,125.37351468883988,134.99367704693182,25.44540022777319,-74.55459977222681,-1.2763896075558137,-1.2013861840003843,0.007462488216870566,-12254200.0,-1.0
347,2023-02-10,IBM,127.85006755196686,129.75186407649474,127.58247999647112,129.5894012451172,5049600.0,0.0,0.0,1.767997741699233,0.0,1.767997741699233,51.52771979889011,125.37351468883988,134.76709315388447,44.88051674838802,-55.11948325161198,-1.130711631148614,-1.1872512734300302,0.014527680311832603,-7204600.0,1.0
348,2023-02-13,IBM,129.97165986955318,131.3000461040405,129.82831460707985,131.26182556152344,4403000.0,0.0,0.0,1.67242431640625,0.0,1.67242431640625,62.53852384475409,125.37351468883988,133.1432717018429,75.78500669749666,-24.214993302503355,-0.8833401740641591,-1.126469053556856,0.03196845399642112,-2801600.0,1.0
349,2023-02-14,IBM,130.9751255640141,131.1567059585162,129.0637775501866,129.98121643066406,3202200.0,0.0,0.0,-1.280609130859375,1.280609130859375,0.0,52.085128990743016,125.37351468883988,131.3000461040405,77.74702298896385,-22.25297701103614,-0.7729849637260315,-1.055772235590691,0.01917718044024741,-6003800.0,-1.0
350,2023-02-15,IBM,129.20712173015147,130.40171422873357,129.08289402634998,130.3539276123047,2506700.0,0.0,0.0,0.372711181640625,0.0,0.372711181640625,54.63175651773916,125.37351468883988,131.3000461040405,84.03588160674963,-15.964118393250368,-0.6505793383672653,-0.9747336561460059,0.01235738741373571,-3497100.0,1.0
351,2023-02-16,IBM,129.56073239561584,129.94299616623255,128.6241613674771,129.0159912109375,2965500.0,0.0,0.0,-1.3379364013671875,1.3379364013671875,0.0,44.77485814639503,125.37351468883988,131.3000461040405,61.460511501807765,-38.539488498192235,-0.6458982822047972,-0.9089665813577642,-0.002057685539288534,-6462600.0,-1.0
352,2023-02-17,IBM,128.53815589934354,129.5702855925159,127.95519416289696,129.0351104736328,3466200.0,0.0,0.0,0.0191192626953125,0.0,0.0191192626953125,44.93866250315088,125.37351468883988,131.3000461040405,61.78311609724236,-38.21688390275763,-0.6333621396750857,-0.8538456930212286,0.003660509520802213,-2996400.0,1.0
353,2023-02-21,IBM,128.06030540515147,128.43301765101864,125.82403192994842,125.87181854248048,4257200.0,0.0,0.0,-3.1632919311523295,3.1632919311523295,0.0,28.691968667487686,125.37351468883988,131.3000461040405,8.408018429844759,-91.59198157015524,-0.8517980479419691,-0.8534361640053767,-0.018493695154075063,-7253600.0,-1.0
354,2023-02-22,IBM,126.05340459431406,126.13942634366568,124.51476875106292,125.16463470458984,3200200.0,0.0,0.0,-0.7071838378906392,0.7071838378906392,0.0,26.244464038584923,124.51476875106292,131.3000461040405,9.57758864848387,-90.42241135151613,-1.065736840876525,-0.8958962993796064,-0.02501281315566395,-10453800.0,-1.0
355,2023-02-23,IBM,125.6711344622668,125.86226635104693,123.14815561605528,124.99259948730467,3725600.0,0.0,0.0,-0.17203521728517046,0.17203521728517046,0.0,25.630761908458652,123.14815561605528,131.3000461040405,22.62596478654685,-77.37403521345315,-1.2337503669442071,-0.9634671128925266,-0.02213091030593828,-14179400.0,-1.0
356,2023-02-24,IBM,123.8744543320428,124.87791490898452,123.49219058007805,124.78235626220705,3015800.0,0.0,0.0,-0.21024322509762783,0.21024322509762783,0.0,24.812589974034296,123.14815561605528,131.3000461040405,20.046891559207765,-79.95310844079224,-1.366886222600229,-1.0441509348340672,-0.03709443007470692,-17195200.0,-1.0
357,2023-02-27,IBM,125.59467957950932,126.02472997757415,124.36186649406636,124.7059097290039,2761300.0,0.0,0.0,-0.07644653320313921,0.07644653320313921,0.0,24.484675112930034,123.14815561605528,131.3000461040405,19.10911481507938,-80.89088518492062,-1.4611507207291936,-1.1275508920130926,-0.04994533486391839,-19956500.0,-1.0
358,2023-02-28,IBM,124.76324947750524,124.82058758701037,123.41574557442068,123.56865692138672,5143100.0,0.0,0.0,-1.1372528076171875,1.1372528076171875,0.0,19.957372767353448,123.14815561605528,131.3000461040405,5.158328684017578,-94.84167131598242,-1.6047134257326832,-1.2229833987570107,-0.049334509134233206,-25099600.0,-1.0
359,2023-03-01,IBM,123.18637101114142,123.73111218294216,122.07779297837426,122.50785064697266,3760700.0,0.0,0.0,-1.0608062744140625,1.0608062744140625,0.0,16.64489366550221,122.07779297837426,131.3000461040405,4.663260298088231,-95.33673970191177,-1.7796969042301356,-1.3343260998516357,-0.06019056816352808,-28860300.0,-1.0
360,2023-03-02,IBM,122.6989845692955,123.4921957410784,122.04912595609728,123.2150421142578,3340100.0,0.0,0.0,0.707191467285142,0.0,0.707191467285142,26.082192231556377,122.04912595609728,131.3000461040405,12.603245293601805,-87.3967547063982,-1.842058613292565,-1.4358726025398216,-0.044963023902946375,-25520200.0,1.0
361,2023-03-03,IBM,123.61643853016466,124.15161364042748,123.0621458566987,123.8935775756836,2860300.0,0.0,0.0,0.6785354614257955,0.0,0.6785354614257955,34.315289048693586,122.04912595609728,131.3000461040405,19.938034164054407,-80.06196583594559,-1.817601815150951,-1.5122184450620477,-0.0398459991166501,-22659900.0,1.0
362,2023-03-06,IBM,123.893565882857,125.05948922693268,123.84577927057325,124.419189453125,3131200.0,0.0,0.0,0.5256118774414062,0.0,0.5256118774414062,40.26235518692996,122.04912595609728,131.1567059585162,26.02297752419679,-73.97702247580321,-1.7371094803256852,-1.5571966521147753,-0.011540542642316964,-19528700.0,1.0
363,2023-03-07,IBM,124.50520252188046,124.63899629317643,122.50784744238064,122.565185546875,3530400.0,0.0,0.0,-1.85400390625,1.85400390625,0.0,29.420895783295933,122.04912595609728,130.40171422873357,6.1784392326432,-93.8215607673568,-1.797457521266793,-1.6052488259451791,-0.020768239877422157,-23059100.0,-1.0
364,2023-03-08,IBM,122.78499441487374,123.03347899365424,121.89622457288348,122.37406158447266,2778800.0,0.0,0.0,-0.19112396240234375,0.19112396240234375,0.0,28.507823752161826,121.89622457288348,129.94299616623255,5.938244997336847,-94.06175500266315,-1.838935057174254,-1.6519860721909942,-0.020949543521558422,-25837900.0,-1.0
365,2023-03-09,IBM,122.61297468288866,122.83277561544628,120.39581133854304,120.56783294677734,5478300.0,0.0,0.0,-1.8062286376953125,1.8062286376953125,0.0,21.299626954620322,120.39581133854304,129.5702855925159,1.8750023540565492,-98.12499764594345,-1.9905839635677438,-1.7197056504663442,-0.03377499385068239,-31316200.0,-1.0
366,2023-03-10,IBM,120.5296122613374,121.64774913557144,119.58348971432616,119.8893051147461,5990900.0,0.0,0.0,-0.67852783203125,0.67852783203125,0.0,19.19579292404059,119.58348971432616,128.43301765101864,3.4557255777671423,-96.54427442223286,-2.1393477758081616,-1.8036340755347076,-0.03862370776753632,-37307100.0,-1.0
367,2023-03-13,IBM,119.60260206533796,122.50785188831055,119.31589695003392,120.01354217529295,8188400.0,0.0,0.0,0.12423706054686079,0.0,0.12423706054686079,20.847509289388128,119.31589695003392,126.13942634366568,10.224111087000427,-89.77588891299956,-2.2216995103869976,-1.8872471625051659,-0.028770360014153895,-29118700.0,1.0
368,2023-03-14,IBM,120.8832001184387,121.02655267419112,117.7390318381145,119.12476348876952,8114800.0,0.0,0.0,-0.8887786865234375,0.8887786865234375,0.0,17.83774893866179,117.7390318381145,126.02472997757415,16.724380098469133,-83.27561990153086,-2.330176213668281,-1.975832972737789,-0.027615268248824987,-37233500.0,-1.0
369,2023-03-15,IBM,117.53834438496006,117.8823876116716,116.31508281941412,117.81549072265624,5989300.0,0.0,0.0,-1.3092727661132812,1.3092727661132812,0.0,14.32298808337184,116.31508281941412,126.02472997757415,15.452754140310542,-84.54724585968945,-2.490875138056637,-2.078841405801559,-0.043822177056876965,-43222800.0,-1.0
370,2023-03-16,IBM,117.50967564728376,119.28722989300238,116.51577379980132,119.17254638671876,6438700.0,0.0,0.0,1.3570556640625284,0.0,1.3570556640625284,30.662508153633297,116.31508281941412,126.02472997757415,29.429118491738613,-70.57088150826138,-2.4819985590134337,-2.159472836443934,-0.03810553606849287,-36784100.0,1.0
371,2023-03-17,IBM,118.58003344928794,119.00052505757228,117.4810068745533,118.2073211669922,37400200.0,0.0,0.0,-0.9652252197265625,0.9652252197265625,0.0,26.512866659568587,116.31508281941412,125.05948922693268,21.639414494174382,-78.36058550582563,-2.5223753029030433,-2.232053329735756,-0.04992693099381684,-74184300.0,-1.0
372,2023-03-20,IBM,118.7998288551022,120.5678315322397,118.68515264510064,120.35758209228516,4588300.0,0.0,0.0,2.1502609252929545,0.0,2.1502609252929545,45.47894567437365,116.31508281941412,125.05948922693268,46.22954474525842,-53.77045525474158,-2.3563480604369147,-2.256912275875988,-0.01801166819712885,-69596000.0,1.0
373,2023-03-21,IBM,121.2750375753518,121.51395608622082,120.09000380298151,120.95966339111328,3856300.0,0.0,0.0,0.602081298828125,0.0,0.602081298828125,49.675185610168334,116.31508281941412,125.05948922693268,53.114875444326195,-46.88512455567381,-2.1520527942187186,-2.2359403795445343,-0.011557990108737592,-65739700.0,1.0
374,2023-03-22,IBM,121.37059643105482,121.5808458749312,118.51313324953286,118.55136108398438,3549000.0,0.0,0.0,-2.4083023071289062,2.4083023071289062,0.0,36.65464856261567,116.31508281941412,125.05948922693268,25.573814394622314,-74.42618560537768,-2.1569737786342813,-2.2201470593624837,-0.01672479145978434,-69288700.0,-1.0
375,2023-03-23,IBM,118.32200377700572,119.3923613557515,117.16563903210384,117.9015121459961,4651900.0,0.0,0.0,-0.6498489379882812,0.6498489379882812,0.0,33.888997179884115,116.31508281941412,125.05948922693268,18.142218609806875,-81.85778139019313,-2.1873911889005058,-2.213595885270088,-0.01658023596723235,-73940600.0,-1.0
376,2023-03-24,IBM,117.89194567089936,119.84152151324702,117.43321894102355,119.73639678955078,3812300.0,0.0,0.0,1.8348846435546875,0.0,1.8348846435546875,46.93363376779837,116.31508281941412,124.63899629317643,41.10222890856492,-58.89777109143508,-2.0415635564745713,-2.1791894195109847,-0.002309284275081036,-70128300.0,1.0
377,2023-03-27,IBM,120.86408320072968,124.48608098236942,120.86408320072968,123.57819366455078,6524100.0,0.0,0.0,3.841796875,0.0,3.841796875,64.06386286534854,116.31508281941412,124.48608098236942,88.88890561823027,-11.11109438176973,-1.6008349762954168,-2.063518530867871,0.0373845877662633,-63604200.0,1.0
378,2023-03-28,IBM,123.45396883765603,123.91270288865276,123.09082260865324,123.60688018798828,2888900.0,0.0,0.0,0.0286865234375,0.0,0.0286865234375,64.16353194498659,116.31508281941412,124.48608098236942,89.23998296356068,-10.76001703643932,-1.2350466247366114,-1.8978241496416193,0.04915643460642438,-60715300.0,1.0
379,2023-03-29,IBM,124.35230264333644,124.57211817405027,123.45396670369897,123.96048736572266,3279600.0,0.0,0.0,0.353607177734375,0.0,0.353607177734375,65.52354392307734,116.31508281941412,124.57211817405027,92.59261003425159,-7.4073899657484175,-0.9064536378226506,-1.6995500472778255,0.04017654337490506,-57435700.0,1.0
380,2023-03-30,IBM,124.39053102027556,125.6520131141728,123.37751891606604,123.49219512939452,3561800.0,0.0,0.0,-0.4682922363281392,0.4682922363281392,0.0,61.93203713791607,116.31508281941412,125.6520131141728,76.86800782918229,-23.131992170817703,-0.6757353208253392,-1.4947871019873282,0.04470851644574814,-60997500.0,-1.0
381,2023-03-31,IBM,123.73110971433316,125.41309064712642,123.68332309948214,125.279296875,4524700.0,0.0,0.0,1.787101745605483,0.0,1.787101745605483,69.33358496136535,116.31508281941412,125.6520131141728,96.00815013707418,-3.991849862925809,-0.34584363206022317,-1.2649984080019072,0.04089243649761154,-56472800.0,1.0
382,2023-04-03,IBM,125.16463286083064,126.73193773663516,124.97350096523084,126.20631408691406,3840100.0,0.0,0.0,0.9270172119140625,0.0,0.9270172119140625,72.53029558518185,116.31508281941412,126.73193773663516,94.95410415237576,-5.045895847624236,-0.010050698548766945,-1.0140088661112792,0.043375209129312475,-52632700.0,1.0
383,2023-04-04,IBM,126.13940535898962,126.29230210282832,125.08815821894837,125.76669311523438,3382800.0,0.0,0.0,-0.4396209716796875,0.4396209716796875,0.0,68.61642114813361,116.51577379980132,126.73193773663516,90.55179001268131,-9.448209987318695,0.21829198955462914,-0.7675486949780974,0.060862498458693404,-56015500.0,-1.0
384,2023-04-05,IBM,125.54689514871365,126.73193621912873,125.54689514871365,126.28276824951172,2898700.0,0.0,0.0,0.5160751342773438,0.0,0.5160751342773438,70.75406518758902,117.16563903210384,126.73193773663516,95.3046679703752,-4.695332029624801,0.4355985778656759,-0.5269192404093428,0.07108692629096414,-53116800.0,1.0
385,2023-04-06,IBM,126.3018841309191,126.7223830400588,124.54344740399728,124.71546173095705,3050600.0,0.0,0.0,-1.5673065185546733,1.5673065185546733,0.0,57.12038862360102,117.16563903210384,126.73193773663516,78.92104284049839,-21.078957159501613,0.47656660613691315,-0.32622207110009155,0.04158355416488346,-56167400.0,-1.0
386,2023-04-10,IBM,124.0751561014586,125.26974859117176,123.51131194609668,125.22196197509766,2614400.0,0.0,0.0,0.5065002441406108,0.0,0.5065002441406108,59.99481690878294,117.16563903210384,126.73193773663516,84.21567412668949,-15.784325873310495,0.5434142756185025,-0.1522948017563727,0.013301443092855303,-53553000.0,1.0
387,2023-04-11,IBM,124.79191127704084,125.28886583457398,124.40963293185082,124.63899993896484,3132400.0,0.0,0.0,-0.5829620361328125,0.5829620361328125,0.0,55.090423819939524,117.16563903210384,126.73193773663516,78.12175991662332,-21.878240083376692,0.5433130751295039,-0.013173226379197338,0.008350018618760169,-56685400.0,-1.0
388,2023-04-12,IBM,124.61988517601176,125.0881706909804,122.48873621499632,122.8423309326172,3957500.0,0.0,0.0,-1.796669006347642,1.796669006347642,0.0,42.68254472616798,117.16563903210384,126.73193773663516,59.34052527363015,-40.65947472636985,0.39437162827161387,0.06833574455096493,-0.009020264899463837,-60642900.0,-1.0
389,2023-04-13,IBM,122.33582269262816,122.69898347663712,120.41492321482758,122.23070526123048,5621500.0,0.0,0.0,-0.6116256713867188,0.6116256713867188,0.0,39.21340692074174,117.43321894102355,126.73193773663516,51.59298206190548,-48.407017938094526,0.2246057329976736,0.09958974224030669,-0.010215138429131132,-66264400.0,-1.0
390,2023-04-14,IBM,122.76588278506678,124.08470292809253,121.66684898638016,122.4600601196289,4180600.0,0.0,0.0,0.2293548583984233,0.0,0.2293548583984233,41.27849495940441,120.41492321482758,126.73193773663516,32.37505466769325,-67.62494533230675,0.10726817535167754,0.10112542886258086,-0.02250361253371369,-62083800.0,1.0
391,2023-04-17,IBM,122.6129778294343,123.01435916187684,121.17946682109896,122.1542510986328,3662700.0,0.0,0.0,-0.30580902099610796,0.30580902099610796,0.0,39.22818627145485,120.41492321482758,126.73193773663516,27.53401749830896,-72.46598250169104,-0.01018772624081521,0.07886279784190164,-0.03210665819374725,-65746500.0,-1.0
392,2023-04-18,IBM,122.46007107020009,122.97612863623904,121.70508770261928,122.11602783203124,3193800.0,0.0,0.0,-0.0382232666015625,0.0382232666015625,0.0,38.94917670532725,120.41492321482758,126.73193773663516,26.928933142881117,-73.07106685711888,-0.10513012488688389,0.04206421329614453,-0.029027282126740772,-68940300.0,-1.0
393,2023-04-19,IBM,120.89275524603924,121.35148195234,119.74594941710772,120.72073364257812,7014400.0,0.0,0.0,-1.3952941894531108,1.3952941894531108,0.0,29.970684345674528,119.74594941710772,126.73193773663516,13.953419056623042,-86.04658094337697,-0.2892711764591809,-0.024202864654920574,-0.044044287942310745,-75954700.0,-1.0
394,2023-04-20,IBM,124.38097036000904,125.1741815623797,120.26201758454032,120.75897216796876,9749600.0,0.0,0.0,0.03823852539063921,0.0,0.03823852539063921,30.47745800745615,119.74594941710772,126.73193773663516,14.500779338972123,-85.49922066102788,-0.4271960573670981,-0.1048015031973561,-0.03172413033697008,-66205100.0,1.0
395,2023-04-21,IBM,120.41491963164582,121.0838884908917,119.7172744288205,120.15689086914062,6725400.0,0.0,0.0,-0.6020812988281392,0.6020812988281392,0.0,26.936093195320097,119.7172744288205,126.73193773663516,6.2671067880103335,-93.73289321198966,-0.5782832069456276,-0.19949784394701042,-0.04044874418246458,-72930500.0,-1.0
396,2023-04-24,IBM,119.98487477642551,120.46271178104496,119.03875225760493,119.84152221679688,4043900.0,0.0,0.0,-0.31536865234375,0.31536865234375,0.0,25.168582790669348,119.03875225760493,126.73193621912873,10.43482078690528,-89.56517921309472,-0.715154895271283,-0.302629254211865,-0.038490983757229036,-76974400.0,-1.0
397,2023-04-25,IBM,119.36369154592062,120.59651195820106,119.22989776082488,120.30980682373048,4275400.0,0.0,0.0,0.46828460693360796,0.0,0.46828460693360796,32.73132838578411,119.03875225760493,126.73193621912873,16.521827275709615,-83.47817272429039,-0.7769640973306196,-0.397496222835616,-0.020616053844467408,-72699000.0,1.0
398,2023-04-26,IBM,120.23334809136284,120.94055212741472,119.5739379647932,120.27157592773438,4070200.0,0.0,0.0,-0.03823089599610796,0.03823089599610796,0.0,32.42265682244539,119.03875225760493,126.7223830400588,16.04480622552414,-83.95519377447586,-0.8195746879322456,-0.4819119158549419,-0.016028127542167647,-76769200.0,-1.0
399,2023-04-27,IBM,120.76853123749994,121.38971353144336,119.89886436003628,121.34193420410156,3204900.0,0.0,0.0,1.0703582763671875,0.0,1.0703582763671875,48.20254757664663,119.03875225760493,125.28886583457398,36.85024148974819,-63.14975851025181,-0.7583987166867274,-0.5372092760212991,-0.009130535412403606,-73564300.0,1.0
400,2023-04-28,IBM,120.96921789767552,121.60951773428292,120.07088199536936,120.80675506591795,5060500.0,0.0,0.0,-0.535179138183608,0.535179138183608,0.0,42.47981552414888,119.03875225760493,125.28886583457398,28.28753088308528,-71.71246911691472,-0.7444392402863542,-0.5786552688743102,-0.011031102238323376,-78624800.0,-1.0
401,2023-05-01,IBM,120.74940806690137,121.13167912395744,120.47226173281604,120.5009307861328,2725000.0,0.0,0.0,-0.30582427978515625,0.30582427978515625,0.0,39.39588244429178,119.03875225760493,125.1741815623797,23.831723191561522,-76.16827680843848,-0.7493716804293342,-0.612798551185315,-0.013225921892251358,-81349800.0,-1.0
402,2023-05-02,IBM,120.70162749103528,120.8449727561337,117.80592918541096,119.6121597290039,4445300.0,0.0,0.0,-0.888771057128892,0.888771057128892,0.0,31.68303203522983,117.80592918541096,125.1741815623797,24.513689965869755,-75.48631003413024,-0.815482363280239,-0.6533353136042999,-0.009182962032490694,-85795100.0,-1.0
403,2023-05-03,IBM,119.89885780962926,120.00398253173798,117.79637794988284,117.97795104980467,4554200.0,0.0,0.0,-1.634208679199233,1.634208679199233,0.0,22.38506576844665,117.79637794988284,125.1741815623797,2.4610725557166866,-97.53892744428332,-0.9881576774379113,-0.7202997863710222,-0.023029519614458538,-90349300.0,-1.0
404,2023-05-04,IBM,117.5765720594408,118.04485028190769,116.36286927719,117.136962890625,4468200.0,0.0,0.0,-0.8409881591796733,0.8409881591796733,0.0,19.063165933154394,116.36286927719,125.1741815623797,8.78522504231427,-91.21477495768573,-1.179176224066623,-0.8120750739101424,-0.025133206732225966,-94817500.0,-1.0
405,2023-05-05,IBM,117.65302544167204,118.59914064982586,117.3663203283096,118.1690902709961,4970800.0,0.0,0.0,1.0321273803710938,0.0,1.0321273803710938,33.11808055189307,116.36286927719,125.1741815623797,20.498887513520998,-79.501112486479,-1.2331587675737836,-0.8962918126428707,-0.013955363006615484,-89846700.0,1.0
406,2023-05-08,IBM,118.27421136083896,118.42711540304624,117.11784674389423,117.93016815185548,3663800.0,0.0,0.0,-0.2389221191406108,0.2389221191406108,0.0,31.65007496679111,116.36286927719,125.1741815623797,17.787349079658,-82.212650920342,-1.280433862332032,-0.9731202225807032,-0.019779257690617724,-93510500.0,-1.0
407,2023-05-09,IBM,118.08516402131882,118.1529730889258,116.88397165629472,117.37800598144533,4540000.0,1.66,0.0,-0.5521621704101562,0.5521621704101562,0.0,28.304462322757587,116.36286927719,125.1741815623797,11.52083448411647,-88.47916551588352,-1.3468781670501642,-1.0478718114745955,-0.02405863500140437,-98050500.0,-1.0
408,2023-05-10,IBM,118.17234078444255,118.6566933660223,117.31019378048138,118.20140075683594,4189200.0,0.0,0.0,0.8233947753906108,0.0,0.8233947753906108,39.33783278006981,116.36286927719,121.60951773428292,35.04201767435811,-64.9579823256419,-1.3179642677027772,-1.1018903027202318,-0.025881682765853453,-93861300.0,1.0
409,2023-05-11,IBM,118.20140782513076,118.41452415627136,116.77741735826602,117.11646270751952,3446500.0,0.0,0.0,-1.0849380493164205,1.0849380493164205,0.0,31.879074693449198,116.36286927719,121.60951773428292,14.363329971359857,-85.63667002864014,-1.3667583022637473,-1.154863902628935,-0.030547069626899903,-97307800.0,-1.0
410,2023-05-12,IBM,117.6104939212004,119.01511340990088,117.31987942461164,118.99573516845705,4560500.0,0.0,0.0,1.8792724609375284,0.0,1.8792724609375284,50.59963883042857,116.36286927719,121.60951773428292,50.18186205534101,-49.81813794465899,-1.2396221679453276,-1.1718155556922134,-0.012491153452973691,-92747300.0,1.0
411,2023-05-15,IBM,119.15073910996088,119.8191480602148,118.51139013308595,119.49947357177734,2915700.0,0.0,0.0,0.5037384033202983,0.0,0.5037384033202983,54.46957101007162,116.36286927719,121.60951773428292,59.78300852893973,-40.21699147106027,-1.0857337089740327,-1.1545991863485774,-0.0009420961671611217,-89831600.0,1.0
412,2023-05-16,IBM,119.48977820750092,119.98381990103458,118.61794209851024,119.5963363647461,2748400.0,0.0,0.0,0.09686279296875,0.0,0.09686279296875,55.247412691341715,116.36286927719,121.60951773428292,61.62919269319037,-38.37080730680963,-0.9450711257643576,-1.1126935742317334,0.013717693014165144,-87083200.0,1.0
413,2023-05-17,IBM,120.0613198026211,121.91154281366168,119.60602719527152,121.7759246826172,4515100.0,0.0,0.0,2.179588317871108,0.0,2.179588317871108,68.99851158220386,116.36286927719,121.91154281366168,97.55584591248598,-2.444154087514015,-0.6503413578853667,-1.02022313096246,0.039602886036269824,-82568100.0,1.0
414,2023-05-18,IBM,121.37876574607316,122.5508981630732,121.27220758174278,122.20216369628906,3797900.0,0.0,0.0,0.4262390136718608,0.0,0.4262390136718608,71.00859964109826,116.36286927719,122.5508981630732,94.36436911954777,-5.63563088045222,-0.3780366716279673,-0.8917858390955615,0.03412968159477203,-78770200.0,1.0
415,2023-05-19,IBM,122.82212743878128,124.27517778004948,122.5896402710544,123.27742004394533,4305800.0,0.0,0.0,1.0752563476562642,0.0,1.0752563476562642,75.61143561352061,116.36286927719,124.27517778004948,87.38980241046512,-12.610197589534874,-0.07465947048832788,-0.7283605653741148,0.04534252749647849,-74464400.0,1.0
416,2023-05-22,IBM,123.5099105834961,124.17831952342142,123.17086524825643,123.5099105834961,2806800.0,0.0,0.0,0.23249053955076704,0.0,0.23249053955076704,76.54064492042924,116.36286927719,124.27517778004948,90.32814258598717,-9.671857414012825,0.1824148518870743,-0.546205481921877,0.05224066085276724,-71657600.0,1.0
417,2023-05-23,IBM,123.25804701969008,125.05015015343668,123.15148885692254,124.16862487792967,4592300.0,0.0,0.0,0.6587142944335795,0.0,0.6587142944335795,79.1390194042586,116.36286927719,125.05015015343668,89.8526905246344,-10.147309475365594,0.4342672256159972,-0.35011094041430213,0.05048353135314798,-67065300.0,1.0
418,2023-05-24,IBM,123.81990052103184,123.8973987121314,121.54344473958162,121.7468719482422,3915500.0,0.0,0.0,-2.4217529296874716,2.4217529296874716,0.0,53.841280469592576,116.77741735826602,125.05015015343668,60.07029010869519,-39.92970989130481,0.4335368296054156,-0.19338138641035857,0.039536792127050635,-70980800.0,-1.0
419,2023-05-25,IBM,121.6790555219876,123.24836053901888,121.09783390515024,122.7930679321289,4102900.0,0.0,0.0,1.0461959838867045,0.0,1.0461959838867045,60.1853138555771,116.77741735826602,125.05015015343668,72.7166067466197,-27.28339325338029,0.5114456483465801,-0.0524159794589708,0.031911503032408195,-66877900.0,1.0
420,2023-05-26,IBM,123.08367495345648,125.60231427559674,122.84149866406868,124.85640716552734,5612600.0,0.0,0.0,2.0633392333984375,0.0,2.0633392333984375,69.67110883962732,116.77741735826602,125.60231427559674,91.54769605745138,-8.452303942548623,0.7311887147587157,0.10430495938456656,0.04482809366128593,-61265300.0,1.0
421,2023-05-30,IBM,125.50544618955432,125.9994953127557,124.24612644477848,125.42794799804688,3741100.0,0.0,0.0,0.5715408325195312,0.0,0.5715408325195312,71.81715841663879,116.77741735826602,125.9994953127557,93.80240204507737,-6.197597954922633,0.9405946445471329,0.2715628964170799,0.04876078825287311,-57524200.0,1.0
422,2023-05-31,IBM,124.48829771006776,125.38920121625657,123.47116170259235,124.5657958984375,11590200.0,0.0,0.0,-0.862152099609375,0.862152099609375,0.0,63.94208606395924,116.77741735826602,125.9994953127557,84.45361857280533,-15.54638142719468,1.0251861741413109,0.42228755196192613,0.022909875027362636,-69114400.0,-1.0
423,2023-06-01,IBM,124.42049113048196,126.07696865014572,123.78114218757746,125.75730895996094,4136100.0,0.0,0.0,1.1915130615234375,0.0,1.1915130615234375,69.30874301303946,117.31987942461164,126.07696865014572,96.34970385761619,-3.650296142383808,1.174797676308799,0.5727895768313008,0.029092326650676403,-64978300.0,1.0
424,2023-06-02,IBM,126.29978785054922,128.9540306205597,126.0769750135452,128.27593994140625,5373900.0,0.0,0.0,2.5186309814453125,0.0,2.5186309814453125,77.48271164895021,118.51139013308595,128.9540306205597,93.50652088457085,-6.493479115429143,1.4794842935347816,0.754128520171997,0.040546921696439364,-59604400.0,1.0
425,2023-06-05,IBM,128.95403381385188,129.3996447176264,128.1306432478002,128.4890594482422,3993500.0,0.0,0.0,0.2131195068359375,0.0,0.2131195068359375,78.05339116250622,118.61794209851024,129.3996447176264,91.554346270229,-8.445653729770992,1.7183335641755662,0.9469695289727109,0.04031375977217677,-55610900.0,1.0
426,2023-06-06,IBM,128.28561804154893,128.77966713623255,127.75284202524996,128.53749084472656,3298000.0,0.0,0.0,0.048431396484375,0.0,0.048431396484375,78.19827460426322,119.60602719527152,129.3996447176264,91.19677819833298,-8.803221801667018,1.8897451694338656,1.135524657064942,0.0351849428234543,-52312900.0,1.0
427,2023-06-07,IBM,128.3534208164485,130.23271100321648,128.05312461199375,130.17459106445312,5772000.0,0.0,0.0,1.6371002197265625,0.0,1.6371002197265625,82.66240087141423,121.09783390515024,130.23271100321648,99.36375784655431,-0.6362421534456991,2.1330703563960185,1.3350337969311574,0.06922329076178446,-46540900.0,1.0
428,2023-06-08,IBM,130.47491059998086,131.72453385064472,129.81618335325047,130.20367431640625,4128500.0,0.0,0.0,0.029083251953125,0.0,0.029083251953125,82.73486634839367,121.09783390515024,131.72453385064472,85.68831770879835,-14.311682291201643,2.301719434072268,1.5283709243593797,0.06035036430862206,-42412400.0,1.0
429,2023-06-09,IBM,130.15524109423367,131.84079359080468,129.97118472732848,131.06582641601562,3981500.0,0.0,0.0,0.862152099609375,0.0,0.862152099609375,84.89443930109844,121.09783390515024,131.84079359080468,92.78627866560922,-7.213721334390775,2.4763825262777033,1.7179732447430445,0.04973248383045492,-38430900.0,1.0
430,2023-06-12,IBM,131.74391765220005,132.34451019384355,131.5695577973756,132.15077209472656,4494500.0,0.0,0.0,1.0849456787109375,0.0,1.0849456787109375,87.21625636476966,121.09783390515024,132.34451019384355,98.27737462923373,-1.7226253707662638,2.671537493138757,1.908686094422187,0.05359909178123812,-33936400.0,1.0
431,2023-06-13,IBM,132.23793862243505,133.84599276657352,131.74390430255693,133.29383850097656,3927300.0,0.0,0.0,1.14306640625,0.0,1.14306640625,89.22888319343038,121.09783390515024,133.84599276657352,95.6687528638523,-4.331247136147693,2.885160143920203,2.1039809043217903,0.07006773038768466,-30009100.0,1.0
432,2023-06-14,IBM,133.48758587170354,134.58221274855714,132.65449876878887,132.90635681152344,4514900.0,0.0,0.0,-0.387481689453125,0.387481689453125,0.0,84.05298218548205,121.09783390515024,134.58221274855714,87.57187144847164,-12.428128551528358,2.9887424073079956,2.2809332049190316,0.05684797099020811,-34524000.0,-1.0
433,2023-06-15,IBM,132.97415985470417,134.45627754919994,132.8869651575881,134.06878662109375,3812600.0,0.0,0.0,1.1624298095703125,0.0,1.1624298095703125,86.71957108327223,122.84149866406868,134.58221274855714,95.6269599636898,-4.373040036310193,3.1285520257050194,2.4504569690762295,0.045159261217135205,-30711400.0,1.0
434,2023-06-16,IBM,134.8728158238439,135.1053103844239,133.1679000567273,133.17758178710938,7473100.0,0.0,0.0,-0.891204833984375,0.891204833984375,0.0,75.5447724434675,123.47116170259235,135.1053103844239,83.43042838772595,-16.569571612274046,3.1313516963814436,2.5866359145372724,0.03648966191363412,-38184500.0,-1.0
435,2023-06-20,IBM,132.0926458575304,132.93541467828462,131.63735321657222,131.70516967773438,4271300.0,0.0,0.0,-1.472412109375,1.472412109375,0.0,60.646715656943925,123.47116170259235,135.1053103844239,70.77447779226561,-29.22552220773439,2.9804166281612368,2.6653920572620655,0.02464400706899106,-42455800.0,-1.0
436,2023-06-21,IBM,130.88175462035164,131.15299088236318,129.1187041360088,129.50619506835938,5501300.0,0.0,0.0,-2.198974609375,2.198974609375,0.0,45.264426493366045,123.78114218757746,135.1053103844239,50.556056579733934,-49.443943420266066,2.652800576208037,2.66287376105126,-0.00513461183652042,-47957100.0,-1.0
437,2023-06-22,IBM,127.55909016444676,128.7990463854194,126.59038499084824,127.06505584716795,6012800.0,0.0,0.0,-2.4411392211914205,2.4411392211914205,0.0,34.164714291655514,126.0769750135452,135.1053103844239,10.94421942731392,-89.05578057268609,2.1711756405535,2.5645341369517083,-0.024105452366967595,-53969900.0,-1.0
438,2023-06-23,IBM,126.31914652731956,126.53226284430536,125.13732505358664,125.37950134277344,11324700.0,0.0,0.0,-1.685554504394517,1.685554504394517,0.0,28.580923776500768,125.13732505358664,135.1053103844239,2.429540986959498,-97.5704590130405,1.6346444755770762,2.378556204676782,-0.043385260893203714,-65294600.0,-1.0
439,2023-06-26,IBM,125.34074912835428,127.29753751962916,125.2632509485619,127.22972106933594,4845600.0,0.0,0.0,1.8502197265625,0.0,1.8502197265625,40.82948520094155,125.13732505358664,135.1053103844239,20.991162670316175,-79.00883732968383,1.3432396030592315,2.1714928843532717,-0.03723815568677258,-60449000.0,1.0
440,2023-06-27,IBM,127.19099366377304,128.78935130547302,126.73570104461862,128.1984405517578,3219900.0,0.0,0.0,0.968719482421875,0.0,0.968719482421875,46.38448412208607,125.13732505358664,135.1053103844239,30.709470335005605,-69.2905296649944,1.1768936962363625,1.9725730467298899,-0.03822680782939125,-57229100.0,1.0
441,2023-06-28,IBM,127.92720356021584,128.0337617211453,126.8131985169908,127.63658905029295,2753800.0,0.0,0.0,-0.561851501464858,0.561851501464858,0.0,43.64253127895795,125.13732505358664,135.1053103844239,25.072910059112168,-74.92708994088784,0.9883371923173172,1.7757258758473753,-0.03965023109243471,-59982900.0,-1.0
442,2023-06-29,IBM,127.62691725105957,130.1455568246887,127.56879730080595,129.8646240234375,3639800.0,0.0,0.0,2.2280349731445455,0.0,2.2280349731445455,55.64081600265727,125.13732505358664,135.1053103844239,47.424818686543944,-52.575181313456056,1.0070668472665432,1.621994070131209,-0.03135825051910168,-56343100.0,1.0
443,2023-06-30,IBM,130.47490180363997,130.80425801416624,129.2543238285741,129.6224365234375,4236400.0,0.0,0.0,-0.2421875,0.2421875,0.0,54.193729958037736,125.13732505358664,135.1053103844239,44.99516523138925,-55.00483476861074,0.9909458813911556,1.4957844323831986,-0.026694772618374607,-60579500.0,-1.0
444,2023-07-03,IBM,129.24465534754302,130.1455589348884,128.71186449279782,129.48683166503906,1477100.0,0.0,0.0,-0.1356048583984375,0.1356048583984375,0.0,53.29819042750996,125.13732505358664,135.1053103844239,43.63476135941598,-56.36523864058402,0.9562057463670612,1.3878686951799712,-0.016843211379806156,-62056600.0,-1.0
445,2023-07-05,IBM,129.1477792311923,130.1067878811031,128.4406138207571,130.0389862060547,2955100.0,0.0,0.0,0.552154541015625,0.0,0.552154541015625,56.66276546088176,125.13732505358664,135.1053103844239,49.174040588765,-50.825959411235,0.9621346813472371,1.3027218924134245,0.004114020471484681,-59101500.0,1.0
446,2023-07-06,IBM,129.0702971063344,129.709631358746,127.43318281460672,128.0240936279297,3507700.0,0.0,0.0,-2.014892578125,2.014892578125,0.0,43.47490585431042,125.13732505358664,135.1053103844239,28.96040151074921,-71.03959848925079,0.795091585481714,1.2011958310270825,0.0075476123184903265,-62609200.0,-1.0
447,2023-07-07,IBM,127.65597208804684,129.66119897870027,127.6269121140897,127.94658660888672,2982400.0,0.0,0.0,-0.07750701904296875,0.07750701904296875,0.0,43.03038835981979,125.13732505358664,135.1053103844239,28.182841989235968,-71.81715801076403,0.6489739099984888,1.0907514468213637,0.02047452126241245,-65591600.0,-1.0
448,2023-07-10,IBM,127.63659763355211,128.88623567587533,127.57847768391272,128.7409210205078,2369200.0,0.0,0.0,0.7943344116210938,0.0,0.7943344116210938,49.175547906549426,125.13732505358664,132.93541467828462,46.211266353081236,-53.788733646918764,0.5904613858283199,0.9906934346227549,0.011877727456058196,-63222400.0,1.0
449,2023-07-11,IBM,129.47713819122,130.34896694263128,129.060587276644,130.23272705078125,2925200.0,0.0,0.0,1.4918060302734375,0.0,1.4918060302734375,58.80481529349599,125.13732505358664,131.15299088236318,84.70221156268755,-15.297788437312438,0.6568887918269581,0.9239325060635956,0.015868262439605374,-60297200.0,1.0
450,2023-07-12,IBM,130.8430081016932,131.09486611249994,128.4212452933959,128.6827850341797,3732200.0,0.0,0.0,-1.5499420166015625,1.5499420166015625,0.0,47.92066812628124,125.13732505358664,131.09486611249994,59.51213672776207,-40.48786327223793,0.577809774315881,0.8547079597140527,0.008196677705595068,-64029400.0,-1.0
451,2023-07-13,IBM,129.3318312105316,130.84302380048925,129.18653133710723,129.72900390625,3221400.0,0.0,0.0,1.0462188720703125,0.0,1.0462188720703125,54.48236559924554,125.13732505358664,131.09486611249994,77.07338996503559,-22.92661003496441,0.5927245964469137,0.8023112870606249,-0.0010443191762756765,-60808000.0,1.0
452,2023-07-14,IBM,129.7193146062836,129.72899633685736,128.77966939624864,129.2252655029297,2860700.0,0.0,0.0,-0.5037384033203125,0.5037384033203125,0.0,50.91822771836615,125.2632509485619,131.09486611249994,67.94026085377467,-32.059739146225326,0.5574723385048799,0.753343497349476,-0.0030640607533711783,-63668700.0,-1.0
453,2023-07-17,IBM,129.08964450523513,130.3974023858179,128.9346629131526,130.0389862060547,3167400.0,0.0,0.0,0.813720703125,0.0,0.813720703125,56.252443197830125,126.73570104461862,131.09486611249994,75.77793247094348,-24.222067529056513,0.5884102574304109,0.7203568493656631,0.004264175236320167,-60501300.0,1.0
454,2023-07-18,IBM,130.49427943925866,131.6954643853049,130.0874102619493,131.12393188476562,3852100.0,0.0,0.0,1.0849456787109375,0.0,1.0849456787109375,62.51916124949314,126.8131985169908,131.6954643853049,88.29370386712225,-11.706296132877748,0.6924896996724499,0.7147834194270205,0.008343233905190317,-56649200.0,1.0
455,2023-07-19,IBM,131.28861155498376,132.1798185447414,130.95925534206052,131.24017333984375,5520000.0,0.0,0.0,0.116241455078125,0.0,0.116241455078125,63.17134970202423,127.43318281460672,132.1798185447414,80.20397480825864,-19.796025191741357,0.775414317076212,0.7269095989568589,0.02512089420652952,-51129200.0,1.0
456,2023-07-20,IBM,132.89666172572595,135.9287135714037,132.2863727519908,134.04942321777344,10896300.0,0.0,0.0,2.8092498779296875,0.0,2.8092498779296875,75.20327952371346,127.43318281460672,135.9287135714037,77.87907068517512,-22.12092931482488,1.055641280206089,0.7926559352067051,0.04769831513787981,-40232900.0,1.0
457,2023-07-21,IBM,133.88475302489925,135.4056125120583,133.4488238571849,134.59190368652344,5858600.0,0.0,0.0,0.54248046875,0.0,0.54248046875,76.88583480689543,127.43318281460672,135.9287135714037,84.26455128997407,-15.73544871002594,1.3064359247002528,0.8954119331054148,0.04544773036914651,-34374300.0,1.0
458,2023-07-24,IBM,134.98906939854237,135.7349617261355,134.4369003646244,135.17311096191406,3475200.0,0.0,0.0,0.581207275390625,0.0,0.581207275390625,78.67465239860147,127.43318281460672,135.9287135714037,91.10588106711154,-8.894118932888457,1.5344023320294298,1.023210012890218,0.03793504154456073,-30899100.0,1.0
459,2023-07-25,IBM,135.05687500345417,136.035261918211,134.6887623034632,135.9384002685547,3770800.0,0.0,0.0,0.765289306640625,0.0,0.765289306640625,80.91826658906912,127.43318281460672,136.035261918211,98.8739739719932,-1.1260260280068042,1.756569857862388,1.169881981884652,0.056383728658404575,-27128300.0,1.0
460,2023-07-26,IBM,136.04495394401212,136.82960275231463,135.50248142376682,136.65524291992188,4046400.0,0.0,0.0,0.7168426513671875,0.0,0.7168426513671875,82.86651313330245,127.57847768391272,136.82960275231463,98.11525807830341,-1.8847419216965884,1.967797744864896,1.329465134480701,0.05339005777518491,-23081900.0,1.0
461,2023-07-27,IBM,137.84675784078453,138.89296126791203,137.45926687818056,138.49578857421875,6331600.0,0.0,0.0,1.840545654296875,0.0,1.840545654296875,86.84549010886168,127.57847768391272,138.89296126791203,96.4896966729003,-3.5103033270997113,2.257686245547319,1.5151093566940248,0.07173924569014622,-16750300.0,1.0
462,2023-07-28,IBM,138.95107266403792,139.44510698202092,138.3795401583044,138.96075439453125,6686400.0,0.0,0.0,0.4649658203125,0.0,0.4649658203125,87.6795092506449,128.4212452933959,139.44510698202092,95.6063256128345,-4.3936743871655,2.496168855524047,1.7113212564600295,0.06860841082180902,-10063900.0,1.0
463,2023-07-31,IBM,139.3094915232263,140.0747769036619,139.03825525152635,139.66790771484375,6138100.0,0.0,0.0,0.7071533203125,0.0,0.7071533203125,88.91305101548565,128.4212452933959,140.0747769036619,96.50861899701097,-3.4913810029890366,2.710978020835114,1.9112526093350468,0.06515954568527382,-3925800.0,1.0
464,2023-08-01,IBM,139.7357199166425,139.9585179656229,137.72081140163132,138.84451293945312,4797700.0,0.0,0.0,-0.823394775390625,0.823394775390625,0.0,78.37103091823226,128.77966939624864,140.0747769036619,89.10799243476592,-10.89200756523407,2.7826983227746496,2.0855417520229675,0.057942163638553756,-8723500.0,-1.0
465,2023-08-02,IBM,138.31173394091982,139.78417005465482,137.85644129247063,139.65823364257812,4957400.0,0.0,0.0,0.813720703125,0.0,0.813720703125,80.94698021582448,128.77966939624864,140.0747769036619,96.3121797573827,-3.6878202426173123,2.8720891064441503,2.242851222907204,0.04184136186615861,-3766100.0,1.0
466,2023-08-03,IBM,139.28042792909267,140.6753657365819,138.82513531744635,139.92945861816406,3951900.0,0.0,0.0,0.2712249755859375,0.0,0.2712249755859375,81.7814626842592,128.9346629131526,140.6753657365819,93.64682736940294,-6.353172630597062,2.93103012474225,2.3804870032742134,0.0396573254812731,185800.0,1.0
467,2023-08-04,IBM,140.54943425436682,141.51813945666797,139.48386740059658,139.72604370117188,4223100.0,0.0,0.0,-0.2034149169921875,0.2034149169921875,0.0,78.79502655711904,130.0874102619493,141.51813945666797,84.32212219388339,-15.677877806116614,2.927580208389344,2.48990564429724,0.03368223685064575,-4037300.0,-1.0
468,2023-08-07,IBM,140.46225114435703,141.9153089148159,140.39443468672698,141.60531616210938,3438700.0,0.0,0.0,1.8792724609375,0.0,1.8792724609375,84.73662985201943,130.95925534206052,141.9153089148159,97.17058016695538,-2.829419833044619,3.0414265079824645,2.600209817034285,0.04168738106641934,-598600.0,1.0
469,2023-08-08,IBM,141.14034592003813,141.57626030760278,139.6001081860511,141.34378051757812,4654600.0,0.0,0.0,-0.26153564453125,0.26153564453125,0.0,81.08814676088917,132.2863727519908,141.9153089148159,94.06446997286875,-5.935530027131255,3.075099079742273,2.695187669575883,0.03430924051998252,-5253200.0,-1.0
470,2023-08-09,IBM,142.01988409136422,142.01988409136422,139.43307299019347,139.61924743652344,4072900.0,1.66,0.0,-1.7245330810546875,1.7245330810546875,0.0,61.07924124286062,133.4488238571849,142.01988409136422,71.99136875426893,-28.008631245731063,2.928868365571475,2.7419238087750015,0.008111862995044294,-9326100.0,-1.0
471,2023-08-10,IBM,140.15814644004988,141.66712821640047,139.81520691005608,140.36392211914062,4735800.0,0.0,0.0,0.7446746826171875,0.0,0.7446746826171875,65.34044155572664,134.4369003646244,142.01988409136422,78.16213205912356,-21.837867940876436,2.8403264842894487,2.761604343877891,0.010097582808348715,-4590300.0,1.0
472,2023-08-11,IBM,140.23654174804688,140.55989499802246,139.34488697536486,140.23654174804688,2526000.0,0.0,0.0,-0.12738037109375,0.12738037109375,0.0,63.95836583292085,134.6887623034632,142.01988409136422,75.67435932846598,-24.325640671534014,2.7284263157287683,2.754968738248067,0.004071329215900477,-7116300.0,-1.0
473,2023-08-14,IBM,140.16795020632685,140.4814953369574,138.94313416983564,139.05091857910156,4226400.0,0.0,0.0,-1.1856231689453125,1.1856231689453125,0.0,52.11878936096336,135.50248142376682,142.01988409136422,54.44557189901005,-45.554428100989945,2.515083039805404,2.7069915985595348,0.0014865955829197475,-11342700.0,-1.0
474,2023-08-15,IBM,138.64917798070726,139.44285639530375,138.35521913605763,139.01171875,3656600.0,0.0,0.0,-0.0391998291015625,0.0391998291015625,0.0,51.75331042994213,137.45926687818056,142.01988409136422,34.040389694001796,-65.95961030599821,2.3161447865566913,2.628822236158966,-0.004629264424414248,-14999300.0,-1.0
475,2023-08-16,IBM,138.84514491766984,139.22728692853607,137.72811327426334,137.80650329589844,3285300.0,0.0,0.0,-1.2052154541015625,1.2052154541015625,0.0,41.443458226804275,137.72081140163132,142.01988409136422,1.9932646049871379,-98.00673539501287,2.037744659409867,2.5106067208091467,-0.01517161106196152,-18284600.0,-1.0
476,2023-08-17,IBM,138.16903508312987,139.78580114045647,137.76730680649135,137.8260955810547,3742100.0,0.0,0.0,0.01959228515625,0.0,0.01959228515625,41.661449069412626,137.72081140163132,142.01988409136422,2.4489974239050536,-97.55100257609494,1.7979656444964576,2.368078505546609,-0.013597666331844005,-14542500.0,1.0
477,2023-08-18,IBM,137.17939333015806,138.9725257657092,136.94422327338555,138.5609893798828,3914700.0,0.0,0.0,0.734893798828125,0.0,0.734893798828125,49.75666897252734,136.94422327338555,142.01988409136422,31.853312592726123,-68.14668740727387,1.648238673304263,2.22411053909814,-0.021498675789413335,-10627800.0,1.0
478,2023-08-21,IBM,138.57079332731303,139.52125182272837,138.2670413249085,139.41346740722656,2937800.0,0.0,0.0,0.85247802734375,0.0,0.85247802734375,57.626629306358716,136.94422327338555,142.01988409136422,48.64872225296501,-51.351277747034985,1.5801515026605273,2.0953187318106172,-0.01365686628221674,-7690000.0,1.0
479,2023-08-22,IBM,139.78581511074657,140.344323476283,138.45321459911767,138.63938903808594,3557500.0,0.0,0.0,-0.774078369140625,0.774078369140625,0.0,49.50259530950028,136.94422327338555,142.01988409136422,33.39793231840643,-66.60206768159357,1.4470498354361894,1.9656649525357317,-0.007018075347261732,-11247500.0,-1.0
480,2023-08-23,IBM,138.8647524047575,140.5892881041673,138.72757359857,140.5207061767578,2559100.0,0.0,0.0,1.881317138671875,0.0,1.881317138671875,63.81002887739537,136.94422327338555,142.01988409136422,70.46339445504087,-29.536605544959123,1.4763533024424476,1.867802622517075,0.0011169825924650656,-8688400.0,1.0
481,2023-08-24,IBM,140.61868020280448,141.55934553802197,140.33452944867892,140.6578826904297,2900200.0,0.0,0.0,0.137176513671875,0.0,0.137176513671875,64.65261750902046,136.94422327338555,142.01988409136422,73.166028035007,-26.833971964992998,1.4934301259586107,1.7929281232053824,0.0030045018019611014,-5788200.0,1.0
482,2023-08-25,IBM,141.2751746260074,142.53919315639183,140.60888187461694,142.42161560058594,3660100.0,0.0,0.0,1.76373291015625,0.0,1.76373291015625,73.72732471033977,136.94422327338555,142.53919315639183,97.89851315977562,-2.10148684022438,1.6304864239348547,1.760439783351277,0.024240738974815823,-2128100.0,1.0
483,2023-08-28,IBM,142.48041413145967,143.78362028586298,142.28444654124633,143.078125,3561100.0,0.0,0.0,0.6565093994140625,0.0,0.6565093994140625,76.33653853766998,136.94422327338555,143.78362028586298,89.68483209008174,-10.315167909918259,1.7716566186308569,1.762683150407193,0.029252255036951613,1433000.0,1.0
484,2023-08-29,IBM,143.35247873275782,143.77380829273304,142.6861710024421,143.49945068359375,2778100.0,0.0,0.0,0.42132568359375,0.0,0.42132568359375,77.95756406057356,136.94422327338555,143.78362028586298,95.845107372027,-4.154892627972998,1.895680145754568,1.7892825494766682,0.041311166393006804,4211100.0,1.0
485,2023-08-30,IBM,143.4700464539896,143.9599728583338,142.81354686633244,143.90118408203125,2245400.0,0.0,0.0,0.4017333984375,0.0,0.4017333984375,79.50240046498702,136.94422327338555,143.9599728583338,99.16204568605647,-0.8379543139435301,2.0032933952249152,1.8320847186263178,0.04407792642869901,6456500.0,1.0
486,2023-08-31,IBM,143.97958006577267,144.75365723810384,143.58762995523895,143.87179565429688,3885900.0,0.0,0.0,-0.029388427734375,0.029388427734375,0.0,79.03485067615453,136.94422327338555,144.75365723810384,88.70774005144204,-11.292259948557962,2.0624318337741556,1.8781541416558856,0.038328293541942005,2570600.0,-1.0
487,2023-09-01,IBM,144.2931191954002,145.116206917569,143.95997282884255,144.9594268798828,2727500.0,0.0,0.0,1.0876312255859375,0.0,1.0876312255859375,83.24304626013225,136.94422327338555,145.116206917569,98.08149349640732,-1.9185065035926794,2.1720242710499917,1.9369281675347068,0.039780658036834504,5298100.0,1.0
488,2023-09-05,IBM,144.9300305541397,145.9980665127843,144.59688419203596,145.14559936523438,3731300.0,0.0,0.0,0.1861724853515625,0.0,0.1861724853515625,83.88203032294021,136.94422327338555,145.9980665127843,90.58447197494729,-9.41552802505271,2.247986202989381,1.9991397746256419,0.046929017592259425,9029400.0,1.0
489,2023-09-06,IBM,144.6850759475148,145.34157556524727,144.15594703381714,145.07701110839844,2932200.0,0.0,0.0,-0.0685882568359375,0.0685882568359375,0.0,82.54401004678301,136.94422327338555,145.9980665127843,89.8269123947519,-10.173087605248096,2.2764110338458465,2.054594026469683,0.032424438046228854,6097200.0,-1.0
490,2023-09-07,IBM,145.14559285651643,145.78249116441145,144.43028958297512,144.54788208007812,3332900.0,0.0,0.0,-0.5291290283203125,0.5291290283203125,0.0,72.28094023060561,136.94422327338555,145.9980665127843,83.9826646611734,-16.017335338826598,2.2305295387159845,2.0897811289189434,0.027655751069492807,2764300.0,-1.0
491,2023-09-08,IBM,144.38132784450855,145.59633584679878,144.29312972227103,144.7046661376953,3722800.0,0.0,0.0,0.1567840576171875,0.0,0.1567840576171875,73.41120101471789,138.2670413249085,145.9980665127843,83.27000179591487,-16.729998204085128,2.181670321889584,2.1081589675130714,0.016030224959054484,6487100.0,1.0
492,2023-09-11,IBM,145.57673838997988,145.78249910622813,144.60667873070776,145.39056396484375,3273600.0,0.0,0.0,0.6858978271484375,0.0,0.6858978271484375,77.94976810401218,138.45321459911767,145.9980665127843,91.94811833430244,-8.051881665697563,2.173243375717419,2.121175849153941,0.0161620720487059,9760700.0,1.0
493,2023-09-12,IBM,144.93983489403408,145.01822491788363,142.86255159181036,143.35247802734375,4457700.0,0.0,0.0,-2.0380859375,2.0380859375,0.0,49.17234379192546,138.72757359857,145.9980665127843,63.61197904108747,-36.38802095891253,1.9792926323456754,2.092799205792288,-0.0010242036157620538,5303000.0,-1.0
494,2023-09-13,IBM,143.00952491810818,144.01877218890954,142.9801305278028,143.59744262695312,2627800.0,0.0,0.0,0.244964599609375,0.0,0.244964599609375,51.64794546566056,140.33452944867892,145.9980665127843,57.61263926308595,-42.387360736914054,1.8243221880041176,2.0391038022346537,-0.0021107641123020437,7930800.0,1.0
495,2023-09-14,IBM,144.410711526782,144.7536510385225,143.52883502937652,144.38131713867188,2723100.0,0.0,0.0,0.78387451171875,0.0,0.78387451171875,59.01791734503226,140.60888187461694,145.9980665127843,70.00011165581034,-29.99988834418965,1.7446478230548337,1.9802126063986898,0.0035414966641502676,10653900.0,1.0
496,2023-09-15,IBM,144.14615170845323,144.87124819163012,142.59798242904384,143.04872131347656,6231400.0,0.0,0.0,-1.3325958251953125,1.3325958251953125,0.0,45.43383978950802,142.28444654124633,145.9980665127843,20.580317266920456,-79.41968273307954,1.5560390376461442,1.895377892648181,-0.013180967995889747,4422500.0,-1.0
497,2023-09-18,IBM,142.83314728036345,143.5288343977311,142.1374452116286,142.16683959960938,2508100.0,0.0,0.0,-0.8818817138671875,0.8818817138671875,0.0,38.64228953469253,142.1374452116286,145.9980665127843,0.7613900895167665,-99.23860991048323,1.3201865170801739,1.7803396175345796,-0.020522563402900373,1914400.0,-1.0
498,2023-09-19,IBM,142.07867357262583,143.76402179318305,141.7455271677496,143.56805419921875,3945400.0,0.0,0.0,1.401214599609375,0.0,1.401214599609375,51.840467063050944,141.7455271677496,145.9980665127843,42.8573819921771,-57.1426180078229,1.2321346129541269,1.670698616618489,-0.01040107524721634,5859800.0,1.0
499,2023-09-20,IBM,145.3709706926413,148.869037622956,145.1456087215577,146.8113555908203,9632400.0,0.0,0.0,3.2433013916015625,0.0,3.2433013916015625,69.41243203388123,141.7455271677496,148.869037622956,71.1142133492374,-28.88578665076259,1.4078313229767048,1.6181251578901323,0.0156589877220632,15492200.0,1.0
500,2023-09-21,IBM,145.99806226430564,146.2430254560243,144.34210869606903,144.41070556640625,4944600.0,0.0,0.0,-2.4006500244140625,2.4006500244140625,0.0,52.9210814902698,141.7455271677496,148.869037622956,37.41383430845863,-62.58616569154136,1.3379370884063064,1.5620875439933672,-0.002031451916065685,10547600.0,-1.0
501,2023-09-22,IBM,144.4401217699371,145.11622267341934,143.86201213848986,143.9501953125,2562000.0,0.0,0.0,-0.46051025390625,0.46051025390625,0.0,50.277162863929476,141.7455271677496,148.869037622956,30.949181005820826,-69.05081899417918,1.231193668009638,1.4959087687966215,-0.009906892256721922,7985600.0,-1.0
502,2023-09-25,IBM,143.61703722953413,144.45969631447912,143.3034771456188,143.52883911132812,2694200.0,0.0,0.0,-0.421356201171875,0.421356201171875,0.0,47.75818043845258,141.7455271677496,148.869037622956,25.03417317616409,-74.96582682383591,1.0999196485352627,1.4167109447443498,0.0012302618441708546,5291400.0,-1.0
503,2023-09-26,IBM,142.57838115508886,143.22508761686092,140.13855715597182,140.3541259765625,4824700.0,0.0,0.0,-3.174713134765625,3.174713134765625,0.0,33.2677610754336,140.13855715597182,148.869037622956,2.4691518571731126,-97.53084814282688,0.7312816330209841,1.2796250823996766,-0.02258617278314856,466700.0,-1.0
504,2023-09-27,IBM,140.77544885702292,140.92243574666878,138.9039264356485,140.2855224609375,4439800.0,0.0,0.0,-0.068603515625,0.068603515625,0.0,33.01797204185914,138.9039264356485,148.869037622956,13.864331258528676,-86.13566874147132,0.4286563408500115,1.1094313340897437,-0.028367899385490003,-3973100.0,-1.0
505,2023-09-28,IBM,139.2762694697908,139.41344825691624,137.385160836464,138.72755432128906,5783200.0,0.0,0.0,-1.5579681396484375,1.5579681396484375,0.0,27.589749353438194,137.385160836464,148.869037622956,11.689375546105364,-88.31062445389463,0.062389493047248834,0.9000229658812446,-0.030207658988563146,-9756300.0,-1.0
506,2023-09-29,IBM,139.1391050127677,139.26649066799175,136.79725729405823,137.47335815429688,5703600.0,0.0,0.0,-1.2541961669921875,1.2541961669921875,0.0,23.934723311679065,136.79725729405823,148.869037622956,5.600672326849575,-94.39932767315042,-0.32533248644551804,0.6549518754158921,-0.03301389732325033,-15459900.0,-1.0
507,2023-10-02,IBM,137.2185744255722,138.60017041047178,137.0422081047935,137.96327209472656,3275300.0,0.0,0.0,0.4899139404296875,0.0,0.4899139404296875,28.2206475671408,136.79725729405823,148.869037622956,9.659012746256623,-90.34098725374338,-0.5863143381169209,0.40669863270932943,-0.039039200856722966,-12184600.0,1.0
508,2023-10-03,IBM,138.03186386998362,138.78635473815763,137.17939668928076,137.56153869628906,3284400.0,0.0,0.0,-0.4017333984375,0.4017333984375,0.0,26.79229941222998,136.79725729405823,148.869037622956,6.33114073821636,-93.66885926178364,-0.8161527466366181,0.1621283568401399,-0.06300477818835437,-15469000.0,-1.0
509,2023-10-04,IBM,137.54193530445644,138.35521493771566,137.1696014004753,138.22784423828125,2637600.0,0.0,0.0,0.6663055419921875,0.0,0.6663055419921875,33.25710592172129,136.79725729405823,148.869037622956,11.850670781329937,-88.14932921867008,-0.9337721293932759,-0.05705174040654332,-0.04281442503777433,-12831400.0,1.0
510,2023-10-05,IBM,138.06125854088253,138.84514379955314,137.3655714004461,138.6687774658203,3223900.0,0.0,0.0,0.4409332275390625,0.0,0.4409332275390625,37.47321803641436,136.79725729405823,148.869037622956,15.503265639136815,-84.49673436086317,-0.9801086413872042,-0.24166312060267559,-0.03668920236762663,-9607500.0,1.0
511,2023-10-06,IBM,138.55119071118645,140.06017251326864,137.2871870795174,139.1685028076172,3511100.0,0.0,0.0,0.499725341796875,0.0,0.499725341796875,42.24421419511437,136.79725729405823,148.869037622956,19.642881571350376,-80.35711842864963,-0.9653787306926347,-0.3864062426206675,-0.030379513488079213,-6096400.0,1.0
512,2023-10-09,IBM,139.43305901138427,139.53103532237765,137.84568727907,139.33506774902344,2354400.0,0.0,0.0,0.16656494140625,0.0,0.16656494140625,43.8907735843501,136.79725729405823,148.869037622956,21.02266928176391,-78.97733071823609,-0.9295495073904476,-0.4950348955746236,-0.0072606218053699045,-3742000.0,1.0
513,2023-10-10,IBM,139.72702047945677,140.5304920307561,138.86474519881264,139.24688720703125,3015800.0,0.0,0.0,-0.0881805419921875,0.0881805419921875,0.0,43.139506860064294,136.79725729405823,146.2430254560243,25.933623088872736,-74.06637691112726,-0.8979193644866257,-0.5756117893570241,-0.007403723746300717,-6757800.0,-1.0
514,2023-10-11,IBM,139.63883453402326,140.4521142534609,139.2762937373154,140.34432983398438,2511500.0,0.0,0.0,1.097442626953125,0.0,1.097442626953125,54.35816641223994,136.79725729405823,145.11622267341934,42.63838564259727,-57.36161435740272,-0.775359957705291,-0.6155614230266775,0.01165432145477685,-4246300.0,1.0
515,2023-10-12,IBM,139.63882681566858,140.05036322600392,138.1102587340321,138.39442443847656,3921100.0,0.0,0.0,-1.9499053955078125,1.9499053955078125,0.0,38.703079278686346,136.79725729405823,144.45969631447912,20.8441090384117,-79.1558909615883,-0.8260495876411085,-0.6576590559495638,0.006699962062074016,-8167400.0,-1.0
516,2023-10-13,IBM,136.9540455953802,137.29698514350534,135.48426622846674,135.67044067382812,4582800.0,0.0,0.0,-2.7239837646484375,2.7239837646484375,0.0,26.43244701211009,135.48426622846674,143.22508761686092,2.405099356000121,-97.59490064399988,-1.0736478118017772,-0.7408568071200066,-0.01661914353063587,-12750200.0,-1.0
517,2023-10-16,IBM,136.47390113734198,136.96382755295602,135.72921836810096,136.4053192138672,3361500.0,0.0,0.0,0.7348785400390625,0.0,0.7348785400390625,33.040764020512455,135.48426622846674,140.92243574666878,16.93682005162956,-83.06317994837043,-1.196776944354184,-0.8320408345668422,-0.008405107222409058,-9388700.0,1.0
518,2023-10-17,IBM,134.35740955560473,137.7868943148678,133.56373118925117,137.49295043945312,4172800.0,0.0,0.0,1.0876312255859375,0.0,1.0876312255859375,41.946093921595974,133.56373118925117,140.5304920307561,56.39951391460679,-43.600486085393214,-1.1928445666224832,-0.9042015809779705,-0.005316539535705211,-5215900.0,1.0
519,2023-10-18,IBM,137.17940354563802,137.60073310844277,136.76786712916532,137.15000915527344,3330000.0,0.0,0.0,-0.3429412841796875,0.3429412841796875,0.0,40.010137505001744,133.56373118925117,140.5304920307561,51.47697829178776,-48.52302170821224,-1.2035271074346383,-0.9640666862693041,-0.010952489365684603,-8545900.0,-1.0
520,2023-10-19,IBM,135.84678896520296,136.6012797929858,135.1510869120638,135.22947692871094,5314200.0,0.0,0.0,-1.9205322265625,1.9205322265625,0.0,30.818950012099606,133.56373118925117,140.5304920307561,23.9099027131228,-76.0900972868772,-1.3513860331790397,-1.0415305556512515,-0.02830400413483969,-13860100.0,-1.0
521,2023-10-20,IBM,135.36665109653435,136.46409634074422,134.35740396264444,134.3966064453125,4865300.0,0.0,0.0,-0.8328704833984375,0.8328704833984375,0.0,27.641577166650762,133.56373118925117,140.5304920307561,11.954985609659788,-88.04501439034021,-1.5182693092850172,-1.1368783063780048,-0.035443060985955954,-18725400.0,-1.0
522,2023-10-23,IBM,133.87728740879678,134.90612084589992,133.13258974218,133.63232421875,3457500.0,0.0,0.0,-0.7642822265625,0.7642822265625,0.0,24.92111886466209,133.13258974218,140.5304920307561,6.755083496327123,-93.24491650367288,-1.6926844731989377,-1.2480395397421915,-0.040320922793294134,-22182900.0,-1.0
523,2023-10-24,IBM,133.9850824964671,135.20009044712756,133.30898164579688,135.013916015625,3698000.0,0.0,0.0,1.381591796875,0.0,1.381591796875,37.70850796588563,133.13258974218,140.5304920307561,25.430536928693503,-74.5694630713065,-1.6998322426674406,-1.3383980803272415,-0.037980970265523495,-18484900.0,1.0
524,2023-10-25,IBM,134.72977372845745,135.69983348179508,133.583347629805,134.3182373046875,6472500.0,0.0,0.0,-0.6956787109375,0.6956787109375,0.0,34.31303628961763,133.13258974218,140.5304920307561,16.026807549734677,-83.97319245026532,-1.7415567692978868,-1.4190298181213707,-0.029453405730236915,-24957400.0,-1.0
525,2023-10-26,IBM,139.33507932981377,141.50056081648486,138.72757531651297,140.8636474609375,11130200.0,0.0,0.0,6.54541015625,0.0,6.54541015625,66.78358321976528,133.13258974218,141.50056081648486,92.38867641998544,-7.611323580014549,-1.2322592062725164,-1.3816756957516,0.038278100677763716,-13827200.0,1.0
526,2023-10-27,IBM,140.72646505541874,141.78470795407426,138.85495742810824,139.6486358642578,5469200.0,0.0,0.0,-1.2150115966796875,1.2150115966796875,0.0,60.389699303738126,133.13258974218,141.78470795407426,75.31157067549145,-24.688429324508554,-0.916118050589688,-1.2885641667192178,0.023777054070050596,-19296400.0,-1.0
527,2023-10-30,IBM,140.3051391821285,141.58874408926548,139.707428314908,139.7564239501953,4204100.0,0.0,0.0,0.1077880859375,0.0,0.1077880859375,60.77411930590601,133.13258974218,141.78470795407426,76.55737064375033,-23.442629356249668,-0.6493905404675786,-1.16072944146889,0.0164624695557678,-15092300.0,1.0
528,2023-10-31,IBM,140.11896348682745,141.84349919340335,139.7172202129773,141.72592163085938,6591800.0,0.0,0.0,1.9694976806640625,0.0,1.9694976806640625,67.43690868943077,133.13258974218,141.84349919340335,98.65022632593823,-1.349773674061767,-0.2759046226354087,-0.9837644777021938,0.033364288517147234,-8500500.0,1.0
529,2023-11-01,IBM,142.07866115978976,143.55823355903036,141.53973910994458,142.47059631347656,4750100.0,0.0,0.0,0.7446746826171875,0.0,0.7446746826171875,69.68348743181365,133.13258974218,143.55823355903036,89.56767308896639,-10.432326911033616,0.07926100429119742,-0.7711593813035156,0.05354690078837576,-3750400.0,1.0
530,2023-11-02,IBM,142.83314881834772,144.13635485454046,141.9218779270302,144.04815673828125,3902700.0,0.0,0.0,1.5775604248046875,0.0,1.5775604248046875,74.05832000086718,133.13258974218,144.13635485454046,99.19847329201771,-0.8015267079822929,0.4824666781877909,-0.5204341694052543,0.07181394343387737,152300.0,1.0
531,2023-11-03,IBM,144.47929626915416,145.45914909559994,144.3127230828225,144.92022705078125,3510100.0,0.0,0.0,0.8720703125,0.0,0.8720703125,76.24484049546774,133.13258974218,145.45914909559994,95.62796049272931,-4.372039507270687,0.8624372205349005,-0.24385989141722328,0.0844698533683621,3662400.0,1.0
532,2023-11-06,IBM,144.9104308814097,146.22343005312268,144.87124334777127,145.9686737060547,4597200.0,0.0,0.0,1.0484466552734375,0.0,1.0484466552734375,78.73159605624357,133.13258974218,146.22343005312268,98.05393434633035,-1.946065653669643,1.233943358437216,0.05170075855366465,0.08113798942889638,8259600.0,1.0
533,2023-11-07,IBM,146.02746476637486,146.27242797170683,145.04761194504707,145.8314971923828,3549900.0,0.0,0.0,-0.137176513671875,0.137176513671875,0.0,77.50670975619437,133.13258974218,146.27242797170683,96.64432109724765,-3.35567890275235,1.5000045328470435,0.3413615134123405,0.08571628185961555,4709700.0,-1.0
534,2023-11-08,IBM,146.24304440727184,146.66437397497086,144.6164850151506,145.04762268066406,3618600.0,0.0,0.0,-0.78387451171875,0.78387451171875,0.0,70.29578903919646,133.13258974218,146.66437397497086,88.05219425248441,-11.94780574751558,1.62883165453934,0.5988555416377406,0.029702306415761548,1091100.0,-1.0
535,2023-11-09,IBM,145.22598940263117,145.6620166190225,143.96745905003493,145.29534912109375,3412700.0,1.66,0.0,0.2477264404296875,0.0,0.2477264404296875,71.27045086353533,133.13258974218,146.66437397497086,89.88289474377207,-10.117105256227928,1.730964052560239,0.8252772438222403,0.04043514798329073,4503800.0,1.0
536,2023-11-10,IBM,146.10794831218857,147.82231430618015,145.52328232593317,147.67367553710938,3179000.0,0.0,0.0,2.378326416015625,0.0,2.378326416015625,78.92927915256624,133.30898164579688,147.82231430618015,98.97584674348086,-1.0241532565191425,1.9809802615706076,1.056417847371914,0.05665035898267923,7682800.0,1.0
537,2023-11-13,IBM,147.11874158528582,147.14846933996495,146.0187692993586,146.76199340820312,2647200.0,0.0,0.0,-0.91168212890625,0.91168212890625,0.0,70.60427585519562,133.583347629805,147.82231430618015,92.55338591573312,-7.446614084266891,2.0815598568495943,1.26144624926745,0.03553387919015094,5035600.0,-1.0
538,2023-11-14,IBM,148.09978345827764,149.44749707493264,147.70340332670438,149.05111694335938,4321900.0,0.0,0.0,2.28912353515625,0.0,2.28912353515625,77.48448764779188,138.72757531651297,149.44749707493264,96.30239715824473,-3.697602841755264,2.3192481911296454,1.4730066376398894,0.04618862277661684,9357500.0,1.0
539,2023-11-15,IBM,149.0412101025014,151.83574016337863,149.0412101025014,151.20152282714844,4632500.0,0.0,0.0,2.1504058837890625,0.0,2.1504058837890625,82.04071847671256,138.85495742810824,151.83574016337863,95.1141826408746,-4.885817359125396,2.6505834086004256,1.7085219918319972,0.04965954616041368,13990000.0,1.0
540,2023-11-16,IBM,151.6177142919806,151.9645582488648,150.7555791866659,151.6771697998047,3519200.0,0.0,0.0,0.47564697265625,0.0,0.47564697265625,82.92269190676211,139.707428314908,151.9645582488648,97.65533652161156,-2.3446634783884446,2.917913795453728,1.9504003525563434,0.046625256436120255,17509200.0,1.0
541,2023-11-17,IBM,151.90509291515394,152.1132023207252,151.08260486700718,151.5087127685547,4426500.0,0.0,0.0,-0.16845703125,0.16845703125,0.0,81.2912829811315,139.7172202129773,152.1132023207252,95.1235041571035,-4.876495842896499,3.0806699333263907,2.1764542687103527,0.03795361649758,13082700.0,-1.0
542,2023-11-20,IBM,151.13214781816694,153.28254120775884,150.97360482498158,152.95553588867188,3658500.0,0.0,0.0,1.4468231201171875,0.0,1.4468231201171875,84.3437524317113,141.53973910994458,153.28254120775884,97.21527011727609,-2.7847298827239153,3.2884941616345884,2.3988622472952,0.048851166129707524,16741200.0,1.0
543,2023-11-21,IBM,153.2032693333146,153.26272484279514,152.12310546766287,152.51950073242188,2859500.0,0.0,0.0,-0.43603515625,0.43603515625,0.0,79.81532335060851,141.9218779270302,153.28254120775884,93.28348656692141,-6.7165134330785845,3.3790602643275065,2.5949018507016617,0.051513274838070666,13881700.0,-1.0
544,2023-11-22,IBM,153.10417199457046,154.30324692036015,152.76724734865505,153.72848510742188,3044700.0,0.0,0.0,1.208984375,0.0,1.208984375,82.77416674322451,143.96745905003493,154.30324692036015,94.43910981775797,-5.560890182242026,3.5079519984125227,2.7775118802438343,0.058041334683739176,16926400.0,1.0
545,2023-11-24,IBM,153.72847895972035,153.9960287508711,152.52940408188243,153.77801513671875,1799200.0,0.0,0.0,0.049530029296875,0.0,0.049530029296875,82.89271009464241,143.96745905003493,154.30324692036015,94.91831885260164,-5.081681147398351,3.572910002950124,2.936591504785093,0.04133668087698816,18725600.0,1.0
546,2023-11-27,IBM,153.58974321934068,154.72934745835488,153.35190606365435,154.1645050048828,4053100.0,0.0,0.0,0.3864898681640625,0.0,0.3864898681640625,83.89084048641574,143.96745905003493,154.72934745835488,94.75145595232718,-5.248544047672818,3.613917203015859,3.0720566444312465,0.05043888696776122,22778700.0,1.0
547,2023-11-28,IBM,154.03568012626258,154.34287701268485,153.46091832030683,154.2437744140625,2666200.0,0.0,0.0,0.0792694091796875,0.0,0.0792694091796875,84.11024157278788,143.96745905003493,154.72934745835488,95.48803122770734,-4.511968772292663,3.6111845949189103,3.1798822345287796,0.03483809834633034,25444900.0,1.0
548,2023-11-29,IBM,154.73925701681196,156.08697070374123,154.61044178384682,154.99691772460938,3568900.0,0.0,0.0,0.753143310546875,0.0,0.753143310546875,86.1745106721655,143.96745905003493,156.08697070374123,91.0058011388726,-8.994198861127403,3.627970368726153,3.2694998613682547,0.025101565291771433,29013800.0,1.0
549,2023-11-30,IBM,155.53203212357218,157.16713427032028,155.4725766129511,157.1274871826172,6740600.0,0.0,0.0,2.1305694580078125,0.0,2.1305694580078125,90.29141606732355,145.52328232593317,157.16713427032028,99.65950195955386,-0.3404980404461401,3.7697371777358057,3.3695473246417653,0.035933670110051885,35754400.0,1.0
550,2023-12-01,IBM,156.97885220681093,159.13914978999475,156.5725527131514,159.09951782226562,4871000.0,0.0,0.0,1.9720306396484375,0.0,1.9720306396484375,92.63397052696462,146.0187692993586,159.13914978999475,99.697935835341,-0.3020641646589942,3.9951610542300386,3.4946700705594202,0.050101442451739864,40625400.0,1.0
551,2023-12-04,IBM,158.84185176019733,161.31926548552968,158.84185176019733,159.64454650878906,5779000.0,0.0,0.0,0.5450286865234375,0.0,0.5450286865234375,93.16026261736708,147.70340332670438,161.31926548552968,87.70023552526104,-12.299764474738966,4.169724372567117,3.62968093096096,0.04373173276308062,46404400.0,1.0
552,2023-12-05,IBM,159.3076022035388,161.00215979651355,159.2679702382753,159.93191528320312,4556700.0,0.0,0.0,0.2873687744140625,0.0,0.2873687744140625,93.44518209762731,149.0412101025014,161.31926548552968,88.70057057859289,-11.299429421407117,4.281896283004585,3.760124001369685,0.04859978242248175,50961100.0,1.0
553,2023-12-06,IBM,160.13010200581817,160.88324541848627,158.56437479429496,158.83193969726562,3555900.0,0.0,0.0,-1.0999755859375,1.0999755859375,0.0,78.924530631684,150.7555791866659,161.31926548552968,76.4539979899669,-23.546002010033103,4.233236380494532,3.854746477194655,0.03319784610039944,47405200.0,-1.0
554,2023-12-07,IBM,159.54544332486554,160.01119831319042,158.52475008345567,158.77249145507812,3665500.0,0.0,0.0,-0.0594482421875,0.0594482421875,0.0,78.1670754715087,150.97360482498158,161.31926548552968,75.38316677867304,-24.616833221326946,4.142128205265266,3.912222822808778,0.03247848084083382,43739700.0,-1.0
555,2023-12-08,IBM,158.5544813458108,160.5760443297591,158.5544813458108,160.4967803955078,4560400.0,0.0,0.0,1.7242889404296875,0.0,1.7242889404296875,83.47482037008862,150.97360482498158,161.31926548552968,92.04995101803101,-7.950048981968992,4.1610935292372915,3.9619969640944808,0.04107479468392827,48300100.0,1.0
556,2023-12-11,IBM,161.21025745502828,162.17149518284705,160.48685688657494,162.0327606201172,6077200.0,0.0,0.0,1.535980224609375,0.0,1.535980224609375,86.77852690276843,152.12310546766287,162.17149518284705,98.61933536952469,-1.3806646304752994,4.251060867570345,4.019809744789654,0.050497896823669564,54377300.0,1.0
557,2023-12-12,IBM,161.79494630447476,164.83720261845428,161.44810232062792,163.22193908691406,5292300.0,0.0,0.0,1.189178466796875,0.0,1.189178466796875,88.78198635041892,152.52940408188243,164.83720261845428,86.87609707990777,-13.123902920092231,4.367966198814429,4.089441035594609,0.053065709196349786,59669600.0,1.0
558,2023-12-13,IBM,162.88499353022792,163.47957887543987,161.2697300560512,162.1417694091797,4989100.0,0.0,0.0,-1.080169677734375,1.080169677734375,0.0,76.61441135705583,152.52940408188243,164.83720261845428,78.09979419743274,-21.90020580256726,4.3236139212578735,4.136275612727262,0.03191219000870804,54680500.0,-1.0
559,2023-12-14,IBM,161.45799506762725,162.02285263762275,158.70311229973254,161.4381866455078,6129800.0,0.0,0.0,-0.703582763671875,0.703582763671875,0.0,69.45983328020908,153.35190606365435,164.83720261845428,70.40550100967174,-29.594498990328262,4.18346677241064,4.145713844663938,0.014699408617031562,48550700.0,-1.0
560,2023-12-15,IBM,160.8337028456204,162.60752442827146,160.5760421395503,160.7643280029297,11015600.0,0.0,0.0,-0.673858642578125,0.673858642578125,0.0,62.96220306220694,153.46091832030683,164.83720261845428,64.1985510489762,-35.80144895102381,3.9722349351493165,4.111018062761014,0.007014217012912383,37535100.0,-1.0
561,2023-12-18,IBM,160.76432753593215,161.85439562552338,160.12020601449495,161.2697296142578,3677300.0,0.0,0.0,0.505401611328125,0.0,0.505401611328125,65.73600223646088,154.61044178384682,164.83720261845428,65.11629574709416,-34.883704252905844,3.801789208678315,4.049172291944474,0.008364899080247401,41212400.0,1.0
562,2023-12-19,IBM,160.3382247424421,160.8138839599079,159.86256552497622,160.1003875732422,3766600.0,0.0,0.0,-1.169342041015625,1.169342041015625,0.0,54.78309769895185,155.4725766129511,164.83720261845428,49.41800086379883,-50.58199913620117,3.531643030484048,3.9456664396523893,0.007986100770375426,37445800.0,-1.0
563,2023-12-20,IBM,159.83282199063888,160.3382240829932,158.56438733532426,158.60403442382812,4865800.0,0.0,0.0,-1.4963531494140625,1.4963531494140625,0.0,43.96654645886953,156.5725527131514,164.83720261845428,24.580372235407815,-75.41962776459219,3.1603761955963137,3.788608390841175,-0.0010609963332197658,32580000.0,-1.0
564,2023-12-21,IBM,159.13913724173503,159.6247157534984,158.08871628900005,159.32742309570312,2982900.0,0.0,0.0,0.723388671875,0.0,0.723388671875,49.52557743142734,158.08871628900005,164.83720261845428,18.355328087376517,-81.64467191262348,2.8911881565930173,3.6091243439915437,-0.0072858614168026525,35562900.0,1.0
565,2023-12-22,IBM,159.64454294732312,160.94270529108758,159.54544035214732,160.67514038085938,2439800.0,0.0,0.0,1.34771728515625,0.0,1.34771728515625,58.397978056835235,158.08871628900005,164.83720261845428,38.32598846011883,-61.67401153988117,2.754848043820715,3.438269083957378,-0.008378677460422534,38002700.0,1.0
566,2023-12-26,IBM,160.76433179661535,161.83457637086923,160.58596526137327,161.73548889160156,1772400.0,0.0,0.0,1.0603485107421875,0.0,1.0603485107421875,64.12307376391468,158.08871628900005,164.83720261845428,54.038378749986094,-45.9616212500139,2.7012207929755334,3.290859425761009,-0.00910692645625888,39775100.0,1.0
567,2023-12-27,IBM,161.66611436629688,162.16159712641436,161.2102635737779,161.9832305908203,3234600.0,0.0,0.0,0.24774169921875,0.0,0.24774169921875,65.40647233617426,158.08871628900005,164.83720261845428,57.709449374186136,-42.290550625813864,2.648184868141385,3.1623245142370844,-0.0009777790074517734,43009700.0,1.0
568,2023-12-28,IBM,162.4787087718295,162.4787087718295,161.92375539455364,162.27059936523438,2071300.0,0.0,0.0,0.2873687744140625,0.0,0.2873687744140625,66.98706107383182,158.08871628900005,164.83720261845428,61.967719457061186,-38.032280542938814,2.599377765119357,3.0497351644135393,0.005156231849620552,45081000.0,1.0
569,2023-12-29,IBM,162.27059302062722,162.69670090761073,161.35890661786297,162.07240295410156,2525600.0,0.0,0.0,-0.1981964111328125,0.1981964111328125,0.0,64.63684235482683,158.08871628900005,164.83720261845428,59.03081773633353,-40.96918226366647,2.51570550333372,2.9429292321975757,0.008136599502024167,42555400.0,-1.0
570,2024-01-02,IBM,161.35890996737274,161.81474561775073,159.01032663237925,160.04092407226562,3825000.0,0.0,0.0,-2.0314788818359375,2.0314788818359375,0.0,45.681792656147,158.08871628900005,164.83720261845428,28.928083839260836,-71.07191616073916,2.2594260090733655,2.806228587572734,-0.007619567199197097,38730400.0,-1.0
571,2024-01-03,IBM,159.54544259731458,160.26884316529205,158.63375616841333,158.65357971191406,4086100.0,0.0,0.0,-1.3873443603515625,1.3873443603515625,0.0,37.10705003710317,158.08871628900005,163.47957887543987,10.478164001710473,-89.52183599828952,1.9222174423684635,2.6294263585318802,-0.009036879193476288,34644300.0,-1.0
572,2024-01-04,IBM,158.77249046112604,160.3481219457571,158.7229391629251,159.40670776367188,3212000.0,0.0,0.0,0.7531280517578125,0.0,0.7531280517578125,43.72366985383907,158.08871628900005,162.69670090761073,28.60234101799594,-71.39765898200406,1.696195675323679,2.4427802218902404,0.0050608633176305595,37856300.0,1.0
573,2024-01-05,IBM,158.46530055895508,159.09951788942604,157.23649786575896,157.72207641601562,4199400.0,0.0,0.0,-1.68463134765625,1.68463134765625,0.0,34.38665402109302,157.23649786575896,162.69670090761073,8.893049334150458,-91.10695066584954,1.3653966832096387,2.22730351415412,-0.010075771317303084,33656900.0,-1.0
574,2024-01-08,IBM,157.2563112317119,159.76345263527867,156.46353583970193,159.68417358398438,3321700.0,0.0,0.0,1.96209716796875,0.0,1.96209716796875,49.017675860258535,156.46353583970193,162.69670090761073,51.66937998904868,-48.33062001095133,1.2471841788984648,2.031279647102989,-0.006167517853266191,36978600.0,1.0
575,2024-01-09,IBM,158.5544794906645,159.03013869527513,158.0689009536883,158.63375854492188,2617200.0,0.0,0.0,-1.0504150390625,1.0504150390625,0.0,43.083243411277785,156.46353583970193,162.69670090761073,34.817346910853466,-65.18265308914654,1.056560827274268,1.8363358831372447,-0.01917779683318932,34361400.0,-1.0
576,2024-01-10,IBM,158.8319470177628,159.88236801444216,158.2968323080909,159.7733612060547,2967800.0,0.0,0.0,1.1396026611328125,0.0,1.1396026611328125,50.57395035313291,156.46353583970193,162.69670090761073,53.10023608059503,-46.89976391940497,0.9860799424587867,1.6662846950015533,-0.013642581251808061,37329200.0,1.0
577,2024-01-11,IBM,159.56526153584463,160.76432126670255,158.84184586781132,160.69496154785156,3778200.0,0.0,0.0,0.921600341796875,0.0,0.921600341796875,55.97988637032533,156.46353583970193,162.69670090761073,67.8856674265688,-32.1143325734312,0.9931404735651199,1.5316558507142668,-0.009709940208185275,41107400.0,1.0
578,2024-01-12,IBM,161.4976441473909,164.48044477394473,160.88325039357932,164.3020782470703,4956400.0,0.0,0.0,3.60711669921875,0.0,3.60711669921875,70.53435658473916,156.46353583970193,164.48044477394473,97.775120955752,-2.2248790442479933,1.2751015890352448,1.4803449983784627,0.013757279168620684,46063800.0,1.0
579,2024-01-16,IBM,164.30207556356754,165.73897245000887,163.8462248007786,165.45159912109375,4869600.0,0.0,0.0,1.1495208740234375,0.0,1.1495208740234375,73.72837066363519,156.46353583970193,165.73897245000887,96.90178111296895,-3.0982188870310607,1.57317989332671,1.4989119773681123,0.033808071780346394,50933400.0,1.0
580,2024-01-17,IBM,165.28312107051508,166.30382939723842,164.00478229076427,164.5795440673828,4288600.0,0.0,0.0,-0.8720550537109375,0.8720550537109375,0.0,67.33894054540099,156.46353583970193,166.30382939723842,82.47729785932037,-17.522702140679623,1.7192234051275648,1.542974262920003,0.03735159563515178,46644800.0,-1.0
581,2024-01-18,IBM,164.98584328405312,165.48132600926337,163.5489312841971,165.33267211914062,3776900.0,0.0,0.0,0.7531280517578125,0.0,0.7531280517578125,69.93525802181752,156.46353583970193,166.30382939723842,90.13080989485317,-9.869190105146831,1.8741312613584,1.6092056626076825,0.03717512542981738,50421700.0,1.0
582,2024-01-19,IBM,169.04879694630395,170.029858211222,167.6515319959176,169.93075561523438,6925800.0,0.0,0.0,4.59808349609375,0.0,4.59808349609375,80.72765682074602,156.46353583970193,170.029858211222,99.26949549573082,-0.7305045042691761,2.340938877062996,1.7555523054987452,0.07740627993646587,57347500.0,1.0
583,2024-01-22,IBM,171.25866573478078,172.87392922477758,170.84244691649585,171.26856994628906,4926000.0,0.0,0.0,1.3378143310546875,0.0,1.3378143310546875,82.80040107991522,156.46353583970193,172.87392922477758,90.21742355092775,-9.782576449072252,2.7867142047649622,1.9617846853519887,0.072545676270241,62273500.0,1.0
584,2024-01-23,IBM,171.33793292033093,172.44782458859805,170.92172921508094,172.36854553222656,3983500.0,0.0,0.0,1.0999755859375,0.0,1.0999755859375,84.39286465033368,156.46353583970193,172.87392922477758,96.92034382910869,-3.0796561708913073,3.191958292118528,2.207819406705297,0.08658174094396975,66257000.0,1.0
585,2024-01-24,IBM,173.1811151918784,173.2802177844466,171.33791886501163,172.35861206054688,9097800.0,0.0,0.0,-0.0099334716796875,0.0099334716796875,0.0,84.3115246727939,156.46353583970193,173.2802177844466,94.51969343936052,-5.480306560639481,3.472289214177863,2.4607133681998103,0.07876939409355854,57159200.0,-1.0
586,2024-01-25,IBM,183.2889816901096,195.12109681043623,183.1601513391121,188.7095489501953,29596200.0,0.0,0.0,16.350936889648438,0.0,16.350936889648438,94.45749760830755,156.46353583970193,195.12109681043623,83.41450495261515,-16.585495047384853,4.956699695972446,2.9599106337543377,0.17433395006601748,86755400.0,1.0
587,2024-01-26,IBM,189.58160065885212,190.65184517538935,184.4781345633085,185.72674560546875,9895900.0,0.0,0.0,-2.9828033447265625,2.9828033447265625,0.0,83.13994368667537,156.46353583970193,195.12109681043623,75.69854132266785,-24.301458677332157,5.825268328832948,3.53298217277006,0.13039803018304474,76859500.0,-1.0
588,2024-01-29,IBM,185.7663959975956,187.74832696254157,184.36913103828468,185.44927978515625,6107900.0,0.0,0.0,-0.2774658203125,0.2774658203125,0.0,82.08432001923683,158.0689009536883,195.12109681043623,73.89677777081448,-26.10322222918552,6.417251969155899,4.109836132047228,0.1208672552595047,70751600.0,-1.0
589,2024-01-30,IBM,186.0141407276706,186.94563559643427,185.0826307379734,186.1726837158203,4575100.0,0.0,0.0,0.7234039306640625,0.0,0.7234039306640625,82.7434523090691,158.2968323080909,195.12109681043623,75.69968276203862,-24.30031723796138,6.865633174989114,4.660995540635605,0.13120184389134493,75326700.0,1.0
590,2024-01-31,IBM,185.3600894150518,185.954659609183,181.48541089809277,182.00071716308597,8876100.0,0.0,0.0,-4.171966552734347,4.171966552734347,0.0,66.47020664311682,158.84184586781132,195.12109681043623,63.835031577416125,-36.164968422583875,6.805881709227293,5.089972774353943,0.1008151917603688,66450600.0,-1.0
591,2024-02-01,IBM,181.9709948271692,185.8159305840093,181.05930840561197,185.21144104003903,4669400.0,0.0,0.0,3.210723876953068,0.0,3.210723876953068,71.45532714067717,160.88325039357932,195.12109681043623,71.05642787883352,-28.943572121166483,6.937634098294097,5.459505039141974,0.0899230122850978,71120000.0,1.0
592,2024-02-02,IBM,185.40964290330655,185.697016232394,183.9430031410596,184.1114654541016,4054200.0,0.0,0.0,-1.0999755859374432,1.0999755859374432,0.0,67.48885128848949,163.5489312841971,195.12109681043623,65.12867846462827,-34.871321535371735,6.874050207159996,5.7424140727455795,0.07498687886423139,67065800.0,-1.0
593,2024-02-05,IBM,183.8340079824014,184.10157290638745,181.60433556469687,181.7628936767578,4379600.0,0.0,0.0,-2.3485717773437784,2.3485717773437784,0.0,59.36981312054593,163.5489312841971,195.12109681043623,57.689936971296376,-42.310063028703624,6.558546558680035,5.905640569932471,0.05450152239507555,62686200.0,-1.0
594,2024-02-06,IBM,181.891725291436,183.0115060533959,181.38632319586176,181.75299072265625,3337600.0,0.0,0.0,-0.0099029541015625,0.0099029541015625,0.0,59.33508406729821,163.5489312841971,195.12109681043623,57.658570880511974,-42.34142911948803,6.235825839924303,5.971677623930838,0.05450484051710314,59348600.0,-1.0
595,2024-02-07,IBM,181.6836065684708,182.35747095439683,180.9800295489008,182.0800018310547,4841200.0,0.0,0.0,0.3270111083984375,0.0,0.3270111083984375,60.221667241572824,167.6515319959176,195.12109681043623,52.525294567139035,-47.47470543286096,5.938004785824489,5.964943056309569,-0.03513095736819505,64189800.0,1.0
596,2024-02-08,IBM,182.6300048828125,184.5500030517578,181.4900054931641,184.3600006103516,5161200.0,1.66,0.0,2.2799987792969034,0.0,2.2799987792969034,66.15750468647204,170.84244691649585,195.12109681043623,55.67671082579242,-44.323289174207574,5.818879876324303,5.935730420312517,-0.007358902406121248,69351000.0,1.0
597,2024-02-09,IBM,184.44000244140625,187.17999267578125,183.8500061035156,186.33999633789065,5064600.0,0.0,0.0,1.9799957275390625,0.0,1.9799957275390625,70.55957559998797,170.92172921508094,195.12109681043623,63.71351260339969,-36.28648739660031,5.817184750185703,5.912021286287155,0.0048030197462416435,74415600.0,1.0
598,2024-02-12,IBM,185.8999938964844,186.47999572753903,184.02999877929688,186.16000366210935,4724000.0,0.0,0.0,-0.17999267578130684,0.17999267578130684,0.0,69.60983770908646,171.33791886501163,195.12109681043623,62.321716765984945,-37.678283234015055,5.735205566111091,5.876658142251943,-6.810909881027616e-05,69691600.0,-1.0
599,2024-02-13,IBM,184.27999877929688,184.7700042724609,182.3600006103516,183.6999969482422,4290500.0,0.0,0.0,-2.460006713867159,2.460006713867159,0.0,57.42133273010064,180.9800295489008,195.12109681043623,19.234526991748808,-80.76547300825119,5.409378540906999,5.783202221982955,0.009336665325519355,65401100.0,-1.0
600,2024-02-14,IBM,185.0,185.0,182.25999450683597,183.57000732421875,3173400.0,0.0,0.0,-0.1299896240234375,0.1299896240234375,0.0,56.81478982883524,180.9800295489008,190.65184517538935,26.77860988400856,-73.22139011599144,5.0820860749043675,5.642978992567238,-0.008862485527907693,62227700.0,-1.0
601,2024-02-15,IBM,183.6199951171875,186.97999572753903,183.6199951171875,186.8699951171875,4714300.0,0.0,0.0,3.29998779296875,0.0,3.29998779296875,67.01943485204396,180.9800295489008,187.74832696254157,87.02285387778784,-12.97714612221216,5.0309917322258,5.5205815404989504,0.014982932520156478,66942000.0,1.0
602,2024-02-16,IBM,186.6300048828125,188.9499969482422,185.9499969482422,187.63999938964844,4841900.0,0.0,0.0,0.7700042724609375,0.0,0.7700042724609375,68.9921450795462,180.9800295489008,188.9499969482422,83.56332600931336,-16.43667399068664,4.995052155175728,5.415475663434306,0.032333913671853676,71783900.0,1.0
603,2024-02-20,IBM,187.63999938964844,188.7700042724609,183.05999755859372,183.44000244140625,4247200.0,0.0,0.0,-4.1999969482421875,4.1999969482421875,0.0,50.12319624934639,180.9800295489008,188.9499969482422,30.86553268346785,-69.13446731653215,4.574928204104424,5.247366171568331,0.009281892485193177,67536700.0,-1.0
604,2024-02-21,IBM,182.55999755859372,183.02999877929688,178.75,179.6999969482422,4728500.0,0.0,0.0,-3.7400054931640625,3.7400054931640625,0.0,39.12792301798909,178.75,188.9499969482422,9.313698357585341,-90.68630164241466,3.8952873119646654,4.976950399647598,-0.013071204189797903,62808200.0,-1.0
605,2024-02-22,IBM,182.4499969482422,184.5500030517578,181.92999267578125,184.2100067138672,5078400.0,0.0,0.0,4.510009765625,0.0,4.510009765625,53.362779101302934,178.75,188.9499969482422,53.52949360252638,-46.47050639747362,3.67818725161942,4.717197770041962,-0.0008135924060957977,67886600.0,1.0
606,2024-02-23,IBM,184.8999938964844,186.4600067138672,184.57000732421875,185.72000122070312,3433800.0,0.0,0.0,1.5099945068359375,0.0,1.5099945068359375,57.226906311219096,178.75,188.9499969482422,68.33336574580345,-31.66663425419654,3.586633350136765,4.491084886060923,-0.003327225122744415,71320400.0,1.0
607,2024-02-26,IBM,185.6000061035156,186.1300048828125,184.05999755859372,184.1300048828125,4620800.0,0.0,0.0,-1.589996337890625,1.589996337890625,0.0,51.992930490175375,178.75,188.9499969482422,52.74516169085385,-47.25483830914615,3.3471924562339836,4.262306400095535,-0.01090459142330813,66699600.0,-1.0
608,2024-02-27,IBM,184.16000366210935,185.1300048828125,182.6199951171875,184.8699951171875,3641400.0,0.0,0.0,0.739990234375,0.0,0.739990234375,54.2403882870199,178.75,188.9499969482422,59.99997008079681,-40.000029919203186,3.1804822309057954,4.0459415662575875,0.006369070159946588,70341000.0,1.0
609,2024-02-28,IBM,184.6300048828125,185.3699951171875,183.5500030517578,185.3000030517578,3216300.0,0.0,0.0,0.4300079345703125,0.0,0.4300079345703125,55.63304587974585,178.75,188.9499969482422,64.21573540653466,-35.784264593465345,3.0479266220070826,3.8463385774074865,0.009424174203379376,73557300.0,1.0
610,2024-02-29,IBM,186.1499938964844,186.8500061035156,184.69000244140625,185.02999877929688,6458500.0,0.0,0.0,-0.2700042724609375,0.2700042724609375,0.0,54.43281474932574,178.75,188.9499969482422,61.56863390414187,-38.43136609585813,2.887799503593925,3.654630762644774,-0.009846397955630914,67098800.0,-1.0
611,2024-03-01,IBM,185.4900054931641,188.3800048828125,185.17999267578125,188.1999969482422,4017300.0,0.0,0.0,3.1699981689453125,0.0,3.1699981689453125,64.73835749003877,178.75,188.9499969482422,92.647056623588,-7.352943376411999,2.982311734756138,3.5201669570670475,0.0029844252846691344,71116100.0,1.0
612,2024-03-04,IBM,187.75999450683597,193.8999938964844,187.6000061035156,193.05999755859372,7938300.0,0.0,0.0,4.860000610351534,0.0,4.860000610351534,74.81450267687937,178.75,193.8999938964844,94.45546748315454,-5.544532516845471,3.4100656769205955,3.498146701037757,0.052442188122300504,79054400.0,1.0
613,2024-03-05,IBM,192.0,193.94000244140625,190.57000732421875,191.9499969482422,5653600.0,0.0,0.0,-1.110000610351534,1.110000610351534,0.0,69.5751141300145,178.75,193.94000244140625,86.89924178195304,-13.100758218046957,3.6177923273521344,3.522075826300633,0.06816917199797334,73400800.0,-1.0
614,2024-03-06,IBM,193.5,198.1300048828125,192.9600067138672,196.16000366210935,6945800.0,0.0,0.0,4.210006713867159,0.0,4.210006713867159,76.71232366552454,178.75,198.1300048828125,89.83487758328542,-10.16512241671458,4.0751537163323235,3.6326914043069714,0.06487159498780137,80346600.0,1.0
615,2024-03-07,IBM,197.5800018310547,198.72999572753903,196.13999938964844,196.5399932861328,4604500.0,0.0,0.0,0.3799896240234659,0.0,0.3799896240234659,77.267690456286,178.75,198.72999572753903,89.03902447592782,-10.960975524072184,4.417357353298428,3.7896245941052626,0.05825970274774872,84951100.0,1.0
616,2024-03-08,IBM,196.05999755859372,197.7700042724609,194.3800048828125,195.9499969482422,3942500.0,0.0,0.0,-0.589996337890625,0.589996337890625,0.0,74.10171534473551,178.75,198.72999572753903,86.08608922040413,-13.913910779595865,4.588060126212724,3.949311700526755,0.06419373134189832,81008600.0,-1.0
617,2024-03-11,IBM,195.08999633789065,195.3800048828125,190.8800048828125,191.72999572753903,4725100.0,0.0,0.0,-4.220001220703153,4.220001220703153,0.0,55.37587442586666,178.75,198.72999572753903,64.96495747318059,-35.035042526819396,4.332877755496327,4.02602491152067,0.03710716066175612,76283500.0,-1.0
618,2024-03-12,IBM,192.4600067138672,199.17999267578125,192.1499938964844,197.77999877929688,5880100.0,0.0,0.0,6.050003051757841,0.0,6.050003051757841,68.53082775509066,181.92999267578125,199.17999267578125,91.88409335371377,-8.115906646286232,4.5661923494110965,4.134058399098755,0.06735021868322999,82163600.0,1.0
619,2024-03-13,IBM,197.5500030517578,198.1000061035156,195.32000732421875,196.6999969482422,3993300.0,0.0,0.0,-1.0800018310546875,1.0800018310546875,0.0,64.6078002592889,182.6199951171875,199.17999267578125,85.0241781814027,-14.975821818597296,4.610798311410264,4.229406381561057,0.06307084389523898,78170300.0,-1.0
620,2024-03-14,IBM,196.9499969482422,197.75,192.1199951171875,193.42999267578125,4109600.0,0.0,0.0,-3.2700042724609375,3.2700042724609375,0.0,53.84030640905793,182.6199951171875,199.17999267578125,65.27777265875224,-34.72222734124776,4.332346250676238,4.249994355384094,0.027789563296206632,74060700.0,-1.0
621,2024-03-15,IBM,191.9900054931641,193.05999755859372,190.6999969482422,191.07000732421875,8827900.0,0.0,0.0,-2.3599853515625,2.3599853515625,0.0,47.278780637693096,182.6199951171875,199.17999267578125,51.026651285018744,-48.973348714981256,3.876553397275927,4.17530616376246,-0.010307625917020946,65232800.0,-1.0
622,2024-03-18,IBM,191.6999969482422,193.22999572753903,190.32000732421875,191.69000244140625,5410600.0,0.0,0.0,0.6199951171875,0.0,0.6199951171875,49.15703770203752,183.5500030517578,199.17999267578125,52.07936528081365,-47.92063471918635,3.524731787605816,4.045191288531131,-0.0013544908099479835,70643400.0,1.0
623,2024-03-19,IBM,191.4900054931641,193.5800018310547,190.27999877929688,193.33999633789065,5317300.0,0.0,0.0,1.6499938964844034,0.0,1.6499938964844034,54.1706969372166,184.69000244140625,199.17999267578125,59.69634041549446,-40.30365958450554,3.34054363743158,3.904261758311221,-0.014376056645452717,75960700.0,1.0
624,2024-03-20,IBM,192.8699951171875,193.97999572753903,191.30999755859372,193.9600067138672,3238600.0,0.0,0.0,0.6200103759765341,0.0,0.6200103759765341,56.049794806977054,185.17999267578125,199.17999267578125,62.714385986328125,-37.285614013671875,3.207627325974528,3.764934871843883,-0.013127030937207573,79199300.0,1.0
625,2024-03-21,IBM,193.0,193.3699951171875,190.00999450683597,191.8999938964844,6013600.0,0.0,0.0,-2.060012817382784,2.060012817382784,0.0,48.436119361308194,187.6000061035156,199.17999267578125,37.13292555336274,-62.86707444663726,2.9026049503670492,3.5924688875485167,-0.020668553788380728,73185700.0,-1.0
626,2024-03-22,IBM,192.0,192.9900054931641,190.50999450683597,190.83999633789065,3987700.0,0.0,0.0,-1.05999755859375,1.05999755859375,0.0,44.821292059258425,190.00999450683597,199.17999267578125,9.051275864651048,-90.94872413534895,2.545990976769673,3.3831733053927477,-0.0046419413210290195,69198000.0,-1.0
627,2024-03-25,IBM,190.25999450683597,190.82000732421875,188.75,188.7899932861328,3718300.0,0.0,0.0,-2.050003051757841,2.050003051757841,0.0,38.422457253581854,188.75,199.17999267578125,0.3834450068759692,-99.61655499312403,2.0740454152514474,3.121347727364488,-0.04545457350920523,65479700.0,-1.0
628,2024-03-26,IBM,189.0200042724609,190.0,188.5,188.5,4229500.0,0.0,0.0,-0.2899932861328125,0.2899932861328125,0.0,37.547515633504446,188.5,199.17999267578125,0.0,-100.0,1.6575182839413287,2.8285818386798565,-0.0416878346490257,61250200.0,-1.0
629,2024-03-27,IBM,189.6000061035156,190.9600067138672,188.6000061035156,190.8000030517578,3693300.0,0.0,0.0,2.3000030517578125,0.0,2.3000030517578125,48.31772073855194,188.5,199.17999267578125,21.53562386773421,-78.46437613226578,1.495766293059802,2.5620187295558456,-0.01359659682369796,64943500.0,1.0
630,2024-03-28,IBM,190.94000244140625,191.92999267578125,190.33999633789065,190.9600067138672,3742200.0,0.0,0.0,0.160003662109375,0.0,0.160003662109375,49.02337945877002,188.5,199.17999267578125,23.033786525394188,-76.96621347460581,1.3647555804506908,2.3225660997348148,-0.0005757084112364419,68685700.0,1.0
631,2024-04-01,IBM,190.0,190.4600067138672,188.5200042724609,189.8300018310547,2364300.0,0.0,0.0,-1.1300048828125,1.1300048828125,0.0,44.11500496293416,188.5,199.17999267578125,12.453209205570891,-87.54679079442911,1.156416249946517,2.089336129777155,-0.009703169631499753,66321400.0,-1.0
632,2024-04-02,IBM,189.13999938964844,189.8000030517578,187.6000061035156,188.8800048828125,2693500.0,0.0,0.0,-0.9499969482421875,0.9499969482421875,0.0,40.20969900921859,187.6000061035156,198.1000061035156,12.190464564732412,-87.80953543526758,0.9042256646520457,1.8523140367521331,-0.023068126303693814,63627900.0,-1.0
633,2024-04-03,IBM,188.6000061035156,191.3500061035156,188.4900054931641,190.8999938964844,2826200.0,0.0,0.0,2.0199890136719034,0.0,2.0199890136719034,50.87848872050517,187.6000061035156,197.75,32.51221455524033,-67.48778544475968,0.8574746070068784,1.6533461508030824,-0.015776514288829424,66454100.0,1.0
634,2024-04-04,IBM,192.0,193.27999877929688,187.33999633789065,187.94000244140625,2983900.0,0.0,0.0,-2.9599914550781534,2.9599914550781534,0.0,39.086218397037,187.33999633789065,193.97999572753903,9.036237329343637,-90.96376267065637,0.5749498206240844,1.437666884767283,-0.02063570391364511,63470200.0,-1.0
635,2024-04-05,IBM,188.58999633789065,190.32000732421875,188.0200042724609,189.13999938964844,2013600.0,0.0,0.0,1.1999969482421875,0.0,1.1999969482421875,45.044388021619305,187.33999633789065,193.97999572753903,27.108482186970544,-72.89151781302947,0.4427726098325593,1.2386880297803384,-0.0089079699269764,65483800.0,1.0
636,2024-04-08,IBM,189.2400054931641,190.2400054931641,188.91000366210935,189.82000732421875,2678300.0,0.0,0.0,0.6800079345703125,0.0,0.6800079345703125,48.3478366850886,187.33999633789065,193.97999572753903,37.349566480297895,-62.6504335197021,0.3884147715434665,1.068633378132964,0.00545587199913089,68162100.0,1.0
637,2024-04-09,IBM,190.5399932861328,191.25,186.66000366210935,189.30999755859372,2794200.0,0.0,0.0,-0.5100097656250284,0.5100097656250284,0.0,45.95715859277754,186.66000366210935,193.97999572753903,36.202141652578675,-63.79785834742132,0.3007158027319008,0.9150498630527514,0.004297069276359311,65367900.0,-1.0
638,2024-04-10,IBM,187.4199981689453,187.9199981689453,185.5200042724609,186.0399932861328,3081700.0,0.0,0.0,-3.270004272460909,3.270004272460909,0.0,33.64815193606796,185.5200042724609,193.3699951171875,6.624071593933359,-93.37592840606665,-0.03227621795520008,0.7255846468511611,-0.024947639882027528,62286200.0,-1.0
639,2024-04-11,IBM,186.0399932861328,186.8000030517578,184.5800018310547,185.8999938964844,2860000.0,0.0,0.0,-0.13999938964840908,0.13999938964840908,0.0,33.20876385111086,184.5800018310547,193.27999877929688,15.172327913246189,-84.82767208675381,-0.30396762458539683,0.5196741925638495,-0.026497762041685857,59426200.0,-1.0
